id,t_depart_secs,t_arrival_secs,t_traveltime_secs,origin,destiny,route_detail,route_path_num,is_attended,has_finished
2304,0,241,241,1/11to2/11,11/3to12/3,1/11to2/11:2/11to3/11:3/11to4/11:4/11to5/11:5/11to6/11:6/11to7/11:7/11to8/11:8/11to9/11:9/11to10/11:10/11to10/10:10/10to10/9:10/9to10/8:10/8to10/7:10/7to10/6:10/6to10/5:10/5to10/4:10/4to10/3:10/3to11/3:11/3to12/3:,19,False,True
3126,0,161,161,bottom7to7/0,10/9to10/10,bottom7to7/0:7/0to7/1:7/1to7/2:7/2to7/3:7/3to7/4:7/4to7/5:7/5to7/6:7/6to7/7:7/7to8/7:8/7to9/7:9/7to10/7:10/7to10/8:10/8to10/9:10/9to10/10:,14,True,True
74,0,373,373,left15to0/15,15/0tobottom15,left15to0/15:0/15to0/14:0/14to0/13:0/13to0/12:0/12to0/11:0/11to0/10:0/10to0/9:0/9to0/8:0/8to0/7:0/7to0/6:0/6to0/5:0/5to0/4:0/4to0/3:0/3to0/2:0/2to0/1:0/1to0/0:0/0to1/0:1/0to2/0:2/0to3/0:3/0to4/0:4/0to5/0:5/0to6/0:6/0to7/0:7/0to8/0:8/0to9/0:9/0to10/0:10/0to11/0:11/0to12/0:12/0to13/0:13/0to14/0:14/0to15/0:15/0tobottom15:,32,True,True
65,0,382,382,left15to0/15,15/0tobottom15,left15to0/15:0/15to0/14:0/14to0/13:0/13to0/12:0/12to0/11:0/11to0/10:0/10to0/9:0/9to0/8:0/8to0/7:0/7to0/6:0/6to0/5:0/5to0/4:0/4to0/3:0/3to0/2:0/2to1/2:1/2to2/2:2/2to3/2:3/2to4/2:4/2to5/2:5/2to6/2:6/2to7/2:7/2to8/2:8/2to9/2:9/2to10/2:10/2to10/1:10/1to11/1:11/1to11/0:11/0to12/0:12/0to13/0:13/0to14/0:14/0to15/0:15/0tobottom15:,32,True,True
690,0,35,35,13/7to14/7,14/6to14/5,13/7to14/7:14/7to14/6:14/6to14/5:,3,True,True
1648,1,120,119,10/7to9/7,7/13to7/14,10/7to9/7:9/7to8/7:8/7to7/7:7/7to7/8:7/8to7/9:7/9to7/10:7/10to7/11:7/11to7/12:7/12to7/13:7/13to7/14:,10,False,True
1950,1,60,59,8/14to7/14,7/11to8/11,8/14to7/14:7/14to7/13:7/13to7/12:7/12to7/11:7/11to8/11:,5,True,True
144,1,512,511,left0to0/0,15/15totop15,left0to0/0:0/0to0/1:0/1to0/2:0/2to0/3:0/3to0/4:0/4to0/5:0/5to0/6:0/6to0/7:0/7to0/8:0/8to0/9:0/9to0/10:0/10to0/11:0/11to0/12:0/12to0/13:0/13to1/13:1/13to2/13:2/13to3/13:3/13to4/13:4/13to5/13:5/13to6/13:6/13to7/13:7/13to8/13:8/13to9/13:9/13to10/13:10/13to10/14:10/14to11/14:11/14to11/15:11/15to12/15:12/15to13/15:13/15to14/15:14/15to15/15:15/15totop15:,32,True,True
1513,2,126,124,8/6to8/5,13/2to14/2,8/6to8/5:8/5to9/5:9/5to10/5:10/5to10/4:10/4to10/3:10/3to10/2:10/2to11/2:11/2to12/2:12/2to13/2:13/2to14/2:,10,False,True
292,2,400,398,right15to15/15,0/0tobottom0,right15to15/15:15/15to14/15:14/15to13/15:13/15to12/15:12/15to11/15:11/15to10/15:10/15to9/15:9/15to8/15:8/15to7/15:7/15to6/15:6/15to5/15:5/15to4/15:4/15to3/15:3/15to2/15:2/15to1/15:1/15to0/15:0/15to0/14:0/14to0/13:0/13to0/12:0/12to0/11:0/11to0/10:0/10to0/9:0/9to0/8:0/8to0/7:0/7to0/6:0/6to0/5:0/5to0/4:0/4to0/3:0/3to0/2:0/2to0/1:0/1to0/0:0/0tobottom0:,32,True,True
751,3,148,145,4/8to4/9,10/12to9/12,4/8to4/9:4/9to5/9:5/9to6/9:6/9to7/9:7/9to8/9:8/9to9/9:9/9to10/9:10/9to10/10:10/10to10/11:10/11to10/12:10/12to9/12:,11,False,True
2653,3,54,51,2/1to1/1,0/0to1/0,2/1to1/1:1/1to0/1:0/1to0/0:0/0to1/0:,4,True,True
1455,3,110,107,6/6to6/7,9/11to9/10,6/6to6/7:6/7to6/8:6/8to6/9:6/9to6/10:6/10to6/11:6/11to7/11:7/11to8/11:8/11to9/11:9/11to9/10:,9,True,True
3206,4,66,62,13/3to13/2,10/2to10/1,13/3to13/2:13/2to12/2:12/2to11/2:11/2to10/2:10/2to10/1:,5,True,True
538,4,235,231,11/0to10/0,9/15to9/14,11/0to10/0:10/0to10/1:10/1to9/1:9/1to8/1:8/1to8/2:8/2to8/3:8/3to8/4:8/4to8/5:8/5to8/6:8/6to8/7:8/7to8/8:8/8to8/9:8/9to8/10:8/10to8/11:8/11to8/12:8/12to8/13:8/13to8/14:8/14to8/15:8/15to9/15:9/15to9/14:,20,True,True
771,5,172,167,0/15to0/14,6/9to7/9,0/15to0/14:0/14to0/13:0/13to0/12:0/12to0/11:0/11to0/10:0/10to0/9:0/9to1/9:1/9to2/9:2/9to3/9:3/9to4/9:4/9to5/9:5/9to6/9:6/9to7/9:,13,True,True
2240,5,189,184,12/12to11/12,6/4to6/3,12/12to11/12:11/12to10/12:10/12to9/12:9/12to8/12:8/12to7/12:7/12to6/12:6/12to6/11:6/11to6/10:6/10to6/9:6/9to6/8:6/8to6/7:6/7to6/6:6/6to6/5:6/5to6/4:6/4to6/3:,15,False,True
2894,5,214,209,9/15to8/15,6/1to6/0,9/15to8/15:8/15to7/15:7/15to6/15:6/15to6/14:6/14to6/13:6/13to6/12:6/12to6/11:6/11to6/10:6/10to6/9:6/9to6/8:6/8to6/7:6/7to6/6:6/6to6/5:6/5to6/4:6/4to6/3:6/3to6/2:6/2to6/1:6/1to6/0:,18,True,True
1928,6,123,117,4/9to4/10,10/9to11/9,4/9to4/10:4/10to5/10:5/10to6/10:6/10to7/10:7/10to8/10:8/10to9/10:9/10to10/10:10/10to10/9:10/9to11/9:,9,False,True
941,6,126,120,5/13to4/13,9/12to9/13,5/13to4/13:4/13to4/12:4/12to5/12:5/12to6/12:6/12to7/12:7/12to8/12:8/12to9/12:9/12to9/13:,8,True,True
558,7,179,172,10/15to11/15,11/2to11/1,10/15to11/15:11/15to11/14:11/14to11/13:11/13to11/12:11/12to11/11:11/11to11/10:11/10to11/9:11/9to11/8:11/8to11/7:11/7to11/6:11/6to11/5:11/5to11/4:11/4to11/3:11/3to11/2:11/2to11/1:,15,False,True
2794,7,211,204,8/3to7/3,3/15totop3,8/3to7/3:7/3to6/3:6/3to5/3:5/3to4/3:4/3to3/3:3/3to3/4:3/4to3/5:3/5to3/6:3/6to3/7:3/7to3/8:3/8to3/9:3/9to3/10:3/10to3/11:3/11to3/12:3/12to3/13:3/13to3/14:3/14to3/15:3/15totop3:,18,False,True
2934,7,75,68,4/2to4/3,4/7to5/7,4/2to4/3:4/3to4/4:4/4to4/5:4/5to4/6:4/6to4/7:4/7to5/7:,6,True,True
2446,8,242,234,14/14to14/15,11/0to12/0,14/14to14/15:14/15to13/15:13/15to12/15:12/15to11/15:11/15to11/14:11/14to11/13:11/13to11/12:11/12to11/11:11/11to11/10:11/10to11/9:11/9to11/8:11/8to11/7:11/7to11/6:11/6to11/5:11/5to11/4:11/4to11/3:11/3to11/2:11/2to11/1:11/1to11/0:11/0to12/0:,20,False,True
1710,8,69,61,4/7to4/8,1/8to1/7,4/7to4/8:4/8to3/8:3/8to2/8:2/8to1/8:1/8to1/7:,5,True,True
2576,8,158,150,14/6to13/6,5/8to6/8,14/6to13/6:13/6to12/6:12/6to11/6:11/6to10/6:10/6to9/6:9/6to8/6:8/6to7/6:7/6to6/6:6/6to5/6:5/6to5/7:5/7to5/8:5/8to6/8:,12,True,True
1913,9,263,254,15/0to14/0,9/14to9/13,15/0to14/0:14/0to13/0:13/0to12/0:12/0to11/0:11/0to10/0:10/0to10/1:10/1to10/2:10/2to10/3:10/3to10/4:10/4to10/5:10/5to10/6:10/6to10/7:10/7to10/8:10/8to10/9:10/9to10/10:10/10to10/11:10/11to10/12:10/12to10/13:10/13to10/14:10/14to9/14:9/14to9/13:,21,False,True
3382,9,137,128,7/13to8/13,10/6to9/6,7/13to8/13:8/13to9/13:9/13to10/13:10/13to10/12:10/12to10/11:10/11to10/10:10/10to10/9:10/9to10/8:10/8to10/7:10/7to10/6:10/6to9/6:,11,False,True
1092,9,130,121,5/12to5/13,1/9to0/9,5/12to5/13:5/13to4/13:4/13to3/13:3/13to2/13:2/13to1/13:1/13to1/12:1/12to1/11:1/11to1/10:1/10to1/9:1/9to0/9:,10,False,True
1798,10,75,65,14/10to14/9,11/9to10/9,14/10to14/9:14/9to13/9:13/9to12/9:12/9to11/9:11/9to10/9:,5,False,True
3159,11,290,279,14/10to14/9,2/3to3/3,14/10to14/9:14/9to13/9:13/9to12/9:12/9to11/9:11/9to10/9:10/9to9/9:9/9to8/9:8/9to7/9:7/9to6/9:6/9to5/9:5/9to4/9:4/9to3/9:3/9to2/9:2/9to2/8:2/8to2/7:2/7to2/6:2/6to2/5:2/5to2/4:2/4to2/3:2/3to3/3:,20,False,True
2072,11,216,205,8/4to8/3,12/15to12/14,8/4to8/3:8/3to8/4:8/4to8/5:8/5to8/6:8/6to8/7:8/7to8/8:8/8to8/9:8/9to8/10:8/10to8/11:8/11to8/12:8/12to8/13:8/13to9/13:9/13to10/13:10/13to10/14:10/14to11/14:11/14to11/15:11/15to12/15:12/15to12/14:,18,True,True
2578,11,220,209,14/6to14/7,4/12to4/13,14/6to14/7:14/7to13/7:13/7to12/7:12/7to11/7:11/7to10/7:10/7to9/7:9/7to8/7:8/7to7/7:7/7to6/7:6/7to5/7:5/7to4/7:4/7to4/8:4/8to4/9:4/9to4/10:4/10to4/11:4/11to4/12:4/12to4/13:,17,False,True
735,12,105,93,9/11to9/12,11/8to12/8,9/11to9/12:9/12to10/12:10/12to10/11:10/11to10/10:10/10to10/9:10/9to10/8:10/8to11/8:11/8to12/8:,8,False,True
2769,12,122,110,bottom7to7/0,0/1toleft1,bottom7to7/0:7/0to6/0:6/0to5/0:5/0to4/0:4/0to3/0:3/0to2/0:2/0to1/0:1/0to0/0:0/0to0/1:0/1toleft1:,10,False,True
2228,12,85,73,4/9to4/10,7/11to7/12,4/9to4/10:4/10to4/11:4/11to5/11:5/11to6/11:6/11to7/11:7/11to7/12:,6,True,True
2586,13,59,46,9/8to9/7,8/6to8/5,9/8to9/7:9/7to8/7:8/7to8/6:8/6to8/5:,4,True,True
3001,13,230,217,left2to0/2,6/13to7/13,left2to0/2:0/2to0/3:0/3to0/4:0/4to0/5:0/5to0/6:0/6to0/7:0/7to0/8:0/8to0/9:0/9to0/10:0/10to0/11:0/11to0/12:0/12to0/13:0/13to1/13:1/13to2/13:2/13to3/13:3/13to4/13:4/13to5/13:5/13to6/13:6/13to7/13:,19,True,True
2039,14,116,102,3/7to4/7,8/9to8/10,3/7to4/7:4/7to4/8:4/8to4/9:4/9to5/9:5/9to6/9:6/9to7/9:7/9to8/9:8/9to8/10:,8,False,True
1657,15,267,252,13/5to12/5,1/10to2/10,13/5to12/5:12/5to11/5:11/5to10/5:10/5to9/5:9/5to8/5:8/5to7/5:7/5to6/5:6/5to5/5:5/5to4/5:4/5to3/5:3/5to2/5:2/5to1/5:1/5to1/6:1/6to1/7:1/7to1/8:1/8to1/9:1/9to1/10:1/10to2/10:,18,True,True
2755,15,109,94,7/2to6/2,2/4to2/5,7/2to6/2:6/2to5/2:5/2to4/2:4/2to3/2:3/2to2/2:2/2to2/3:2/3to2/4:2/4to2/5:,8,False,True
1236,15,73,58,6/4to5/4,3/5to4/5,6/4to5/4:5/4to4/4:4/4to3/4:3/4to3/5:3/5to4/5:,5,False,True
2119,15,136,121,12/10to12/11,6/13to6/14,12/10to12/11:12/11to11/11:11/11to10/11:10/11to9/11:9/11to8/11:8/11to7/11:7/11to6/11:6/11to6/12:6/12to6/13:6/13to6/14:,10,True,True
855,15,184,169,12/11to12/10,3/9to3/8,12/11to12/10:12/10to12/9:12/9to11/9:11/9to10/9:10/9to9/9:9/9to8/9:8/9to7/9:7/9to6/9:6/9to5/9:5/9to4/9:4/9to3/9:3/9to3/8:,12,True,True
2649,15,189,174,5/0to4/0,1/9to1/10,5/0to4/0:4/0to3/0:3/0to2/0:2/0to1/0:1/0to1/1:1/1to1/2:1/2to1/3:1/3to1/4:1/4to1/5:1/5to1/6:1/6to1/7:1/7to1/8:1/8to1/9:1/9to1/10:,14,False,True
2424,16,176,160,6/8to7/8,12/15totop12,6/8to7/8:7/8to8/8:8/8to9/8:9/8to10/8:10/8to10/9:10/9to10/10:10/10to10/11:10/11to10/12:10/12to10/13:10/13to10/14:10/14to10/15:10/15to11/15:11/15to12/15:12/15totop12:,14,False,True
646,16,323,307,0/9to0/10,13/0tobottom13,0/9to0/10:0/10to1/10:1/10to2/10:2/10to3/10:3/10to4/10:4/10to5/10:5/10to6/10:6/10to7/10:7/10to8/10:8/10to9/10:9/10to10/10:10/10to10/9:10/9to10/8:10/8to10/7:10/7to10/6:10/6to10/5:10/5to10/4:10/4to10/3:10/3to10/2:10/2to10/1:10/1to10/0:10/0to11/0:11/0to12/0:12/0to13/0:13/0tobottom13:,25,False,True
466,17,89,72,3/14to3/13,4/10to5/10,3/14to3/13:3/13to3/12:3/12to3/11:3/11to3/10:3/10to4/10:4/10to5/10:,6,True,True
1025,17,91,74,8/0to8/1,6/3to6/4,8/0to8/1:8/1to7/1:7/1to6/1:6/1to6/2:6/2to6/3:6/3to6/4:,6,False,True
1691,17,76,59,4/9to4/10,5/12to6/12,4/9to4/10:4/10to4/11:4/11to4/12:4/12to5/12:5/12to6/12:,5,False,True
114,17,396,379,left0to0/0,15/15totop15,left0to0/0:0/0to1/0:1/0to2/0:2/0to3/0:3/0to4/0:4/0to5/0:5/0to6/0:6/0to7/0:7/0to8/0:8/0to9/0:9/0to10/0:10/0to10/1:10/1to10/2:10/2to10/3:10/3to10/4:10/4to10/5:10/5to10/6:10/6to10/7:10/7to10/8:10/8to10/9:10/9to10/10:10/10to10/11:10/11to10/12:10/12to10/13:10/13to10/14:10/14to10/15:10/15to11/15:11/15to12/15:12/15to13/15:13/15to14/15:14/15to15/15:15/15totop15:,32,False,True
2720,17,174,157,1/14to2/14,13/14to13/13,1/14to2/14:2/14to3/14:3/14to4/14:4/14to5/14:5/14to6/14:6/14to7/14:7/14to8/14:8/14to9/14:9/14to10/14:10/14to11/14:11/14to12/14:12/14to13/14:13/14to13/13:,13,False,True
3135,17,126,109,15/14to14/14,12/9to13/9,15/14to14/14:14/14to13/14:13/14to12/14:12/14to12/13:12/13to12/12:12/12to12/11:12/11to12/10:12/10to12/9:12/9to13/9:,9,False,True
1494,17,172,155,1/10to1/9,3/0to4/0,1/10to1/9:1/9to1/8:1/8to1/7:1/7to1/6:1/6to1/5:1/5to1/4:1/4to1/3:1/3to1/2:1/2to1/1:1/1to1/0:1/0to2/0:2/0to3/0:3/0to4/0:,13,True,True
175,17,400,383,left0to0/0,15/15totop15,left0to0/0:0/0to1/0:1/0to2/0:2/0to3/0:3/0to4/0:4/0to5/0:5/0to6/0:6/0to7/0:7/0to8/0:8/0to9/0:9/0to10/0:10/0to10/1:10/1to10/2:10/2to10/3:10/3to10/4:10/4to10/5:10/5to10/6:10/6to10/7:10/7to10/8:10/8to10/9:10/9to10/10:10/10to10/11:10/11to10/12:10/12to10/13:10/13to10/14:10/14to10/15:10/15to11/15:11/15to12/15:12/15to13/15:13/15to14/15:14/15to15/15:15/15totop15:,32,False,True
2420,17,222,205,2/7to3/7,12/12to12/11,2/7to3/7:3/7to4/7:4/7to5/7:5/7to6/7:6/7to7/7:7/7to8/7:8/7to9/7:9/7to10/7:10/7to10/8:10/8to10/9:10/9to10/10:10/10to10/11:10/11to10/12:10/12to11/12:11/12to12/12:12/12to12/11:,16,False,True
919,18,99,81,4/8to4/9,5/13to6/13,4/8to4/9:4/9to4/10:4/10to4/11:4/11to4/12:4/12to4/13:4/13to5/13:5/13to6/13:,7,False,True
10,18,389,371,left15to0/15,15/0tobottom15,left15to0/15:0/15to1/15:1/15to2/15:2/15to3/15:3/15to4/15:4/15to5/15:5/15to6/15:6/15to7/15:7/15to8/15:8/15to9/15:9/15to10/15:10/15to10/14:10/14to10/13:10/13to10/12:10/12to10/11:10/11to10/10:10/10to10/9:10/9to10/8:10/8to10/7:10/7to10/6:10/6to10/5:10/5to10/4:10/4to10/3:10/3to10/2:10/2to10/1:10/1to10/0:10/0to11/0:11/0to12/0:12/0to13/0:13/0to14/0:14/0to15/0:15/0tobottom15:,32,False,True
75,18,392,374,left15to0/15,15/0tobottom15,left15to0/15:0/15to1/15:1/15to2/15:2/15to3/15:3/15to4/15:4/15to5/15:5/15to6/15:6/15to7/15:7/15to8/15:8/15to9/15:9/15to10/15:10/15to10/14:10/14to10/13:10/13to10/12:10/12to10/11:10/11to10/10:10/10to10/9:10/9to10/8:10/8to10/7:10/7to10/6:10/6to10/5:10/5to10/4:10/4to10/3:10/3to10/2:10/2to10/1:10/1to10/0:10/0to11/0:11/0to12/0:12/0to13/0:13/0to14/0:14/0to15/0:15/0tobottom15:,32,False,True
838,18,117,99,9/11to10/11,13/14to14/14,9/11to10/11:10/11to10/12:10/12to10/13:10/13to10/14:10/14to11/14:11/14to12/14:12/14to13/14:13/14to14/14:,8,False,True
2164,19,213,194,12/10to11/10,3/8to4/8,12/10to11/10:11/10to10/10:10/10to9/10:9/10to8/10:8/10to7/10:7/10to6/10:6/10to5/10:5/10to4/10:4/10to3/10:3/10to3/9:3/9to3/8:3/8to4/8:,12,True,True
3197,19,76,57,7/9to6/9,6/12to7/12,7/9to6/9:6/9to6/10:6/10to6/11:6/11to6/12:6/12to7/12:,5,True,True
2563,19,249,230,top8to8/15,1/4to1/3,top8to8/15:8/15to7/15:7/15to6/15:6/15to5/15:5/15to4/15:4/15to3/15:3/15to2/15:2/15to1/15:1/15to1/14:1/14to1/13:1/13to1/12:1/12to1/11:1/11to1/10:1/10to1/9:1/9to1/8:1/8to1/7:1/7to1/6:1/6to1/5:1/5to1/4:1/4to1/3:,20,False,True
3245,20,126,106,4/6to5/6,12/6to12/5,4/6to5/6:5/6to6/6:6/6to7/6:7/6to8/6:8/6to9/6:9/6to10/6:10/6to11/6:11/6to12/6:12/6to12/5:,9,False,True
2471,20,125,105,3/15to3/14,9/14to10/14,3/15to3/14:3/14to4/14:4/14to5/14:5/14to6/14:6/14to7/14:7/14to8/14:8/14to9/14:9/14to10/14:,8,False,True
767,20,299,279,5/0to5/1,13/14to13/15,5/0to5/1:5/1to5/2:5/2to5/3:5/3to5/4:5/4to5/5:5/5to5/6:5/6to5/7:5/7to5/8:5/8to5/9:5/9to5/10:5/10to5/11:5/11to5/12:5/12to5/13:5/13to5/14:5/14to6/14:6/14to7/14:7/14to8/14:8/14to9/14:9/14to10/14:10/14to11/14:11/14to12/14:12/14to13/14:13/14to13/15:,23,True,True
2916,20,330,310,14/14to14/13,2/2to2/1,14/14to14/13:14/13to13/13:13/13to12/13:12/13to11/13:11/13to10/13:10/13to9/13:9/13to8/13:8/13to7/13:7/13to6/13:6/13to5/13:5/13to4/13:4/13to3/13:3/13to2/13:2/13to2/12:2/12to2/11:2/11to2/10:2/10to2/9:2/9to2/8:2/8to2/7:2/7to2/6:2/6to2/5:2/5to2/4:2/4to2/3:2/3to2/2:2/2to2/1:,25,False,True
1130,21,44,23,6/8to7/8,7/8to7/9,6/8to7/8:7/8to7/9:,2,False,True
2669,21,202,181,13/11to12/11,4/7to3/7,13/11to12/11:12/11to11/11:11/11to10/11:10/11to9/11:9/11to8/11:8/11to7/11:7/11to6/11:6/11to5/11:5/11to4/11:4/11to4/10:4/10to4/9:4/9to4/8:4/8to4/7:4/7to3/7:,14,False,True
2137,21,139,118,12/2to11/2,6/4to5/4,12/2to11/2:11/2to10/2:10/2to9/2:9/2to8/2:8/2to7/2:7/2to6/2:6/2to6/3:6/3to6/4:6/4to5/4:,9,False,True
3163,22,154,132,3/5to3/6,9/8to9/9,3/5to3/6:3/6to3/7:3/7to3/8:3/8to4/8:4/8to5/8:5/8to6/8:6/8to7/8:7/8to8/8:8/8to9/8:9/8to9/9:,10,False,True
119,22,408,386,left0to0/0,15/15totop15,left0to0/0:0/0to1/0:1/0to2/0:2/0to3/0:3/0to4/0:4/0to5/0:5/0to6/0:6/0to7/0:7/0to8/0:8/0to9/0:9/0to10/0:10/0to10/1:10/1to10/2:10/2to10/3:10/3to10/4:10/4to10/5:10/5to10/6:10/6to10/7:10/7to10/8:10/8to10/9:10/9to10/10:10/10to10/11:10/11to10/12:10/12to10/13:10/13to10/14:10/14to10/15:10/15to11/15:11/15to12/15:12/15to13/15:13/15to14/15:14/15to15/15:15/15totop15:,32,False,True
320,23,394,371,right0to15/0,0/15totop0,right0to15/0:15/0to14/0:14/0to13/0:13/0to12/0:12/0to11/0:11/0to10/0:10/0to9/0:9/0to8/0:8/0to7/0:7/0to6/0:6/0to5/0:5/0to4/0:4/0to3/0:3/0to2/0:2/0to1/0:1/0to0/0:0/0to0/1:0/1to0/2:0/2to0/3:0/3to0/4:0/4to0/5:0/5to0/6:0/6to0/7:0/7to0/8:0/8to0/9:0/9to0/10:0/10to0/11:0/11to0/12:0/12to0/13:0/13to0/14:0/14to0/15:0/15totop0:,32,True,True
666,23,202,179,2/9to3/9,12/10to13/10,2/9to3/9:3/9to4/9:4/9to5/9:5/9to6/9:6/9to7/9:7/9to8/9:8/9to9/9:9/9to10/9:10/9to10/10:10/10to11/10:11/10to12/10:12/10to13/10:,12,False,True
1188,23,150,127,10/0to9/0,1/0to1/1,10/0to9/0:9/0to8/0:8/0to7/0:7/0to6/0:6/0to5/0:5/0to4/0:4/0to3/0:3/0to2/0:2/0to1/0:1/0to1/1:,10,True,True
1723,24,136,112,10/10to9/10,9/5to9/4,10/10to9/10:9/10to8/10:8/10to8/9:8/9to8/8:8/8to8/7:8/7to8/6:8/6to8/5:8/5to9/5:9/5to9/4:,9,True,True
1478,24,303,279,12/5to12/4,2/13to1/13,12/5to12/4:12/4to11/4:11/4to10/4:10/4to9/4:9/4to8/4:8/4to7/4:7/4to6/4:6/4to5/4:5/4to4/4:4/4to3/4:3/4to2/4:2/4to2/5:2/5to2/6:2/6to2/7:2/7to2/8:2/8to2/9:2/9to2/10:2/10to2/11:2/11to2/12:2/12to2/13:2/13to1/13:,21,True,True
512,24,239,215,11/13to10/13,1/7to1/6,11/13to10/13:10/13to9/13:9/13to8/13:8/13to7/13:7/13to6/13:6/13to5/13:5/13to4/13:4/13to3/13:3/13to2/13:2/13to1/13:1/13to1/12:1/12to1/11:1/11to1/10:1/10to1/9:1/9to1/8:1/8to1/7:1/7to1/6:,17,False,True
1783,24,172,148,6/5to6/6,12/3to13/3,6/5to6/6:6/6to6/5:6/5to7/5:7/5to8/5:8/5to9/5:9/5to10/5:10/5to10/4:10/4to11/4:11/4to11/3:11/3to12/3:12/3to13/3:,11,True,True
649,24,131,107,8/0to9/0,9/7to8/7,8/0to9/0:9/0to9/1:9/1to9/2:9/2to9/3:9/3to9/4:9/4to9/5:9/5to9/6:9/6to9/7:9/7to8/7:,9,False,True
2036,25,96,71,9/1to10/1,11/4to12/4,9/1to10/1:10/1to10/2:10/2to10/3:10/3to11/3:11/3to11/4:11/4to12/4:,6,True,True
2917,25,103,78,5/11to5/12,1/12to0/12,5/11to5/12:5/12to4/12:4/12to3/12:3/12to2/12:2/12to1/12:1/12to0/12:,6,True,True
2911,26,59,33,1/14to1/13,0/13to0/14,1/14to1/13:1/13to0/13:0/13to0/14:,3,False,True
2925,26,213,187,10/1to10/2,9/13to8/13,10/1to10/2:10/2to11/2:11/2to11/3:11/3to11/4:11/4to11/5:11/5to11/6:11/6to11/7:11/7to11/8:11/8to11/9:11/9to11/10:11/10to11/11:11/11to11/12:11/12to11/13:11/13to10/13:10/13to9/13:9/13to8/13:,16,True,True
1255,26,120,94,9/10to8/10,6/14to6/15,9/10to8/10:8/10to7/10:7/10to6/10:6/10to6/11:6/11to6/12:6/12to6/13:6/13to6/14:6/14to6/15:,8,False,True
2070,26,258,232,15/14to15/13,2/11to2/10,15/14to15/13:15/13to14/13:14/13to13/13:13/13to12/13:12/13to12/12:12/12to11/12:11/12to10/12:10/12to9/12:9/12to8/12:8/12to7/12:7/12to6/12:6/12to5/12:5/12to4/12:4/12to3/12:3/12to2/12:2/12to2/11:2/11to2/10:,17,True,True
1613,28,175,147,15/3to15/2,6/3to7/3,15/3to15/2:15/2to14/2:14/2to13/2:13/2to12/2:12/2to11/2:11/2to10/2:10/2to9/2:9/2to8/2:8/2to7/2:7/2to6/2:6/2to6/3:6/3to7/3:,12,True,True
1352,28,149,121,0/1to1/1,4/6to4/5,0/1to1/1:1/1to1/2:1/2to1/3:1/3to1/4:1/4to1/5:1/5to1/6:1/6to2/6:2/6to3/6:3/6to4/6:4/6to4/5:,10,False,True
3354,30,172,142,3/13to2/13,4/5to4/4,3/13to2/13:2/13to2/12:2/12to2/11:2/11to2/10:2/10to2/9:2/9to2/8:2/8to2/7:2/7to2/6:2/6to2/5:2/5to3/5:3/5to4/5:4/5to4/4:,12,True,True
87,30,401,371,left15to0/15,15/0tobottom15,left15to0/15:0/15to1/15:1/15to2/15:2/15to3/15:3/15to4/15:4/15to5/15:5/15to6/15:6/15to7/15:7/15to8/15:8/15to9/15:9/15to10/15:10/15to10/14:10/14to10/13:10/13to10/12:10/12to10/11:10/11to10/10:10/10to10/9:10/9to10/8:10/8to10/7:10/7to10/6:10/6to10/5:10/5to10/4:10/4to10/3:10/3to10/2:10/2to10/1:10/1to10/0:10/0to11/0:11/0to12/0:12/0to13/0:13/0to14/0:14/0to15/0:15/0tobottom15:,32,False,True
2613,30,157,127,4/10to3/10,2/2to1/2,4/10to3/10:3/10to2/10:2/10to2/9:2/9to2/8:2/8to2/7:2/7to2/6:2/6to2/5:2/5to2/4:2/4to2/3:2/3to2/2:2/2to1/2:,11,True,True
2537,30,353,323,left6to0/6,15/15to15/14,left6to0/6:0/6to0/7:0/7to0/8:0/8to0/9:0/9to0/10:0/10to0/11:0/11to0/12:0/12to0/13:0/13to1/13:1/13to2/13:2/13to3/13:3/13to4/13:4/13to5/13:5/13to6/13:6/13to7/13:7/13to8/13:8/13to9/13:9/13to10/13:10/13to10/14:10/14to11/14:11/14to11/15:11/15to12/15:12/15to13/15:13/15to14/15:14/15to15/15:15/15to15/14:,26,True,True
264,31,403,372,right15to15/15,0/0tobottom0,right15to15/15:15/15to14/15:14/15to13/15:13/15to12/15:12/15to11/15:11/15to10/15:10/15to9/15:9/15to8/15:8/15to7/15:7/15to6/15:6/15to5/15:5/15to4/15:4/15to3/15:3/15to2/15:2/15to1/15:1/15to0/15:0/15to0/14:0/14to0/13:0/13to0/12:0/12to0/11:0/11to0/10:0/10to0/9:0/9to0/8:0/8to0/7:0/7to0/6:0/6to0/5:0/5to0/4:0/4to0/3:0/3to0/2:0/2to0/1:0/1to0/0:0/0tobottom0:,32,False,True
2008,31,179,148,4/11to3/11,3/0to2/0,4/11to3/11:3/11to3/10:3/10to3/9:3/9to3/8:3/8to3/7:3/7to3/6:3/6to3/5:3/5to3/4:3/4to3/3:3/3to3/2:3/2to3/1:3/1to3/0:3/0to2/0:,13,False,True
2014,31,146,115,10/1to9/1,9/9to9/10,10/1to9/1:9/1to9/2:9/2to9/3:9/3to9/4:9/4to9/5:9/5to9/6:9/6to9/7:9/7to9/8:9/8to9/9:9/9to9/10:,10,False,True
2984,31,371,340,15/0to14/0,2/14to1/14,15/0to14/0:14/0to13/0:13/0to12/0:12/0to11/0:11/0to10/0:10/0to9/0:9/0to8/0:8/0to7/0:7/0to6/0:6/0to5/0:5/0to4/0:4/0to3/0:3/0to2/0:2/0to2/1:2/1to2/2:2/2to2/3:2/3to2/4:2/4to2/5:2/5to2/6:2/6to2/7:2/7to2/8:2/8to2/9:2/9to2/10:2/10to2/11:2/11to2/12:2/12to2/13:2/13to2/14:2/14to1/14:,28,False,True
1434,32,184,152,left4to0/4,8/1to9/1,left4to0/4:0/4to0/3:0/3to0/2:0/2to0/1:0/1to1/1:1/1to2/1:2/1to3/1:3/1to4/1:4/1to5/1:5/1to6/1:6/1to7/1:7/1to8/1:8/1to9/1:,13,False,True
1066,32,142,110,1/2to2/2,3/8to4/8,1/2to2/2:2/2to2/3:2/3to2/4:2/4to2/5:2/5to2/6:2/6to2/7:2/7to2/8:2/8to3/8:3/8to4/8:,9,False,True
2149,32,70,38,2/15to2/14,2/13to3/13,2/15to2/14:2/14to2/13:2/13to3/13:,3,True,True
1303,32,66,34,4/4to5/4,5/3to4/3,4/4to5/4:5/4to5/3:5/3to4/3:,3,True,True
937,32,207,175,3/14to2/14,9/10to9/11,3/14to2/14:2/14to2/13:2/13to2/12:2/12to2/11:2/11to2/10:2/10to3/10:3/10to4/10:4/10to5/10:5/10to6/10:6/10to7/10:7/10to8/10:8/10to9/10:9/10to9/11:,13,False,True
2053,32,68,36,14/2to13/2,13/3to13/4,14/2to13/2:13/2to13/3:13/3to13/4:,3,False,True
2264,32,220,188,6/8to7/8,15/2toright2,6/8to7/8:7/8to8/8:8/8to9/8:9/8to10/8:10/8to10/7:10/7to10/6:10/6to10/5:10/5to10/4:10/4to10/3:10/3to10/2:10/2to11/2:11/2to12/2:12/2to13/2:13/2to14/2:14/2to15/2:15/2toright2:,16,False,True
2398,32,241,209,14/14to14/13,2/10to2/9,14/14to14/13:14/13to13/13:13/13to12/13:12/13to11/13:11/13to10/13:10/13to9/13:9/13to8/13:8/13to7/13:7/13to6/13:6/13to5/13:5/13to4/13:4/13to3/13:3/13to2/13:2/13to2/12:2/12to2/11:2/11to2/10:2/10to2/9:,17,False,True
147,33,417,384,left0to0/0,15/15totop15,left0to0/0:0/0to1/0:1/0to2/0:2/0to3/0:3/0to4/0:4/0to5/0:5/0to6/0:6/0to7/0:7/0to8/0:8/0to9/0:9/0to10/0:10/0to10/1:10/1to10/2:10/2to10/3:10/3to10/4:10/4to10/5:10/5to10/6:10/6to10/7:10/7to10/8:10/8to10/9:10/9to10/10:10/10to10/11:10/11to10/12:10/12to10/13:10/13to10/14:10/14to10/15:10/15to11/15:11/15to12/15:12/15to13/15:13/15to14/15:14/15to15/15:15/15totop15:,32,False,True
1387,33,226,193,2/13to3/13,14/15totop14,2/13to3/13:3/13to3/14:3/14to4/14:4/14to5/14:5/14to6/14:6/14to7/14:7/14to8/14:8/14to9/14:9/14to10/14:10/14to10/15:10/15to11/15:11/15to12/15:12/15to13/15:13/15to14/15:14/15totop14:,15,True,True
700,33,388,355,13/3to13/2,0/14toleft14,13/3to13/2:13/2to12/2:12/2to11/2:11/2to10/2:10/2to9/2:9/2to8/2:8/2to7/2:7/2to6/2:6/2to5/2:5/2to4/2:4/2to3/2:3/2to2/2:2/2to1/2:1/2to0/2:0/2to0/3:0/3to0/4:0/4to0/5:0/5to0/6:0/6to0/7:0/7to0/8:0/8to0/9:0/9to0/10:0/10to0/11:0/11to0/12:0/12to0/13:0/13to0/14:0/14toleft14:,27,False,True
523,33,88,55,13/13to14/13,15/11toright11,13/13to14/13:14/13to14/12:14/12to14/11:14/11to15/11:15/11toright11:,5,False,True
1759,34,143,109,11/3to10/3,6/6to7/6,11/3to10/3:10/3to9/3:9/3to8/3:8/3to7/3:7/3to6/3:6/3to6/4:6/4to6/5:6/5to6/6:6/6to7/6:,9,True,True
2028,34,142,108,bottom5to5/0,5/8to4/8,bottom5to5/0:5/0to5/1:5/1to5/2:5/2to5/3:5/3to5/4:5/4to5/5:5/5to5/6:5/6to5/7:5/7to5/8:5/8to4/8:,10,True,True
2049,35,242,207,7/6to7/5,10/14to9/14,7/6to7/5:7/5to7/6:7/6to7/7:7/7to7/8:7/8to7/9:7/9to7/10:7/10to7/11:7/11to7/12:7/12to7/13:7/13to8/13:8/13to9/13:9/13to10/13:10/13to10/14:10/14to9/14:,14,True,True
1315,35,115,80,13/2to12/2,8/2to7/2,13/2to12/2:12/2to11/2:11/2to10/2:10/2to9/2:9/2to8/2:8/2to7/2:,6,True,True
709,35,265,230,4/5to5/5,15/11to15/12,4/5to5/5:5/5to5/6:5/6to5/7:5/7to5/8:5/8to5/9:5/9to5/10:5/10to6/10:6/10to7/10:7/10to8/10:8/10to9/10:9/10to10/10:10/10to10/11:10/11to11/11:11/11to12/11:12/11to13/11:13/11to14/11:14/11to15/11:15/11to15/12:,18,True,True
24,35,421,386,left15to0/15,15/0tobottom15,left15to0/15:0/15to1/15:1/15to2/15:2/15to3/15:3/15to4/15:4/15to5/15:5/15to6/15:6/15to7/15:7/15to8/15:8/15to9/15:9/15to10/15:10/15to10/14:10/14to10/13:10/13to10/12:10/12to10/11:10/11to10/10:10/10to10/9:10/9to10/8:10/8to10/7:10/7to10/6:10/6to10/5:10/5to10/4:10/4to10/3:10/3to10/2:10/2to10/1:10/1to10/0:10/0to11/0:11/0to12/0:12/0to13/0:13/0to14/0:14/0to15/0:15/0tobottom15:,32,False,True
762,36,101,65,6/5to7/5,10/5to10/6,6/5to7/5:7/5to8/5:8/5to9/5:9/5to10/5:10/5to10/6:,5,False,True
3128,36,360,324,left0to0/0,11/10to11/11,left0to0/0:0/0to0/1:0/1to0/2:0/2to0/3:0/3to0/4:0/4to0/5:0/5to0/6:0/6to0/7:0/7to0/8:0/8to1/8:1/8to2/8:2/8to3/8:3/8to4/8:4/8to5/8:5/8to6/8:6/8to7/8:7/8to8/8:8/8to9/8:9/8to10/8:10/8to10/9:10/9to11/9:11/9to11/10:11/10to11/11:,23,True,True
1414,36,131,95,15/10to14/10,10/10to10/11,15/10to14/10:14/10to13/10:13/10to12/10:12/10to12/11:12/11to11/11:11/11to10/11:10/11to10/10:10/10to10/11:,8,True,True
852,36,73,37,2/10to2/11,2/12to1/12,2/10to2/11:2/11to2/12:2/12to1/12:,3,True,True
2550,37,124,87,8/11to8/10,10/13to11/13,8/11to8/10:8/10to8/11:8/11to8/12:8/12to8/13:8/13to9/13:9/13to10/13:10/13to11/13:,7,True,True
2913,37,145,108,4/0to3/0,6/4to7/4,4/0to3/0:3/0to3/1:3/1to3/2:3/2to3/3:3/3to3/4:3/4to4/4:4/4to5/4:5/4to6/4:6/4to7/4:,9,False,True
212,37,407,370,right15to15/15,0/0tobottom0,right15to15/15:15/15to14/15:14/15to13/15:13/15to12/15:12/15to11/15:11/15to11/14:11/14to10/14:10/14to9/14:9/14to8/14:8/14to7/14:7/14to6/14:6/14to5/14:5/14to4/14:4/14to3/14:3/14to2/14:2/14to1/14:1/14to0/14:0/14to0/13:0/13to0/12:0/12to0/11:0/11to0/10:0/10to0/9:0/9to0/8:0/8to0/7:0/7to0/6:0/6to0/5:0/5to0/4:0/4to0/3:0/3to0/2:0/2to0/1:0/1to0/0:0/0tobottom0:,32,True,True
303,37,410,373,right0to15/0,0/15totop0,right0to15/0:15/0to14/0:14/0to13/0:13/0to12/0:12/0to11/0:11/0to10/0:10/0to9/0:9/0to8/0:8/0to7/0:7/0to6/0:6/0to5/0:5/0to4/0:4/0to3/0:3/0to2/0:2/0to1/0:1/0to0/0:0/0to0/1:0/1to0/2:0/2to0/3:0/3to0/4:0/4to0/5:0/5to0/6:0/6to0/7:0/7to0/8:0/8to0/9:0/9to0/10:0/10to0/11:0/11to0/12:0/12to0/13:0/13to0/14:0/14to0/15:0/15totop0:,32,False,True
1907,37,178,141,4/14to3/14,2/5to2/4,4/14to3/14:3/14to2/14:2/14to2/13:2/13to2/12:2/12to2/11:2/11to2/10:2/10to2/9:2/9to2/8:2/8to2/7:2/7to2/6:2/6to2/5:2/5to2/4:,12,True,True
12,37,410,373,left15to0/15,15/0tobottom15,left15to0/15:0/15to1/15:1/15to2/15:2/15to3/15:3/15to4/15:4/15to5/15:5/15to6/15:6/15to7/15:7/15to8/15:8/15to9/15:9/15to10/15:10/15to10/14:10/14to10/13:10/13to10/12:10/12to10/11:10/11to10/10:10/10to10/9:10/9to10/8:10/8to10/7:10/7to10/6:10/6to10/5:10/5to10/4:10/4to10/3:10/3to10/2:10/2to10/1:10/1to10/0:10/0to11/0:11/0to12/0:12/0to13/0:13/0to14/0:14/0to15/0:15/0tobottom15:,32,False,True
535,37,162,125,3/8to3/9,7/13to8/13,3/8to3/9:3/9to3/10:3/10to3/11:3/11to3/12:3/12to3/13:3/13to4/13:4/13to5/13:5/13to6/13:6/13to7/13:7/13to8/13:,10,False,True
3181,37,207,170,top13to13/15,3/13to4/13,top13to13/15:13/15to12/15:12/15to11/15:11/15to11/14:11/14to10/14:10/14to9/14:9/14to8/14:8/14to7/14:7/14to6/14:6/14to5/14:5/14to4/14:4/14to3/14:3/14to3/13:3/13to4/13:,14,True,True
2346,37,140,103,10/5to9/5,4/4to5/4,10/5to9/5:9/5to8/5:8/5to7/5:7/5to6/5:6/5to5/5:5/5to4/5:4/5to4/4:4/4to5/4:,8,True,True
1046,38,164,126,5/6to6/6,7/14to7/13,5/6to6/6:6/6to6/7:6/7to6/8:6/8to6/9:6/9to6/10:6/10to6/11:6/11to6/12:6/12to6/13:6/13to6/14:6/14to7/14:7/14to7/13:,11,True,True
1615,38,117,79,13/9to13/10,13/15to14/15,13/9to13/10:13/10to13/11:13/11to13/12:13/12to13/13:13/13to13/14:13/14to13/15:13/15to14/15:,7,True,True
2717,39,111,72,13/8to12/8,10/10to10/11,13/8to12/8:12/8to11/8:11/8to11/9:11/9to11/10:11/10to10/10:10/10to10/11:,6,True,True
1080,39,89,50,9/4to8/4,7/3to7/2,9/4to8/4:8/4to7/4:7/4to7/3:7/3to7/2:,4,True,True
289,39,420,381,right15to15/15,0/0tobottom0,right15to15/15:15/15to14/15:14/15to13/15:13/15to12/15:12/15to11/15:11/15to10/15:10/15to9/15:9/15to8/15:8/15to7/15:7/15to6/15:6/15to5/15:5/15to4/15:4/15to3/15:3/15to2/15:2/15to1/15:1/15to0/15:0/15to0/14:0/14to0/13:0/13to0/12:0/12to0/11:0/11to0/10:0/10to0/9:0/9to0/8:0/8to0/7:0/7to0/6:0/6to0/5:0/5to0/4:0/4to0/3:0/3to0/2:0/2to0/1:0/1to0/0:0/0tobottom0:,32,True,True
2797,39,325,286,1/12to1/13,13/3to14/3,1/12to1/13:1/13to2/13:2/13to3/13:3/13to4/13:4/13to5/13:5/13to6/13:6/13to7/13:7/13to8/13:8/13to9/13:9/13to10/13:10/13to10/12:10/12to10/11:10/11to10/10:10/10to10/9:10/9to10/8:10/8to10/7:10/7to10/6:10/6to10/5:10/5to10/4:10/4to10/3:10/3to11/3:11/3to12/3:12/3to13/3:13/3to14/3:,24,False,True
68,40,424,384,left15to0/15,15/0tobottom15,left15to0/15:0/15to0/14:0/14to0/13:0/13to0/12:0/12to0/11:0/11to0/10:0/10to0/9:0/9to0/8:0/8to0/7:0/7to0/6:0/6to0/5:0/5to0/4:0/4to0/3:0/3to0/2:0/2to1/2:1/2to2/2:2/2to3/2:3/2to4/2:4/2to5/2:5/2to6/2:6/2to7/2:7/2to8/2:8/2to9/2:9/2to10/2:10/2to10/1:10/1to11/1:11/1to11/0:11/0to12/0:12/0to13/0:13/0to14/0:14/0to15/0:15/0tobottom15:,32,True,True
2002,40,198,158,11/9to10/9,3/11to2/11,11/9to10/9:10/9to9/9:9/9to8/9:8/9to7/9:7/9to6/9:6/9to5/9:5/9to4/9:4/9to3/9:3/9to3/10:3/10to3/11:3/11to2/11:,11,False,True
401,41,246,205,4/15to3/15,0/2toleft2,4/15to3/15:3/15to2/15:2/15to1/15:1/15to0/15:0/15to0/14:0/14to0/13:0/13to0/12:0/12to0/11:0/11to0/10:0/10to0/9:0/9to0/8:0/8to0/7:0/7to0/6:0/6to0/5:0/5to0/4:0/4to0/3:0/3to0/2:0/2toleft2:,18,False,True
1501,41,141,100,5/4to5/3,1/0tobottom1,5/4to5/3:5/3to4/3:4/3to3/3:3/3to2/3:2/3to1/3:1/3to1/2:1/2to1/1:1/1to1/0:1/0tobottom1:,9,True,True
379,41,411,370,right0to15/0,0/15totop0,right0to15/0:15/0to14/0:14/0to13/0:13/0to12/0:12/0to11/0:11/0to10/0:10/0to9/0:9/0to8/0:8/0to7/0:7/0to6/0:6/0to5/0:5/0to4/0:4/0to3/0:3/0to2/0:2/0to1/0:1/0to0/0:0/0to0/1:0/1to0/2:0/2to0/3:0/3to0/4:0/4to0/5:0/5to0/6:0/6to0/7:0/7to0/8:0/8to0/9:0/9to0/10:0/10to0/11:0/11to0/12:0/12to0/13:0/13to0/14:0/14to0/15:0/15totop0:,32,False,True
1322,41,158,117,2/11to2/12,8/13to9/13,2/11to2/12:2/12to2/13:2/13to3/13:3/13to4/13:4/13to5/13:5/13to6/13:6/13to7/13:7/13to8/13:8/13to9/13:,9,False,True
80,42,428,386,left15to0/15,15/0tobottom15,left15to0/15:0/15to0/14:0/14to0/13:0/13to0/12:0/12to0/11:0/11to0/10:0/10to0/9:0/9to0/8:0/8to0/7:0/7to0/6:0/6to0/5:0/5to0/4:0/4to0/3:0/3to0/2:0/2to0/1:0/1to0/0:0/0to1/0:1/0to2/0:2/0to3/0:3/0to4/0:4/0to5/0:5/0to6/0:6/0to7/0:7/0to8/0:8/0to9/0:9/0to10/0:10/0to11/0:11/0to12/0:12/0to13/0:13/0to14/0:14/0to15/0:15/0tobottom15:,32,True,True
1997,42,250,208,top13to13/15,2/10to1/10,top13to13/15:13/15to12/15:12/15to11/15:11/15to10/15:10/15to9/15:9/15to8/15:8/15to7/15:7/15to6/15:6/15to5/15:5/15to4/15:4/15to3/15:3/15to2/15:2/15to2/14:2/14to2/13:2/13to2/12:2/12to2/11:2/11to2/10:2/10to1/10:,18,False,True
3319,42,260,218,14/9to13/9,7/1to6/1,14/9to13/9:13/9to12/9:12/9to11/9:11/9to10/9:10/9to9/9:9/9to8/9:8/9to7/9:7/9to7/8:7/8to7/7:7/7to7/6:7/6to7/5:7/5to7/4:7/4to7/3:7/3to7/2:7/2to7/1:7/1to6/1:,16,False,True
1305,42,89,47,14/2to13/2,12/3to13/3,14/2to13/2:13/2to12/2:12/2to12/3:12/3to13/3:,4,False,True
353,43,428,385,right0to15/0,0/15totop0,right0to15/0:15/0to14/0:14/0to13/0:13/0to12/0:12/0to11/0:11/0to10/0:10/0to9/0:9/0to8/0:8/0to7/0:7/0to6/0:6/0to5/0:5/0to4/0:4/0to3/0:3/0to2/0:2/0to1/0:1/0to0/0:0/0to0/1:0/1to0/2:0/2to0/3:0/3to0/4:0/4to0/5:0/5to0/6:0/6to0/7:0/7to0/8:0/8to0/9:0/9to0/10:0/10to0/11:0/11to0/12:0/12to0/13:0/13to0/14:0/14to0/15:0/15totop0:,32,False,True
736,44,117,73,14/7to14/6,15/3to15/2,14/7to14/6:14/6to14/5:14/5to14/4:14/4to14/3:14/3to15/3:15/3to15/2:,6,False,True
3225,44,120,76,9/5to10/5,13/4to14/4,9/5to10/5:10/5to10/4:10/4to11/4:11/4to12/4:12/4to13/4:13/4to14/4:,6,False,True
2275,45,253,208,12/9to11/9,4/3to3/3,12/9to11/9:11/9to10/9:10/9to9/9:9/9to8/9:8/9to7/9:7/9to6/9:6/9to5/9:5/9to4/9:4/9to4/8:4/8to4/7:4/7to4/6:4/6to4/5:4/5to4/4:4/4to4/3:4/3to3/3:,15,True,True
2387,45,245,200,top11to11/15,3/8to3/7,top11to11/15:11/15to10/15:10/15to9/15:9/15to8/15:8/15to7/15:7/15to6/15:6/15to5/15:5/15to4/15:4/15to3/15:3/15to3/14:3/14to3/13:3/13to3/12:3/12to3/11:3/11to3/10:3/10to3/9:3/9to3/8:3/8to3/7:,17,False,True
1975,46,320,274,14/6to14/5,0/0tobottom0,14/6to14/5:14/5to13/5:13/5to12/5:12/5to11/5:11/5to10/5:10/5to9/5:9/5to8/5:8/5to7/5:7/5to6/5:6/5to5/5:5/5to4/5:4/5to3/5:3/5to2/5:2/5to1/5:1/5to0/5:0/5to0/4:0/4to0/3:0/3to0/2:0/2to0/1:0/1to0/0:0/0tobottom0:,21,False,True
1751,46,175,129,2/10to2/9,1/0tobottom1,2/10to2/9:2/9to1/9:1/9to1/8:1/8to1/7:1/7to1/6:1/6to1/5:1/5to1/4:1/4to1/3:1/3to1/2:1/2to1/1:1/1to1/0:1/0tobottom1:,12,False,True
2686,46,68,22,8/14to9/14,9/14to9/13,8/14to9/14:9/14to9/13:,2,False,True
1139,46,148,102,left11to0/11,0/3toleft3,left11to0/11:0/11to0/10:0/10to0/9:0/9to0/8:0/8to0/7:0/7to0/6:0/6to0/5:0/5to0/4:0/4to0/3:0/3toleft3:,10,True,True
3219,47,285,238,12/1to11/1,1/8to2/8,12/1to11/1:11/1to10/1:10/1to9/1:9/1to8/1:8/1to7/1:7/1to6/1:6/1to5/1:5/1to4/1:4/1to3/1:3/1to2/1:2/1to1/1:1/1to1/2:1/2to1/3:1/3to1/4:1/4to1/5:1/5to1/6:1/6to1/7:1/7to1/8:1/8to2/8:,19,True,True
2365,47,73,26,11/15to10/15,10/15to10/14,11/15to10/15:10/15to10/14:,2,True,True
2999,47,122,75,6/4to6/3,4/5to4/6,6/4to6/3:6/3to5/3:5/3to4/3:4/3to4/4:4/4to4/5:4/5to4/6:,6,False,True
981,47,158,111,15/6to14/6,12/0tobottom12,15/6to14/6:14/6to13/6:13/6to12/6:12/6to12/5:12/5to12/4:12/4to12/3:12/3to12/2:12/2to12/1:12/1to12/0:12/0tobottom12:,10,False,True
1518,48,189,141,6/11to6/12,4/4to4/3,6/11to6/12:6/12to5/12:5/12to4/12:4/12to4/11:4/11to4/10:4/10to4/9:4/9to4/8:4/8to4/7:4/7to4/6:4/6to4/5:4/5to4/4:4/4to4/3:,12,True,True
2546,48,281,233,11/4to10/4,4/14to4/15,11/4to10/4:10/4to9/4:9/4to8/4:8/4to7/4:7/4to6/4:6/4to5/4:5/4to4/4:4/4to4/5:4/5to4/6:4/6to4/7:4/7to4/8:4/8to4/9:4/9to4/10:4/10to4/11:4/11to4/12:4/12to4/13:4/13to4/14:4/14to4/15:,18,True,True
608,48,186,138,14/14to14/13,14/3to15/3,14/14to14/13:14/13to14/12:14/12to14/11:14/11to14/10:14/10to14/9:14/9to14/8:14/8to14/7:14/7to14/6:14/6to14/5:14/5to14/4:14/4to14/3:14/3to15/3:,12,False,True
719,49,126,77,13/10to12/10,15/9to15/10,13/10to12/10:12/10to12/9:12/9to13/9:13/9to14/9:14/9to15/9:15/9to15/10:,6,True,True
1290,49,61,12,12/0to13/0,12/0to13/0,12/0to13/0:,1,False,True
2478,49,129,80,13/3to12/3,12/8to13/8,13/3to12/3:12/3to12/4:12/4to12/5:12/5to12/6:12/6to12/7:12/7to12/8:12/8to13/8:,7,False,True
2434,49,188,139,7/1to7/2,8/10to9/10,7/1to7/2:7/2to7/3:7/3to7/4:7/4to7/5:7/5to7/6:7/6to7/7:7/7to7/8:7/8to7/9:7/9to7/10:7/10to8/10:8/10to9/10:,11,False,True
1927,50,268,218,3/7to4/7,13/2to14/2,3/7to4/7:4/7to5/7:5/7to6/7:6/7to7/7:7/7to8/7:8/7to9/7:9/7to10/7:10/7to10/6:10/6to10/5:10/5to10/4:10/4to10/3:10/3to10/2:10/2to11/2:11/2to12/2:12/2to13/2:13/2to14/2:,16,False,True
1496,50,84,34,2/13to2/14,3/14to3/15,2/13to2/14:2/14to3/14:3/14to3/15:,3,True,True
547,50,86,36,11/9to11/10,10/10to10/11,11/9to11/10:11/10to10/10:10/10to10/11:,3,True,True
1497,51,236,185,6/12to7/12,12/4to13/4,6/12to7/12:7/12to8/12:8/12to9/12:9/12to10/12:10/12to10/11:10/11to10/10:10/10to10/9:10/9to10/8:10/8to10/7:10/7to10/6:10/6to10/5:10/5to10/4:10/4to11/4:11/4to12/4:12/4to13/4:,15,False,True
774,51,109,58,14/1to14/2,15/4to15/5,14/1to14/2:14/2to14/3:14/3to14/4:14/4to15/4:15/4to15/5:,5,True,True
1476,51,139,88,10/15to10/14,14/13to15/13,10/15to10/14:10/14to10/13:10/13to11/13:11/13to12/13:12/13to13/13:13/13to14/13:14/13to15/13:,7,False,True
1556,51,232,181,7/13to6/13,5/1to6/1,7/13to6/13:6/13to5/13:5/13to5/12:5/12to5/11:5/11to5/10:5/10to5/9:5/9to5/8:5/8to5/7:5/7to5/6:5/6to5/5:5/5to5/4:5/4to5/3:5/3to5/2:5/2to5/1:5/1to6/1:,15,False,True
2615,51,329,278,15/11to15/10,1/6to2/6,15/11to15/10:15/10to14/10:14/10to13/10:13/10to12/10:12/10to11/10:11/10to10/10:10/10to9/10:9/10to8/10:8/10to7/10:7/10to6/10:6/10to5/10:5/10to4/10:4/10to3/10:3/10to2/10:2/10to1/10:1/10to1/9:1/9to1/8:1/8to1/7:1/7to1/6:1/6to2/6:,20,False,True
992,51,325,274,1/5to2/5,13/14to13/15,1/5to2/5:2/5to3/5:3/5to4/5:4/5to5/5:5/5to6/5:6/5to7/5:7/5to8/5:8/5to9/5:9/5to10/5:10/5to10/6:10/6to10/7:10/7to10/8:10/8to10/9:10/9to10/10:10/10to10/11:10/11to10/12:10/12to10/13:10/13to10/14:10/14to11/14:11/14to12/14:12/14to13/14:13/14to13/15:,22,False,True
3241,52,254,202,14/7to14/8,3/10to3/11,14/7to14/8:14/8to13/8:13/8to12/8:12/8to11/8:11/8to10/8:10/8to9/8:9/8to8/8:8/8to7/8:7/8to6/8:6/8to5/8:5/8to4/8:4/8to3/8:3/8to3/9:3/9to3/10:3/10to3/11:,15,False,True
1540,52,368,316,bottom3to3/0,14/10to14/9,bottom3to3/0:3/0to3/1:3/1to3/2:3/2to3/3:3/3to3/4:3/4to3/5:3/5to3/6:3/6to3/7:3/7to3/8:3/8to4/8:4/8to5/8:5/8to6/8:6/8to7/8:7/8to8/8:8/8to9/8:9/8to10/8:10/8to10/9:10/9to11/9:11/9to12/9:12/9to12/10:12/10to13/10:13/10to14/10:14/10to14/9:,23,True,True
1366,52,275,223,11/8to10/8,0/2to0/1,11/8to10/8:10/8to9/8:9/8to8/8:8/8to7/8:7/8to6/8:6/8to5/8:5/8to4/8:4/8to3/8:3/8to2/8:2/8to1/8:1/8to0/8:0/8to0/7:0/7to0/6:0/6to0/5:0/5to0/4:0/4to0/3:0/3to0/2:0/2to0/1:,18,False,True
3275,52,260,208,2/3to3/3,10/10to10/11,2/3to3/3:3/3to4/3:4/3to5/3:5/3to6/3:6/3to7/3:7/3to8/3:8/3to9/3:9/3to10/3:10/3to10/4:10/4to10/5:10/5to10/6:10/6to10/7:10/7to10/8:10/8to10/9:10/9to10/10:10/10to10/11:,16,False,True
1368,52,226,174,12/13to13/13,14/1to15/1,12/13to13/13:13/13to13/12:13/12to13/11:13/11to13/10:13/10to13/9:13/9to13/8:13/8to13/7:13/7to13/6:13/6to13/5:13/5to13/4:13/4to13/3:13/3to13/2:13/2to13/1:13/1to14/1:14/1to15/1:,15,False,True
1754,52,247,195,6/15to5/15,0/5toleft5,6/15to5/15:5/15to4/15:4/15to3/15:3/15to2/15:2/15to1/15:1/15to0/15:0/15to0/14:0/14to0/13:0/13to0/12:0/12to0/11:0/11to0/10:0/10to0/9:0/9to0/8:0/8to0/7:0/7to0/6:0/6to0/5:0/5toleft5:,17,True,True
2923,53,89,36,11/3to11/4,12/4to13/4,11/3to11/4:11/4to12/4:12/4to13/4:,3,False,True
1594,53,117,64,3/3to4/3,7/3to8/3,3/3to4/3:4/3to5/3:5/3to6/3:6/3to7/3:7/3to8/3:,5,False,True
190,53,487,434,left0to0/0,15/15totop15,left0to0/0:0/0to0/1:0/1to0/2:0/2to0/3:0/3to0/4:0/4to0/5:0/5to0/6:0/6to0/7:0/7to0/8:0/8to0/9:0/9to0/10:0/10to0/11:0/11to0/12:0/12to0/13:0/13to0/14:0/14to1/14:1/14to2/14:2/14to3/14:3/14to4/14:4/14to5/14:5/14to6/14:6/14to7/14:7/14to8/14:8/14to9/14:9/14to10/14:10/14to10/15:10/15to11/15:11/15to12/15:12/15to13/15:13/15to14/15:14/15to15/15:15/15totop15:,32,True,True
2694,53,177,124,7/0to7/1,2/4to3/4,7/0to7/1:7/1to6/1:6/1to5/1:5/1to4/1:4/1to3/1:3/1to2/1:2/1to2/2:2/2to2/3:2/3to2/4:2/4to3/4:,10,True,True
1153,53,285,232,10/14to9/14,3/3to2/3,10/14to9/14:9/14to8/14:8/14to7/14:7/14to6/14:6/14to5/14:5/14to4/14:4/14to3/14:3/14to3/13:3/13to3/12:3/12to3/11:3/11to3/10:3/10to3/9:3/9to3/8:3/8to3/7:3/7to3/6:3/6to3/5:3/5to3/4:3/4to3/3:3/3to2/3:,19,False,True
2128,53,149,96,right7to15/7,14/13to14/14,right7to15/7:15/7to14/7:14/7to14/8:14/8to14/9:14/9to14/10:14/10to14/11:14/11to14/12:14/12to14/13:14/13to14/14:,9,True,True
1606,54,217,163,1/7to0/7,8/10to8/11,1/7to0/7:0/7to0/8:0/8to0/9:0/9to0/10:0/10to1/10:1/10to2/10:2/10to3/10:3/10to4/10:4/10to5/10:5/10to6/10:6/10to7/10:7/10to8/10:8/10to8/11:,13,True,True
563,54,322,268,right8to15/8,2/13to3/13,right8to15/8:15/8to14/8:14/8to13/8:13/8to12/8:12/8to11/8:11/8to10/8:10/8to9/8:9/8to8/8:8/8to7/8:7/8to6/8:6/8to5/8:5/8to4/8:4/8to3/8:3/8to2/8:2/8to2/9:2/9to2/10:2/10to2/11:2/11to2/12:2/12to2/13:2/13to3/13:,20,False,True
477,54,233,179,bottom2to2/0,12/3to12/2,bottom2to2/0:2/0to2/1:2/1to3/1:3/1to4/1:4/1to5/1:5/1to6/1:6/1to7/1:7/1to8/1:8/1to9/1:9/1to10/1:10/1to10/2:10/2to11/2:11/2to11/3:11/3to12/3:12/3to12/2:,15,True,True
2332,55,258,203,15/8to15/7,4/9to4/10,15/8to15/7:15/7to14/7:14/7to13/7:13/7to12/7:12/7to11/7:11/7to10/7:10/7to9/7:9/7to8/7:8/7to7/7:7/7to6/7:6/7to5/7:5/7to4/7:4/7to4/8:4/8to4/9:4/9to4/10:,15,False,True
6,55,430,375,left15to0/15,15/0tobottom15,left15to0/15:0/15to1/15:1/15to2/15:2/15to3/15:3/15to4/15:4/15to5/15:5/15to6/15:6/15to7/15:7/15to8/15:8/15to9/15:9/15to10/15:10/15to10/14:10/14to10/13:10/13to10/12:10/12to10/11:10/11to10/10:10/10to10/9:10/9to10/8:10/8to10/7:10/7to10/6:10/6to10/5:10/5to10/4:10/4to10/3:10/3to10/2:10/2to10/1:10/1to10/0:10/0to11/0:11/0to12/0:12/0to13/0:13/0to14/0:14/0to15/0:15/0tobottom15:,32,False,True
2176,55,206,151,14/4to13/4,5/2to5/1,14/4to13/4:13/4to12/4:12/4to12/3:12/3to11/3:11/3to10/3:10/3to9/3:9/3to8/3:8/3to7/3:7/3to6/3:6/3to5/3:5/3to5/2:5/2to5/1:,12,True,True
1853,56,81,25,13/7to14/7,14/7to14/6,13/7to14/7:14/7to14/6:,2,False,True
1938,56,248,192,11/3to11/2,4/9to4/10,11/3to11/2:11/2to10/2:10/2to9/2:9/2to8/2:8/2to7/2:7/2to6/2:6/2to5/2:5/2to4/2:4/2to4/3:4/3to4/4:4/4to4/5:4/5to4/6:4/6to4/7:4/7to4/8:4/8to4/9:4/9to4/10:,16,True,True
647,56,445,389,left0to0/0,15/15totop15,left0to0/0:0/0to1/0:1/0to2/0:2/0to3/0:3/0to4/0:4/0to5/0:5/0to6/0:6/0to7/0:7/0to8/0:8/0to9/0:9/0to10/0:10/0to10/1:10/1to10/2:10/2to10/3:10/3to10/4:10/4to10/5:10/5to10/6:10/6to10/7:10/7to10/8:10/8to10/9:10/9to10/10:10/10to10/11:10/11to10/12:10/12to10/13:10/13to10/14:10/14to10/15:10/15to11/15:11/15to12/15:12/15to13/15:13/15to14/15:14/15to15/15:15/15totop15:,32,False,True
3364,56,330,274,10/12to10/13,0/3toleft3,10/12to10/13:10/13to9/13:9/13to8/13:8/13to7/13:7/13to6/13:6/13to5/13:5/13to4/13:4/13to3/13:3/13to2/13:2/13to1/13:1/13to0/13:0/13to0/12:0/12to0/11:0/11to0/10:0/10to0/9:0/9to0/8:0/8to0/7:0/7to0/6:0/6to0/5:0/5to0/4:0/4to0/3:0/3toleft3:,22,False,True
996,57,225,168,6/6to6/5,15/7to15/8,6/6to6/5:6/5to7/5:7/5to8/5:8/5to9/5:9/5to10/5:10/5to10/6:10/6to10/7:10/7to11/7:11/7to12/7:12/7to13/7:13/7to14/7:14/7to15/7:15/7to15/8:,13,False,True
2492,57,180,123,2/3to2/2,9/0tobottom9,2/3to2/2:2/2to2/1:2/1to2/0:2/0to3/0:3/0to4/0:4/0to5/0:5/0to6/0:6/0to7/0:7/0to8/0:8/0to9/0:9/0tobottom9:,11,False,True
1392,57,228,171,7/8to8/8,14/15totop14,7/8to8/8:8/8to9/8:9/8to10/8:10/8to10/9:10/9to10/10:10/10to10/11:10/11to10/12:10/12to10/13:10/13to10/14:10/14to10/15:10/15to11/15:11/15to12/15:12/15to13/15:13/15to14/15:14/15totop14:,15,False,True
2912,57,340,283,12/5to12/6,1/14to1/15,12/5to12/6:12/6to11/6:11/6to11/7:11/7to10/7:10/7to9/7:9/7to8/7:8/7to7/7:7/7to6/7:6/7to5/7:5/7to4/7:4/7to3/7:3/7to2/7:2/7to1/7:1/7to1/8:1/8to1/9:1/9to1/10:1/10to1/11:1/11to1/12:1/12to1/13:1/13to1/14:1/14to1/15:,21,True,True
465,58,150,92,5/4to5/5,6/10to6/9,5/4to5/5:5/5to5/6:5/6to5/7:5/7to5/8:5/8to5/9:5/9to5/10:5/10to6/10:6/10to6/9:,8,False,True
837,58,361,303,left2to0/2,14/9to15/9,left2to0/2:0/2to0/3:0/3to0/4:0/4to0/5:0/5to0/6:0/6to0/7:0/7to0/8:0/8to1/8:1/8to2/8:2/8to3/8:3/8to4/8:4/8to5/8:5/8to6/8:6/8to7/8:7/8to8/8:8/8to9/8:9/8to10/8:10/8to10/9:10/9to11/9:11/9to12/9:12/9to13/9:13/9to14/9:14/9to15/9:,23,True,True
2976,58,320,262,4/10to4/11,14/1to14/2,4/10to4/11:4/11to4/10:4/10to4/9:4/9to4/8:4/8to4/7:4/7to4/6:4/6to4/5:4/5to4/4:4/4to4/3:4/3to4/2:4/2to5/2:5/2to6/2:6/2to7/2:7/2to8/2:8/2to9/2:9/2to10/2:10/2to10/1:10/1to11/1:11/1to12/1:12/1to13/1:13/1to14/1:14/1to14/2:,22,True,True
3201,58,214,156,6/11to6/12,15/14toright14,6/11to6/12:6/12to6/13:6/13to6/14:6/14to7/14:7/14to8/14:8/14to9/14:9/14to10/14:10/14to11/14:11/14to12/14:12/14to13/14:13/14to14/14:14/14to15/14:15/14toright14:,13,True,True
1530,59,339,280,1/13to2/13,11/2to11/1,1/13to2/13:2/13to2/12:2/12to2/11:2/11to2/10:2/10to2/9:2/9to2/8:2/8to2/7:2/7to2/6:2/6to2/5:2/5to2/4:2/4to2/3:2/3to3/3:3/3to4/3:4/3to5/3:5/3to6/3:6/3to7/3:7/3to8/3:8/3to9/3:9/3to10/3:10/3to10/2:10/2to11/2:11/2to11/1:,22,True,True
1809,59,107,48,6/5to7/5,8/6to8/7,6/5to7/5:7/5to7/6:7/6to8/6:8/6to8/7:,4,True,True
1480,59,218,159,12/12to12/11,4/14to4/15,12/12to12/11:12/11to11/11:11/11to10/11:10/11to9/11:9/11to8/11:8/11to7/11:7/11to6/11:6/11to5/11:5/11to4/11:4/11to4/12:4/12to4/13:4/13to4/14:4/14to4/15:,13,True,True
990,60,419,359,left3to0/3,15/15to15/14,left3to0/3:0/3to1/3:1/3to2/3:2/3to3/3:3/3to4/3:4/3to5/3:5/3to6/3:6/3to7/3:7/3to8/3:8/3to9/3:9/3to10/3:10/3to10/4:10/4to10/5:10/5to10/6:10/6to10/7:10/7to10/8:10/8to10/9:10/9to10/10:10/10to10/11:10/11to10/12:10/12to10/13:10/13to10/14:10/14to10/15:10/15to11/15:11/15to12/15:12/15to13/15:13/15to14/15:14/15to15/15:15/15to15/14:,29,False,True
769,60,170,110,0/14to1/14,7/15totop7,0/14to1/14:1/14to1/15:1/15to2/15:2/15to3/15:3/15to4/15:4/15to5/15:5/15to6/15:6/15to7/15:7/15totop7:,9,False,True
3094,60,325,265,15/9to14/9,1/8to1/7,15/9to14/9:14/9to13/9:13/9to12/9:12/9to11/9:11/9to11/8:11/8to10/8:10/8to9/8:9/8to8/8:8/8to7/8:7/8to6/8:6/8to5/8:5/8to4/8:4/8to3/8:3/8to2/8:2/8to1/8:1/8to1/7:,16,True,True
3030,60,283,223,11/15to10/15,7/2to7/1,11/15to10/15:10/15to9/15:9/15to8/15:8/15to7/15:7/15to7/14:7/14to7/13:7/13to7/12:7/12to7/11:7/11to7/10:7/10to7/9:7/9to7/8:7/8to7/7:7/7to7/6:7/6to7/5:7/5to7/4:7/4to7/3:7/3to7/2:7/2to7/1:,18,False,True
3274,61,211,150,top14to14/15,14/3to13/3,top14to14/15:14/15to14/14:14/14to14/13:14/13to14/12:14/12to14/11:14/11to14/10:14/10to14/9:14/9to14/8:14/8to14/7:14/7to14/6:14/6to14/5:14/5to14/4:14/4to14/3:14/3to13/3:,14,True,True
1089,61,130,69,11/2to10/2,13/3to13/4,11/2to10/2:10/2to10/3:10/3to11/3:11/3to12/3:12/3to13/3:13/3to13/4:,6,False,True
802,61,230,169,8/13to8/12,14/7to14/8,8/13to8/12:8/12to9/12:9/12to10/12:10/12to10/11:10/11to10/10:10/10to10/9:10/9to10/8:10/8to10/7:10/7to11/7:11/7to12/7:12/7to13/7:13/7to14/7:14/7to14/8:,13,False,True
601,61,330,269,12/0to11/0,1/10to2/10,12/0to11/0:11/0to11/1:11/1to10/1:10/1to9/1:9/1to8/1:8/1to7/1:7/1to6/1:6/1to5/1:5/1to4/1:4/1to3/1:3/1to2/1:2/1to1/1:1/1to1/2:1/2to1/3:1/3to1/4:1/4to1/5:1/5to1/6:1/6to1/7:1/7to1/8:1/8to1/9:1/9to1/10:1/10to2/10:,22,True,True
2374,61,108,47,6/9to6/10,6/12to7/12,6/9to6/10:6/10to6/11:6/11to6/12:6/12to7/12:,4,True,True
2161,62,201,139,right1to15/1,14/11to15/11,right1to15/1:15/1to14/1:14/1to14/2:14/2to14/3:14/3to14/4:14/4to14/5:14/5to14/6:14/6to14/7:14/7to14/8:14/8to14/9:14/9to14/10:14/10to14/11:14/11to15/11:,13,True,True
1679,62,162,100,15/4to15/5,10/6to10/7,15/4to15/5:15/5to14/5:14/5to13/5:13/5to12/5:12/5to11/5:11/5to10/5:10/5to10/6:10/6to10/7:,8,False,True
989,62,265,203,1/2to1/3,13/1to14/1,1/2to1/3:1/3to2/3:2/3to3/3:3/3to4/3:4/3to5/3:5/3to6/3:6/3to7/3:7/3to8/3:8/3to9/3:9/3to10/3:10/3to10/2:10/2to10/1:10/1to11/1:11/1to12/1:12/1to13/1:13/1to14/1:,16,False,True
1208,62,142,80,8/7to9/7,10/5to11/5,8/7to9/7:9/7to10/7:10/7to11/7:11/7to11/6:11/6to11/5:11/5to10/5:10/5to11/5:,7,True,True
1198,63,182,119,2/12to1/12,2/5to2/4,2/12to1/12:1/12to1/11:1/11to1/10:1/10to1/9:1/9to1/8:1/8to1/7:1/7to1/6:1/6to1/5:1/5to2/5:2/5to2/4:,10,False,True
2463,63,86,23,8/13to8/14,8/14to9/14,8/13to8/14:8/14to9/14:,2,False,True
2404,64,312,248,3/12to3/11,15/6toright6,3/12to3/11:3/11to3/10:3/10to3/9:3/9to3/8:3/8to4/8:4/8to5/8:5/8to6/8:6/8to7/8:7/8to8/8:8/8to9/8:9/8to10/8:10/8to10/7:10/7to11/7:11/7to11/6:11/6to12/6:12/6to13/6:13/6to14/6:14/6to15/6:15/6toright6:,19,True,True
1228,64,153,89,10/7to9/7,5/6to5/5,10/7to9/7:9/7to8/7:8/7to7/7:7/7to6/7:6/7to5/7:5/7to5/6:5/6to5/5:,7,False,True
1937,65,219,154,7/2to7/1,5/10to5/11,7/2to7/1:7/1to6/1:6/1to5/1:5/1to5/2:5/2to5/3:5/3to5/4:5/4to5/5:5/5to5/6:5/6to5/7:5/7to5/8:5/8to5/9:5/9to5/10:5/10to5/11:,13,True,True
457,65,261,196,8/9to7/9,0/3to1/3,8/9to7/9:7/9to6/9:6/9to5/9:5/9to4/9:4/9to3/9:3/9to2/9:2/9to1/9:1/9to0/9:0/9to0/8:0/8to0/7:0/7to0/6:0/6to0/5:0/5to0/4:0/4to0/3:0/3to1/3:,15,True,True
1848,65,288,223,2/1to1/1,5/14to5/15,2/1to1/1:1/1to1/2:1/2to1/3:1/3to1/4:1/4to1/5:1/5to1/6:1/6to1/7:1/7to1/8:1/8to1/9:1/9to1/10:1/10to1/11:1/11to1/12:1/12to1/13:1/13to1/14:1/14to2/14:2/14to3/14:3/14to4/14:4/14to5/14:5/14to5/15:,19,True,True
932,66,148,82,2/5to1/5,2/9to3/9,2/5to1/5:1/5to1/6:1/6to1/7:1/7to1/8:1/8to1/9:1/9to2/9:2/9to3/9:,7,False,True
1874,66,168,102,5/3to5/4,1/3to2/3,5/3to5/4:5/4to4/4:4/4to3/4:3/4to2/4:2/4to1/4:1/4to1/3:1/3to2/3:,7,False,True
3054,66,221,155,top2to2/15,0/4toleft4,top2to2/15:2/15to1/15:1/15to0/15:0/15to0/14:0/14to0/13:0/13to0/12:0/12to0/11:0/11to0/10:0/10to0/9:0/9to0/8:0/8to0/7:0/7to0/6:0/6to0/5:0/5to0/4:0/4toleft4:,15,False,True
2501,66,180,114,12/1to11/1,7/4to6/4,12/1to11/1:11/1to10/1:10/1to9/1:9/1to8/1:8/1to7/1:7/1to7/2:7/2to7/3:7/3to7/4:7/4to6/4:,9,False,True
1663,66,391,325,15/2to14/2,2/15totop2,15/2to14/2:14/2to13/2:13/2to12/2:12/2to11/2:11/2to10/2:10/2to9/2:9/2to8/2:8/2to7/2:7/2to6/2:6/2to5/2:5/2to4/2:4/2to3/2:3/2to2/2:2/2to2/3:2/3to2/4:2/4to2/5:2/5to2/6:2/6to2/7:2/7to2/8:2/8to2/9:2/9to2/10:2/10to2/11:2/11to2/12:2/12to2/13:2/13to2/14:2/14to2/15:2/15totop2:,27,False,True
3345,66,290,224,15/7to14/7,1/7to1/8,15/7to14/7:14/7to13/7:13/7to12/7:12/7to11/7:11/7to10/7:10/7to9/7:9/7to8/7:8/7to7/7:7/7to6/7:6/7to5/7:5/7to4/7:4/7to3/7:3/7to2/7:2/7to1/7:1/7to1/8:,15,False,True
373,67,441,374,right0to15/0,0/15totop0,right0to15/0:15/0to14/0:14/0to13/0:13/0to12/0:12/0to11/0:11/0to11/1:11/1to10/1:10/1to9/1:9/1to8/1:8/1to7/1:7/1to6/1:6/1to5/1:5/1to4/1:4/1to3/1:3/1to2/1:2/1to1/1:1/1to0/1:0/1to0/2:0/2to0/3:0/3to0/4:0/4to0/5:0/5to0/6:0/6to0/7:0/7to0/8:0/8to0/9:0/9to0/10:0/10to0/11:0/11to0/12:0/12to0/13:0/13to0/14:0/14to0/15:0/15totop0:,32,True,True
1280,67,167,100,3/6to3/7,9/7to9/6,3/6to3/7:3/7to4/7:4/7to5/7:5/7to6/7:6/7to7/7:7/7to8/7:8/7to9/7:9/7to9/6:,8,False,True
86,67,456,389,left15to0/15,15/0tobottom15,left15to0/15:0/15to1/15:1/15to2/15:2/15to3/15:3/15to4/15:4/15to5/15:5/15to6/15:6/15to7/15:7/15to8/15:8/15to9/15:9/15to10/15:10/15to10/14:10/14to10/13:10/13to10/12:10/12to10/11:10/11to10/10:10/10to10/9:10/9to10/8:10/8to10/7:10/7to10/6:10/6to10/5:10/5to10/4:10/4to10/3:10/3to10/2:10/2to10/1:10/1to10/0:10/0to11/0:11/0to12/0:12/0to13/0:13/0to14/0:14/0to15/0:15/0tobottom15:,32,False,True
1970,68,209,141,top10to10/15,14/9to15/9,top10to10/15:10/15to10/14:10/14to11/14:11/14to12/14:12/14to12/13:12/13to12/12:12/12to12/11:12/11to12/10:12/10to12/9:12/9to13/9:13/9to14/9:14/9to15/9:,12,True,True
3021,69,290,221,11/0to10/0,13/14to14/14,11/0to10/0:10/0to10/1:10/1to10/2:10/2to10/3:10/3to10/4:10/4to10/5:10/5to10/6:10/6to10/7:10/7to10/8:10/8to10/9:10/9to10/10:10/10to10/11:10/11to10/12:10/12to10/13:10/13to10/14:10/14to11/14:11/14to12/14:12/14to13/14:13/14to14/14:,19,False,True
3039,69,190,121,4/8to5/8,10/6to11/6,4/8to5/8:5/8to6/8:6/8to7/8:7/8to8/8:8/8to9/8:9/8to10/8:10/8to10/7:10/7to10/6:10/6to11/6:,9,False,True
30,69,458,389,left15to0/15,15/0tobottom15,left15to0/15:0/15to1/15:1/15to2/15:2/15to3/15:3/15to4/15:4/15to5/15:5/15to6/15:6/15to7/15:7/15to8/15:8/15to9/15:9/15to10/15:10/15to10/14:10/14to10/13:10/13to10/12:10/12to10/11:10/11to10/10:10/10to10/9:10/9to10/8:10/8to10/7:10/7to10/6:10/6to10/5:10/5to10/4:10/4to10/3:10/3to10/2:10/2to10/1:10/1to10/0:10/0to11/0:11/0to12/0:12/0to13/0:13/0to14/0:14/0to15/0:15/0tobottom15:,32,False,True
2360,69,197,128,2/13to2/12,3/4to3/5,2/13to2/12:2/12to2/11:2/11to2/10:2/10to2/9:2/9to2/8:2/8to2/7:2/7to2/6:2/6to2/5:2/5to2/4:2/4to3/4:3/4to3/5:,11,True,True
1778,69,293,224,7/13to8/13,13/2to13/3,7/13to8/13:8/13to8/12:8/12to8/11:8/11to8/10:8/10to8/9:8/9to8/8:8/8to8/7:8/7to8/6:8/6to8/5:8/5to8/4:8/4to8/3:8/3to8/2:8/2to9/2:9/2to10/2:10/2to11/2:11/2to12/2:12/2to13/2:13/2to13/3:,18,True,True
1640,69,174,105,13/12to14/12,14/5to15/5,13/12to14/12:14/12to14/11:14/11to14/10:14/10to14/9:14/9to14/8:14/8to14/7:14/7to14/6:14/6to14/5:14/5to15/5:,9,False,True
2514,69,206,137,5/3to5/4,13/3to14/3,5/3to5/4:5/4to6/4:6/4to7/4:7/4to8/4:8/4to9/4:9/4to10/4:10/4to10/3:10/3to11/3:11/3to12/3:12/3to13/3:13/3to14/3:,11,False,True
2257,69,211,142,12/0to11/0,7/5to6/5,12/0to11/0:11/0to11/1:11/1to10/1:10/1to9/1:9/1to8/1:8/1to7/1:7/1to7/2:7/2to7/3:7/3to7/4:7/4to7/5:7/5to6/5:,11,True,True
361,70,457,387,right0to15/0,0/15totop0,right0to15/0:15/0to14/0:14/0to13/0:13/0to12/0:12/0to11/0:11/0to11/1:11/1to10/1:10/1to9/1:9/1to8/1:8/1to7/1:7/1to6/1:6/1to5/1:5/1to4/1:4/1to3/1:3/1to2/1:2/1to1/1:1/1to0/1:0/1to0/2:0/2to0/3:0/3to0/4:0/4to0/5:0/5to0/6:0/6to0/7:0/7to0/8:0/8to0/9:0/9to0/10:0/10to0/11:0/11to0/12:0/12to0/13:0/13to0/14:0/14to0/15:0/15totop0:,32,True,True
1031,70,237,167,7/14to8/14,12/6to12/7,7/14to8/14:8/14to9/14:9/14to10/14:10/14to10/13:10/13to10/12:10/12to10/11:10/11to10/10:10/10to10/9:10/9to10/8:10/8to10/7:10/7to10/6:10/6to11/6:11/6to12/6:12/6to12/7:,14,False,True
2625,70,199,129,3/5to2/5,1/13to0/13,3/5to2/5:2/5to1/5:1/5to1/6:1/6to1/7:1/7to1/8:1/8to1/9:1/9to1/10:1/10to1/11:1/11to1/12:1/12to1/13:1/13to0/13:,11,False,True
1960,71,179,108,6/14to6/15,10/12to11/12,6/14to6/15:6/15to7/15:7/15to8/15:8/15to9/15:9/15to10/15:10/15to10/14:10/14to10/13:10/13to10/12:10/12to11/12:,9,False,True
826,71,328,257,5/13to5/14,10/5to9/5,5/13to5/14:5/14to5/13:5/13to5/12:5/12to5/11:5/11to5/10:5/10to5/9:5/9to5/8:5/8to5/7:5/7to5/6:5/6to5/5:5/5to6/5:6/5to7/5:7/5to8/5:8/5to9/5:9/5to10/5:10/5to9/5:,16,True,True
927,72,235,163,10/3to11/3,15/11toright11,10/3to11/3:11/3to11/4:11/4to11/5:11/5to11/6:11/6to11/7:11/7to11/8:11/8to11/9:11/9to11/10:11/10to11/11:11/11to12/11:12/11to13/11:13/11to14/11:14/11to15/11:15/11toright11:,14,False,True
2254,72,183,111,13/7to12/7,6/7to5/7,13/7to12/7:12/7to11/7:11/7to10/7:10/7to9/7:9/7to8/7:8/7to7/7:7/7to6/7:6/7to5/7:,8,False,True
1586,73,258,185,1/14to1/13,10/10to11/10,1/14to1/13:1/13to2/13:2/13to3/13:3/13to4/13:4/13to5/13:5/13to6/13:6/13to7/13:7/13to8/13:8/13to9/13:9/13to10/13:10/13to10/12:10/12to10/11:10/11to10/10:10/10to11/10:,14,False,True
3186,73,231,158,9/4to10/4,9/14to8/14,9/4to10/4:10/4to10/5:10/5to10/6:10/6to10/7:10/7to10/8:10/8to10/9:10/9to10/10:10/10to10/11:10/11to10/12:10/12to10/13:10/13to10/14:10/14to9/14:9/14to8/14:,13,False,True
2746,73,262,189,bottom8to8/0,1/7to0/7,bottom8to8/0:8/0to7/0:7/0to6/0:6/0to5/0:5/0to4/0:4/0to3/0:3/0to2/0:2/0to1/0:1/0to1/1:1/1to1/2:1/2to1/3:1/3to1/4:1/4to1/5:1/5to1/6:1/6to1/7:1/7to0/7:,16,True,True
609,73,182,109,12/3to11/3,7/6to7/7,12/3to11/3:11/3to10/3:10/3to9/3:9/3to8/3:8/3to7/3:7/3to7/4:7/4to7/5:7/5to7/6:7/6to7/7:,9,False,True
1082,75,130,55,13/11to13/10,14/9to15/9,13/11to13/10:13/10to13/9:13/9to14/9:14/9to15/9:,4,False,True
3261,75,251,176,1/6to0/6,9/8to10/8,1/6to0/6:0/6to0/7:0/7to0/8:0/8to1/8:1/8to2/8:2/8to3/8:3/8to4/8:4/8to5/8:5/8to6/8:6/8to7/8:7/8to8/8:8/8to9/8:9/8to10/8:,13,True,True
921,75,208,133,left9to0/9,4/6to4/7,left9to0/9:0/9to0/8:0/8to0/7:0/7to0/6:0/6to1/6:1/6to2/6:2/6to3/6:3/6to4/6:4/6to4/7:,9,False,True
556,76,160,84,8/10to8/11,7/7to8/7,8/10to8/11:8/11to7/11:7/11to7/10:7/10to7/9:7/9to7/8:7/8to7/7:7/7to8/7:,7,True,True
471,76,175,99,15/7to15/8,11/6to11/5,15/7to15/8:15/8to14/8:14/8to13/8:13/8to12/8:12/8to11/8:11/8to11/7:11/7to11/6:11/6to11/5:,8,False,True
571,76,124,48,11/13to10/13,9/12to8/12,11/13to10/13:10/13to10/12:10/12to9/12:9/12to8/12:,4,False,True
554,78,238,160,12/14to11/14,5/9to5/8,12/14to11/14:11/14to10/14:10/14to9/14:9/14to8/14:8/14to7/14:7/14to6/14:6/14to5/14:5/14to5/13:5/13to5/12:5/12to5/11:5/11to5/10:5/10to5/9:5/9to5/8:,13,True,True
1871,78,208,130,12/7to11/7,13/1to14/1,12/7to11/7:11/7to11/6:11/6to11/5:11/5to11/4:11/4to11/3:11/3to11/2:11/2to11/1:11/1to12/1:12/1to13/1:13/1to14/1:,10,False,True
1048,79,163,84,13/10to12/10,9/8to9/9,13/10to12/10:12/10to11/10:11/10to10/10:10/10to10/9:10/9to10/8:10/8to9/8:9/8to9/9:,7,False,True
335,79,451,372,right0to15/0,0/15totop0,right0to15/0:15/0to14/0:14/0to13/0:13/0to12/0:12/0to11/0:11/0to10/0:10/0to9/0:9/0to8/0:8/0to7/0:7/0to6/0:6/0to5/0:5/0to4/0:4/0to3/0:3/0to2/0:2/0to1/0:1/0to0/0:0/0to0/1:0/1to0/2:0/2to0/3:0/3to0/4:0/4to0/5:0/5to0/6:0/6to0/7:0/7to0/8:0/8to0/9:0/9to0/10:0/10to0/11:0/11to0/12:0/12to0/13:0/13to0/14:0/14to0/15:0/15totop0:,32,False,True
530,80,222,142,14/9to13/9,10/2to9/2,14/9to13/9:13/9to12/9:12/9to11/9:11/9to10/9:10/9to10/8:10/8to10/7:10/7to10/6:10/6to10/5:10/5to10/4:10/4to10/3:10/3to10/2:10/2to9/2:,12,False,True
2723,80,383,303,0/13to1/13,13/7to14/7,0/13to1/13:1/13to1/12:1/12to1/11:1/11to1/10:1/10to1/9:1/9to1/8:1/8to2/8:2/8to3/8:3/8to4/8:4/8to5/8:5/8to6/8:6/8to7/8:7/8to8/8:8/8to9/8:9/8to10/8:10/8to10/7:10/7to11/7:11/7to12/7:12/7to13/7:13/7to14/7:,20,True,True
2101,80,210,130,5/15to5/14,6/6to7/6,5/15to5/14:5/14to5/13:5/13to5/12:5/12to5/11:5/11to5/10:5/10to5/9:5/9to5/8:5/8to5/7:5/7to5/6:5/6to6/6:6/6to7/6:,11,False,True
418,80,277,197,4/1to4/2,2/15to3/15,4/1to4/2:4/2to3/2:3/2to2/2:2/2to2/3:2/3to2/4:2/4to2/5:2/5to2/6:2/6to2/7:2/7to2/8:2/8to2/9:2/9to2/10:2/10to2/11:2/11to2/12:2/12to2/13:2/13to2/14:2/14to2/15:2/15to3/15:,17,False,True
1262,81,253,172,top7to7/15,12/7to13/7,top7to7/15:7/15to7/14:7/14to7/13:7/13to7/12:7/12to7/11:7/11to7/10:7/10to7/9:7/9to8/9:8/9to9/9:9/9to10/9:10/9to10/8:10/8to11/8:11/8to12/8:12/8to12/7:12/7to13/7:,15,True,True
2198,81,325,244,right2to15/2,7/12to7/13,right2to15/2:15/2to14/2:14/2to13/2:13/2to12/2:12/2to11/2:11/2to10/2:10/2to9/2:9/2to8/2:8/2to7/2:7/2to7/3:7/3to7/4:7/4to7/5:7/5to7/6:7/6to7/7:7/7to7/8:7/8to7/9:7/9to7/10:7/10to7/11:7/11to7/12:7/12to7/13:,20,False,True
113,81,490,409,left0to0/0,15/15totop15,left0to0/0:0/0to0/1:0/1to0/2:0/2to0/3:0/3to0/4:0/4to0/5:0/5to0/6:0/6to0/7:0/7to0/8:0/8to0/9:0/9to0/10:0/10to0/11:0/11to0/12:0/12to0/13:0/13to0/14:0/14to1/14:1/14to2/14:2/14to3/14:3/14to4/14:4/14to5/14:5/14to6/14:6/14to7/14:7/14to8/14:8/14to9/14:9/14to10/14:10/14to10/15:10/15to11/15:11/15to12/15:12/15to13/15:13/15to14/15:14/15to15/15:15/15totop15:,32,True,True
1158,81,372,291,15/9to14/9,0/12to0/13,15/9to14/9:14/9to13/9:13/9to12/9:12/9to11/9:11/9to10/9:10/9to9/9:9/9to8/9:8/9to7/9:7/9to6/9:6/9to5/9:5/9to4/9:4/9to3/9:3/9to2/9:2/9to1/9:1/9to0/9:0/9to0/10:0/10to0/11:0/11to0/12:0/12to0/13:,19,False,True
3058,82,215,133,12/5to12/6,7/10to7/11,12/5to12/6:12/6to11/6:11/6to10/6:10/6to9/6:9/6to8/6:8/6to7/6:7/6to7/7:7/7to7/8:7/8to7/9:7/9to7/10:7/10to7/11:,11,False,True
2457,82,153,71,11/14to10/14,11/11to11/10,11/14to10/14:10/14to10/13:10/13to10/12:10/12to10/11:10/11to11/11:11/11to11/10:,6,False,True
57,82,461,379,left15to0/15,15/0tobottom15,left15to0/15:0/15to1/15:1/15to2/15:2/15to3/15:3/15to4/15:4/15to5/15:5/15to6/15:6/15to7/15:7/15to8/15:8/15to9/15:9/15to10/15:10/15to10/14:10/14to10/13:10/13to10/12:10/12to10/11:10/11to10/10:10/10to10/9:10/9to10/8:10/8to10/7:10/7to10/6:10/6to10/5:10/5to10/4:10/4to10/3:10/3to10/2:10/2to10/1:10/1to10/0:10/0to11/0:11/0to12/0:12/0to13/0:13/0to14/0:14/0to15/0:15/0tobottom15:,32,False,True
409,82,314,232,4/14to4/13,9/0tobottom9,4/14to4/13:4/13to4/12:4/12to4/11:4/11to4/10:4/10to4/9:4/9to4/8:4/8to4/7:4/7to4/6:4/6to4/5:4/5to4/4:4/4to4/3:4/3to4/2:4/2to4/1:4/1to4/0:4/0to5/0:5/0to6/0:6/0to7/0:7/0to8/0:8/0to9/0:9/0tobottom9:,20,True,True
2721,82,177,95,11/6to10/6,8/10to8/11,11/6to10/6:10/6to9/6:9/6to8/6:8/6to8/7:8/7to8/8:8/8to8/9:8/9to8/10:8/10to8/11:,8,True,True
1137,82,266,184,5/14to4/14,0/4toleft4,5/14to4/14:4/14to3/14:3/14to2/14:2/14to1/14:1/14to0/14:0/14to0/13:0/13to0/12:0/12to0/11:0/11to0/10:0/10to0/9:0/9to0/8:0/8to0/7:0/7to0/6:0/6to0/5:0/5to0/4:0/4toleft4:,16,False,True
1625,82,334,252,8/14to9/14,15/3to15/2,8/14to9/14:9/14to9/13:9/13to9/12:9/12to9/11:9/11to9/10:9/10to9/9:9/9to9/8:9/8to9/7:9/7to9/6:9/6to9/5:9/5to9/4:9/4to9/3:9/3to10/3:10/3to11/3:11/3to12/3:12/3to13/3:13/3to14/3:14/3to15/3:15/3to15/2:,19,True,True
1587,82,387,305,right15to15/15,5/1to6/1,right15to15/15:15/15to14/15:14/15to13/15:13/15to12/15:12/15to11/15:11/15to11/14:11/14to10/14:10/14to9/14:9/14to8/14:8/14to7/14:7/14to6/14:6/14to5/14:5/14to5/13:5/13to5/12:5/12to5/11:5/11to5/10:5/10to5/9:5/9to5/8:5/8to5/7:5/7to5/6:5/6to5/5:5/5to5/4:5/4to5/3:5/3to5/2:5/2to5/1:5/1to6/1:,26,True,True
1945,83,316,233,11/0to10/0,14/14to15/14,11/0to10/0:10/0to10/1:10/1to10/2:10/2to10/3:10/3to10/4:10/4to10/5:10/5to10/6:10/6to10/7:10/7to10/8:10/8to10/9:10/9to10/10:10/10to10/11:10/11to10/12:10/12to10/13:10/13to10/14:10/14to11/14:11/14to12/14:12/14to13/14:13/14to14/14:14/14to15/14:,20,False,True
2442,83,366,283,right14to15/14,4/3to4/2,right14to15/14:15/14to14/14:14/14to13/14:13/14to12/14:12/14to11/14:11/14to10/14:10/14to9/14:9/14to8/14:8/14to7/14:7/14to6/14:6/14to5/14:5/14to4/14:4/14to4/13:4/13to4/12:4/12to4/11:4/11to4/10:4/10to4/9:4/9to4/8:4/8to4/7:4/7to4/6:4/6to4/5:4/5to4/4:4/4to4/3:4/3to4/2:,24,False,True
1111,83,263,180,9/4to8/4,0/1to0/0,9/4to8/4:8/4to7/4:7/4to6/4:6/4to5/4:5/4to4/4:4/4to3/4:3/4to2/4:2/4to1/4:1/4to0/4:0/4to0/3:0/3to0/2:0/2to0/1:0/1to0/0:,13,False,True
2369,83,222,139,11/13to11/14,2/14to2/15,11/13to11/14:11/14to10/14:10/14to9/14:9/14to8/14:8/14to7/14:7/14to6/14:6/14to5/14:5/14to4/14:4/14to3/14:3/14to2/14:2/14to2/15:,11,False,True
1192,83,247,164,2/12to2/13,13/13to14/13,2/12to2/13:2/13to3/13:3/13to4/13:4/13to5/13:5/13to6/13:6/13to7/13:7/13to8/13:8/13to9/13:9/13to10/13:10/13to11/13:11/13to12/13:12/13to13/13:13/13to14/13:,13,False,True
3228,83,405,322,right3to15/3,3/15totop3,right3to15/3:15/3to14/3:14/3to13/3:13/3to12/3:12/3to11/3:11/3to10/3:10/3to9/3:9/3to8/3:8/3to7/3:7/3to6/3:6/3to5/3:5/3to4/3:4/3to3/3:3/3to3/4:3/4to3/5:3/5to3/6:3/6to3/7:3/7to3/8:3/8to3/9:3/9to3/10:3/10to3/11:3/11to3/12:3/12to3/13:3/13to3/14:3/14to3/15:3/15totop3:,26,False,True
3146,83,342,259,15/13to14/13,3/5to3/4,15/13to14/13:14/13to13/13:13/13to12/13:12/13to11/13:11/13to10/13:10/13to9/13:9/13to8/13:8/13to7/13:7/13to6/13:6/13to5/13:5/13to4/13:4/13to3/13:3/13to3/12:3/12to3/11:3/11to3/10:3/10to3/9:3/9to3/8:3/8to3/7:3/7to3/6:3/6to3/5:3/5to3/4:,21,False,True
2804,83,224,141,left10to0/10,6/14to6/13,left10to0/10:0/10to0/11:0/11to0/12:0/12to0/13:0/13to0/14:0/14to1/14:1/14to2/14:2/14to3/14:3/14to4/14:4/14to5/14:5/14to6/14:6/14to6/13:,12,True,True
3059,85,347,262,1/5to2/5,10/7to10/8,1/5to2/5:2/5to3/5:3/5to4/5:4/5to5/5:5/5to6/5:6/5to7/5:7/5to8/5:8/5to9/5:9/5to10/5:10/5to10/6:10/6to10/7:10/7to10/8:,12,True,True
3306,86,489,403,1/4to2/4,13/12to14/12,1/4to2/4:2/4to2/5:2/5to2/6:2/6to2/7:2/7to2/8:2/8to2/9:2/9to2/10:2/10to2/11:2/11to3/11:3/11to4/11:4/11to5/11:5/11to6/11:6/11to7/11:7/11to8/11:8/11to9/11:9/11to10/11:10/11to10/12:10/12to11/12:11/12to12/12:12/12to13/12:13/12to14/12:,21,True,True
1027,86,397,311,15/10to15/9,0/14to0/15,15/10to15/9:15/9to14/9:14/9to13/9:13/9to12/9:12/9to11/9:11/9to10/9:10/9to9/9:9/9to8/9:8/9to7/9:7/9to6/9:6/9to5/9:5/9to4/9:4/9to3/9:3/9to2/9:2/9to1/9:1/9to0/9:0/9to0/10:0/10to0/11:0/11to0/12:0/12to0/13:0/13to0/14:0/14to0/15:,22,False,True
3084,86,161,75,7/5to8/5,8/9to8/10,7/5to8/5:8/5to8/6:8/6to8/7:8/7to8/8:8/8to8/9:8/9to8/10:,6,True,True
574,87,135,48,7/5to7/4,7/2to8/2,7/5to7/4:7/4to7/3:7/3to7/2:7/2to8/2:,4,True,True
1143,87,208,121,4/4to4/3,10/1to11/1,4/4to4/3:4/3to5/3:5/3to6/3:6/3to7/3:7/3to8/3:8/3to9/3:9/3to10/3:10/3to10/2:10/2to10/1:10/1to11/1:,10,False,True
550,88,129,41,11/11to10/11,10/12to10/13,11/11to10/11:10/11to10/12:10/12to10/13:,3,False,True
925,88,156,68,2/11to1/11,2/14to2/13,2/11to1/11:1/11to1/12:1/12to1/13:1/13to1/14:1/14to2/14:2/14to2/13:,6,True,True
860,88,356,268,14/8to14/7,3/13to3/14,14/8to14/7:14/7to13/7:13/7to12/7:12/7to11/7:11/7to10/7:10/7to9/7:9/7to8/7:8/7to7/7:7/7to6/7:6/7to5/7:5/7to4/7:4/7to3/7:3/7to3/8:3/8to3/9:3/9to3/10:3/10to3/11:3/11to3/12:3/12to3/13:3/13to3/14:,19,False,True
200,88,458,370,right15to15/15,0/0tobottom0,right15to15/15:15/15to14/15:14/15to13/15:13/15to12/15:12/15to11/15:11/15to10/15:10/15to9/15:9/15to8/15:8/15to7/15:7/15to6/15:6/15to5/15:5/15to4/15:4/15to3/15:3/15to2/15:2/15to1/15:1/15to0/15:0/15to0/14:0/14to0/13:0/13to0/12:0/12to0/11:0/11to0/10:0/10to0/9:0/9to0/8:0/8to0/7:0/7to0/6:0/6to0/5:0/5to0/4:0/4to0/3:0/3to0/2:0/2to0/1:0/1to0/0:0/0tobottom0:,32,True,True
3348,89,332,243,6/2to6/1,10/15to11/15,6/2to6/1:6/1to7/1:7/1to8/1:8/1to9/1:9/1to10/1:10/1to10/2:10/2to10/3:10/3to10/4:10/4to10/5:10/5to10/6:10/6to10/7:10/7to10/8:10/8to10/9:10/9to10/10:10/10to10/11:10/11to10/12:10/12to10/13:10/13to10/14:10/14to10/15:10/15to11/15:,20,False,True
713,89,268,179,12/4to11/4,4/9to4/10,12/4to11/4:11/4to10/4:10/4to9/4:9/4to8/4:8/4to7/4:7/4to6/4:6/4to5/4:5/4to4/4:4/4to4/5:4/5to4/6:4/6to4/7:4/7to4/8:4/8to4/9:4/9to4/10:,14,False,True
2677,89,263,174,3/5to4/5,10/6to11/6,3/5to4/5:4/5to5/5:5/5to6/5:6/5to7/5:7/5to8/5:8/5to9/5:9/5to10/5:10/5to10/6:10/6to11/6:,9,False,True
671,89,173,84,14/0to15/0,15/5to14/5,14/0to15/0:15/0to15/1:15/1to15/2:15/2to15/3:15/3to15/4:15/4to15/5:15/5to14/5:,7,True,True
3313,89,205,116,bottom14to14/0,14/9to15/9,bottom14to14/0:14/0to14/1:14/1to14/2:14/2to14/3:14/3to14/4:14/4to14/5:14/5to14/6:14/6to14/7:14/7to14/8:14/8to14/9:14/9to15/9:,11,False,True
568,89,384,295,0/1to0/0,11/7to11/8,0/1to0/0:0/0to0/1:0/1to0/2:0/2to0/3:0/3to0/4:0/4to0/5:0/5to0/6:0/6to0/7:0/7to1/7:1/7to2/7:2/7to3/7:3/7to4/7:4/7to5/7:5/7to6/7:6/7to7/7:7/7to8/7:8/7to9/7:9/7to10/7:10/7to11/7:11/7to11/8:,20,True,True
536,89,173,84,6/12to6/11,1/11to1/12,6/12to6/11:6/11to5/11:5/11to4/11:4/11to3/11:3/11to2/11:2/11to1/11:1/11to1/12:,7,True,True
688,90,380,290,14/11to14/12,1/4to1/3,14/11to14/12:14/12to13/12:13/12to12/12:12/12to11/12:11/12to10/12:10/12to9/12:9/12to8/12:8/12to7/12:7/12to6/12:6/12to5/12:5/12to4/12:4/12to3/12:3/12to2/12:2/12to1/12:1/12to1/11:1/11to1/10:1/10to1/9:1/9to1/8:1/8to1/7:1/7to1/6:1/6to1/5:1/5to1/4:1/4to1/3:,23,False,True
2352,90,141,51,15/6to15/5,15/2toright2,15/6to15/5:15/5to15/4:15/4to15/3:15/3to15/2:15/2toright2:,5,False,True
2672,90,191,101,6/2to6/1,5/7to5/8,6/2to6/1:6/1to5/1:5/1to5/2:5/2to5/3:5/3to5/4:5/4to5/5:5/5to5/6:5/6to5/7:5/7to5/8:,9,False,True
3316,90,424,334,12/2to12/3,0/12toleft12,12/2to12/3:12/3to11/3:11/3to10/3:10/3to9/3:9/3to8/3:8/3to7/3:7/3to6/3:6/3to5/3:5/3to4/3:4/3to3/3:3/3to2/3:2/3to1/3:1/3to0/3:0/3to0/4:0/4to0/5:0/5to0/6:0/6to0/7:0/7to0/8:0/8to0/9:0/9to0/10:0/10to0/11:0/11to0/12:0/12toleft12:,23,True,True
2147,91,226,135,4/1to4/2,10/5to10/6,4/1to4/2:4/2to5/2:5/2to6/2:6/2to7/2:7/2to8/2:8/2to9/2:9/2to10/2:10/2to10/3:10/3to10/4:10/4to10/5:10/5to10/6:,11,False,True
504,91,446,355,13/10to12/10,0/3toleft3,13/10to12/10:12/10to12/9:12/9to11/9:11/9to10/9:10/9to9/9:9/9to8/9:8/9to7/9:7/9to6/9:6/9to5/9:5/9to4/9:4/9to3/9:3/9to2/9:2/9to1/9:1/9to0/9:0/9to0/8:0/8to0/7:0/7to0/6:0/6to0/5:0/5to0/4:0/4to0/3:0/3toleft3:,21,True,True
1844,91,381,290,right12to15/12,1/6to2/6,right12to15/12:15/12to14/12:14/12to13/12:13/12to12/12:12/12to11/12:11/12to11/11:11/11to10/11:10/11to9/11:9/11to8/11:8/11to7/11:7/11to6/11:6/11to5/11:5/11to4/11:4/11to3/11:3/11to2/11:2/11to1/11:1/11to1/10:1/10to1/9:1/9to1/8:1/8to1/7:1/7to1/6:1/6to2/6:,22,True,True
1706,91,135,44,8/2to9/2,10/1to9/1,8/2to9/2:9/2to10/2:10/2to10/1:10/1to9/1:,4,False,True
1306,91,198,107,4/11to5/11,7/7to7/6,4/11to5/11:5/11to5/10:5/10to5/9:5/9to5/8:5/8to5/7:5/7to6/7:6/7to7/7:7/7to7/6:,8,False,True
2001,92,188,96,2/8to2/9,3/15totop3,2/8to2/9:2/9to2/10:2/10to2/11:2/11to2/12:2/12to2/13:2/13to2/14:2/14to2/15:2/15to3/15:3/15totop3:,9,True,True
884,92,145,53,right10to15/10,12/10to12/11,right10to15/10:15/10to14/10:14/10to13/10:13/10to12/10:12/10to12/11:,5,False,True
798,93,358,265,0/15to1/15,14/10to14/9,0/15to1/15:1/15to2/15:2/15to3/15:3/15to4/15:4/15to5/15:5/15to6/15:6/15to7/15:7/15to8/15:8/15to9/15:9/15to10/15:10/15to10/14:10/14to10/13:10/13to10/12:10/12to10/11:10/11to10/10:10/10to11/10:11/10to12/10:12/10to13/10:13/10to14/10:14/10to14/9:,20,False,True
2009,93,290,197,14/14to14/15,0/15totop0,14/14to14/15:14/15to13/15:13/15to12/15:12/15to11/15:11/15to10/15:10/15to9/15:9/15to8/15:8/15to7/15:7/15to6/15:6/15to5/15:5/15to4/15:4/15to3/15:3/15to2/15:2/15to1/15:1/15to0/15:0/15totop0:,16,False,True
1562,93,332,239,1/13to2/13,10/5to11/5,1/13to2/13:2/13to2/12:2/12to2/11:2/11to2/10:2/10to2/9:2/9to2/8:2/8to2/7:2/7to2/6:2/6to2/5:2/5to3/5:3/5to4/5:4/5to5/5:5/5to6/5:6/5to7/5:7/5to8/5:8/5to9/5:9/5to10/5:10/5to11/5:,18,True,True
2787,94,155,61,6/12to7/12,7/9to8/9,6/12to7/12:7/12to7/11:7/11to7/10:7/10to7/9:7/9to8/9:,5,False,True
2789,95,213,118,10/3to9/3,8/10to8/11,10/3to9/3:9/3to8/3:8/3to8/4:8/4to8/5:8/5to8/6:8/6to8/7:8/7to8/8:8/8to8/9:8/9to8/10:8/10to8/11:,10,False,True
1004,95,284,189,10/14to10/13,15/4to15/3,10/14to10/13:10/13to10/12:10/12to10/11:10/11to10/10:10/10to10/9:10/9to10/8:10/8to10/7:10/7to10/6:10/6to10/5:10/5to10/4:10/4to11/4:11/4to12/4:12/4to13/4:13/4to14/4:14/4to15/4:15/4to15/3:,16,False,True
2231,95,161,66,8/14to8/13,11/13to12/13,8/14to8/13:8/13to9/13:9/13to10/13:10/13to11/13:11/13to12/13:,5,False,True
308,95,474,379,right0to15/0,0/15totop0,right0to15/0:15/0to14/0:14/0to13/0:13/0to12/0:12/0to11/0:11/0to10/0:10/0to9/0:9/0to8/0:8/0to7/0:7/0to6/0:6/0to5/0:5/0to4/0:4/0to3/0:3/0to2/0:2/0to1/0:1/0to0/0:0/0to0/1:0/1to0/2:0/2to0/3:0/3to0/4:0/4to0/5:0/5to0/6:0/6to0/7:0/7to0/8:0/8to0/9:0/9to0/10:0/10to0/11:0/11to0/12:0/12to0/13:0/13to0/14:0/14to0/15:0/15totop0:,32,True,True
1811,95,251,156,13/11to12/11,11/0tobottom11,13/11to12/11:12/11to11/11:11/11to11/10:11/10to11/9:11/9to11/8:11/8to11/7:11/7to11/6:11/6to11/5:11/5to11/4:11/4to11/3:11/3to11/2:11/2to11/1:11/1to11/0:11/0tobottom11:,14,True,True
2799,96,280,184,7/9to7/8,15/3to15/4,7/9to7/8:7/8to7/7:7/7to7/6:7/6to7/5:7/5to8/5:8/5to9/5:9/5to10/5:10/5to10/4:10/4to11/4:11/4to11/3:11/3to12/3:12/3to13/3:13/3to14/3:14/3to15/3:15/3to15/4:,15,True,True
2508,96,214,118,6/7to6/6,4/12to3/12,6/7to6/6:6/6to5/6:5/6to4/6:4/6to4/7:4/7to4/8:4/8to4/9:4/9to4/10:4/10to4/11:4/11to4/12:4/12to3/12:,10,False,True
1569,96,163,67,12/14to12/13,14/12to14/13,12/14to12/13:12/13to12/12:12/12to13/12:13/12to14/12:14/12to14/13:,5,False,True
1053,96,272,176,3/12to3/13,13/14to13/13,3/12to3/13:3/13to4/13:4/13to5/13:5/13to6/13:6/13to7/13:7/13to8/13:8/13to9/13:9/13to10/13:10/13to10/14:10/14to11/14:11/14to12/14:12/14to13/14:13/14to13/13:,13,True,True
495,97,232,135,7/9to7/8,10/2to10/1,7/9to7/8:7/8to8/8:8/8to9/8:9/8to10/8:10/8to10/7:10/7to10/6:10/6to10/5:10/5to10/4:10/4to10/3:10/3to10/2:10/2to10/1:,11,False,True
1774,97,285,188,5/7to5/8,12/14to13/14,5/7to5/8:5/8to5/9:5/9to5/10:5/10to5/11:5/11to5/12:5/12to5/13:5/13to6/13:6/13to7/13:7/13to8/13:8/13to9/13:9/13to10/13:10/13to10/14:10/14to11/14:11/14to12/14:12/14to13/14:,15,True,True
1532,97,300,203,15/0to14/0,2/0to1/0,15/0to14/0:14/0to13/0:13/0to12/0:12/0to11/0:11/0to11/1:11/1to10/1:10/1to9/1:9/1to8/1:8/1to7/1:7/1to6/1:6/1to5/1:5/1to4/1:4/1to3/1:3/1to2/1:2/1to2/0:2/0to1/0:,16,True,True
1274,97,227,130,10/15to10/14,14/9to14/8,10/15to10/14:10/14to10/13:10/13to11/13:11/13to11/12:11/12to11/11:11/11to11/10:11/10to11/9:11/9to12/9:12/9to13/9:13/9to14/9:14/9to14/8:,11,True,True
1430,97,346,249,12/0to12/1,0/7to1/7,12/0to12/1:12/1to11/1:11/1to10/1:10/1to9/1:9/1to8/1:8/1to7/1:7/1to6/1:6/1to5/1:5/1to4/1:4/1to3/1:3/1to2/1:2/1to1/1:1/1to0/1:0/1to0/2:0/2to0/3:0/3to0/4:0/4to0/5:0/5to0/6:0/6to0/7:0/7to1/7:,20,True,True
2151,98,112,14,0/1to0/0,0/0toleft0,0/1to0/0:0/0toleft0:,2,True,True
3156,98,278,180,11/2to10/2,6/11to5/11,11/2to10/2:10/2to9/2:9/2to8/2:8/2to7/2:7/2to6/2:6/2to6/3:6/3to6/4:6/4to6/5:6/5to6/6:6/6to6/7:6/7to6/8:6/8to6/9:6/9to6/10:6/10to6/11:6/11to5/11:,15,True,True
1394,98,215,117,3/14to3/15,1/10to0/10,3/14to3/15:3/15to2/15:2/15to1/15:1/15to1/14:1/14to1/13:1/13to1/12:1/12to1/11:1/11to1/10:1/10to0/10:,9,False,True
988,99,139,40,4/4to5/4,5/5to6/5,4/4to5/4:5/4to5/5:5/5to6/5:,3,False,True
1230,99,138,39,8/7to8/8,9/8to9/9,8/7to8/8:8/8to9/8:9/8to9/9:,3,True,True
3333,99,234,135,7/6to7/7,9/14to9/15,7/6to7/7:7/7to7/8:7/8to7/9:7/9to7/10:7/10to7/11:7/11to7/12:7/12to7/13:7/13to7/14:7/14to8/14:8/14to9/14:9/14to9/15:,11,False,True
3255,99,169,70,12/8to12/7,12/3to12/2,12/8to12/7:12/7to12/6:12/6to12/5:12/5to12/4:12/4to12/3:12/3to12/2:,6,True,True
564,99,239,140,4/11to5/11,13/10to13/11,4/11to5/11:5/11to6/11:6/11to7/11:7/11to8/11:8/11to9/11:9/11to10/11:10/11to10/10:10/10to11/10:11/10to12/10:12/10to13/10:13/10to13/11:,11,True,True
428,99,342,243,15/9to15/10,4/3to4/2,15/9to15/10:15/10to14/10:14/10to13/10:13/10to12/10:12/10to11/10:11/10to10/10:10/10to9/10:9/10to8/10:8/10to7/10:7/10to6/10:6/10to5/10:5/10to4/10:4/10to4/9:4/9to4/8:4/8to4/7:4/7to4/6:4/6to4/5:4/5to4/4:4/4to4/3:4/3to4/2:,20,False,True
2655,100,327,227,15/5to15/4,7/8to7/9,15/5to15/4:15/4to14/4:14/4to13/4:13/4to12/4:12/4to11/4:11/4to10/4:10/4to9/4:9/4to8/4:8/4to7/4:7/4to7/5:7/5to7/6:7/6to7/7:7/7to7/8:7/8to7/9:,14,False,True
2892,100,181,81,5/1to4/1,5/5to5/6,5/1to4/1:4/1to4/2:4/2to4/3:4/3to4/4:4/4to4/5:4/5to5/5:5/5to5/6:,7,False,True
1431,100,223,123,12/15to11/15,10/8to9/8,12/15to11/15:11/15to11/14:11/14to11/13:11/13to11/12:11/12to11/11:11/11to11/10:11/10to11/9:11/9to11/8:11/8to10/8:10/8to9/8:,10,True,True
2262,100,346,246,right4to15/4,6/14to5/14,right4to15/4:15/4to14/4:14/4to13/4:13/4to12/4:12/4to11/4:11/4to10/4:10/4to9/4:9/4to8/4:8/4to7/4:7/4to6/4:6/4to6/5:6/5to6/6:6/6to6/7:6/7to6/8:6/8to6/9:6/9to6/10:6/10to6/11:6/11to6/12:6/12to6/13:6/13to6/14:6/14to5/14:,21,False,True
1333,100,135,35,14/6to14/5,13/5to13/6,14/6to14/5:14/5to13/5:13/5to13/6:,3,True,True
95,100,544,444,left15to0/15,15/0tobottom15,left15to0/15:0/15to0/14:0/14to0/13:0/13to0/12:0/12to0/11:0/11to0/10:0/10to0/9:0/9to0/8:0/8to0/7:0/7to0/6:0/6to0/5:0/5to0/4:0/4to0/3:0/3to0/2:0/2to1/2:1/2to2/2:2/2to3/2:3/2to4/2:4/2to5/2:5/2to6/2:6/2to7/2:7/2to8/2:8/2to9/2:9/2to10/2:10/2to10/1:10/1to11/1:11/1to11/0:11/0to12/0:12/0to13/0:13/0to14/0:14/0to15/0:15/0tobottom15:,32,True,True
230,101,480,379,right15to15/15,0/0tobottom0,right15to15/15:15/15to14/15:14/15to13/15:13/15to12/15:12/15to11/15:11/15to10/15:10/15to9/15:9/15to8/15:8/15to7/15:7/15to6/15:6/15to5/15:5/15to4/15:4/15to3/15:3/15to2/15:2/15to1/15:1/15to0/15:0/15to0/14:0/14to0/13:0/13to0/12:0/12to0/11:0/11to0/10:0/10to0/9:0/9to0/8:0/8to0/7:0/7to0/6:0/6to0/5:0/5to0/4:0/4to0/3:0/3to0/2:0/2to0/1:0/1to0/0:0/0tobottom0:,32,False,True
738,101,339,238,9/7to8/7,0/14toleft14,9/7to8/7:8/7to7/7:7/7to6/7:6/7to5/7:5/7to4/7:4/7to3/7:3/7to2/7:2/7to1/7:1/7to0/7:0/7to0/8:0/8to0/9:0/9to0/10:0/10to0/11:0/11to0/12:0/12to0/13:0/13to0/14:0/14toleft14:,17,False,True
2756,101,301,200,2/6to2/7,12/6to13/6,2/6to2/7:2/7to2/6:2/6to3/6:3/6to4/6:4/6to5/6:5/6to6/6:6/6to7/6:7/6to8/6:8/6to9/6:9/6to10/6:10/6to11/6:11/6to12/6:12/6to13/6:,13,True,True
1756,101,208,107,6/4to5/4,3/8to2/8,6/4to5/4:5/4to4/4:4/4to3/4:3/4to3/5:3/5to3/6:3/6to3/7:3/7to3/8:3/8to2/8:,8,True,True
1734,102,194,92,12/1to13/1,13/7to13/8,12/1to13/1:13/1to13/2:13/2to13/3:13/3to13/4:13/4to13/5:13/5to13/6:13/6to13/7:13/7to13/8:,8,False,True
2444,102,274,172,1/12to1/11,6/5to6/4,1/12to1/11:1/11to1/10:1/10to1/9:1/9to1/8:1/8to1/7:1/7to1/6:1/6to1/5:1/5to2/5:2/5to3/5:3/5to4/5:4/5to5/5:5/5to6/5:6/5to6/4:,13,False,True
1382,103,256,153,top3to3/15,1/5to0/5,top3to3/15:3/15to2/15:2/15to1/15:1/15to1/14:1/14to1/13:1/13to1/12:1/12to1/11:1/11to1/10:1/10to1/9:1/9to1/8:1/8to1/7:1/7to1/6:1/6to1/5:1/5to0/5:,14,True,True
1693,103,292,189,3/7to4/7,10/14to10/15,3/7to4/7:4/7to4/8:4/8to4/9:4/9to4/10:4/10to4/11:4/11to4/12:4/12to4/13:4/13to4/14:4/14to5/14:5/14to6/14:6/14to7/14:7/14to8/14:8/14to9/14:9/14to10/14:10/14to10/15:,15,True,True
820,104,173,69,4/6to3/6,3/10to4/10,4/6to3/6:3/6to3/7:3/7to3/8:3/8to3/9:3/9to3/10:3/10to4/10:,6,True,True
3046,104,216,112,0/13to0/12,2/7to2/6,0/13to0/12:0/12to0/11:0/11to0/10:0/10to0/9:0/9to0/8:0/8to0/7:0/7to1/7:1/7to2/7:2/7to2/6:,9,False,True
1416,104,143,39,3/14to4/14,5/14to6/14,3/14to4/14:4/14to5/14:5/14to6/14:,3,False,True
2013,104,329,225,8/9to7/9,0/2to0/1,8/9to7/9:7/9to6/9:6/9to5/9:5/9to4/9:4/9to3/9:3/9to2/9:2/9to1/9:1/9to0/9:0/9to0/8:0/8to0/7:0/7to0/6:0/6to0/5:0/5to0/4:0/4to0/3:0/3to0/2:0/2to0/1:,16,False,True
2362,104,277,173,left15to0/15,11/14to11/13,left15to0/15:0/15to1/15:1/15to2/15:2/15to3/15:3/15to4/15:4/15to5/15:5/15to6/15:6/15to7/15:7/15to8/15:8/15to9/15:9/15to10/15:10/15to10/14:10/14to11/14:11/14to11/13:,14,True,True
1822,105,301,196,2/3to1/3,9/7to9/6,2/3to1/3:1/3to1/4:1/4to1/5:1/5to1/6:1/6to1/7:1/7to2/7:2/7to3/7:3/7to4/7:4/7to5/7:5/7to6/7:6/7to7/7:7/7to8/7:8/7to9/7:9/7to9/6:,14,True,True
1044,105,196,91,6/7to7/7,9/4to9/5,6/7to7/7:7/7to7/6:7/6to7/5:7/5to7/4:7/4to8/4:8/4to9/4:9/4to9/5:,7,False,True
337,106,477,371,right0to15/0,0/15totop0,right0to15/0:15/0to14/0:14/0to13/0:13/0to12/0:12/0to11/0:11/0to10/0:10/0to9/0:9/0to8/0:8/0to7/0:7/0to6/0:6/0to5/0:5/0to4/0:4/0to3/0:3/0to2/0:2/0to1/0:1/0to0/0:0/0to0/1:0/1to0/2:0/2to0/3:0/3to0/4:0/4to0/5:0/5to0/6:0/6to0/7:0/7to0/8:0/8to0/9:0/9to0/10:0/10to0/11:0/11to0/12:0/12to0/13:0/13to0/14:0/14to0/15:0/15totop0:,32,False,True
2665,106,172,66,10/6to10/5,11/3to11/2,10/6to10/5:10/5to10/4:10/4to11/4:11/4to11/3:11/3to11/2:,5,True,True
2290,106,248,142,11/14to11/13,13/5to13/4,11/14to11/13:11/13to11/12:11/12to11/11:11/11to12/11:12/11to12/10:12/10to12/9:12/9to12/8:12/8to12/7:12/7to12/6:12/6to12/5:12/5to13/5:13/5to13/4:,12,True,True
2654,106,244,138,1/11to1/10,7/8to8/8,1/11to1/10:1/10to1/9:1/9to1/8:1/8to2/8:2/8to3/8:3/8to4/8:4/8to5/8:5/8to6/8:6/8to7/8:7/8to8/8:,10,False,True
263,106,484,378,right15to15/15,0/0tobottom0,right15to15/15:15/15to14/15:14/15to13/15:13/15to12/15:12/15to11/15:11/15to10/15:10/15to9/15:9/15to8/15:8/15to7/15:7/15to6/15:6/15to5/15:5/15to4/15:4/15to3/15:3/15to2/15:2/15to1/15:1/15to0/15:0/15to0/14:0/14to0/13:0/13to0/12:0/12to0/11:0/11to0/10:0/10to0/9:0/9to0/8:0/8to0/7:0/7to0/6:0/6to0/5:0/5to0/4:0/4to0/3:0/3to0/2:0/2to0/1:0/1to0/0:0/0tobottom0:,32,True,True
3070,107,232,125,8/13to7/13,4/9to5/9,8/13to7/13:7/13to6/13:6/13to5/13:5/13to4/13:4/13to4/12:4/12to4/11:4/11to4/10:4/10to4/9:4/9to5/9:,9,False,True
125,107,485,378,left0to0/0,15/15totop15,left0to0/0:0/0to1/0:1/0to2/0:2/0to3/0:3/0to4/0:4/0to5/0:5/0to6/0:6/0to7/0:7/0to8/0:8/0to9/0:9/0to10/0:10/0to10/1:10/1to10/2:10/2to10/3:10/3to10/4:10/4to10/5:10/5to10/6:10/6to10/7:10/7to10/8:10/8to10/9:10/9to10/10:10/10to10/11:10/11to10/12:10/12to10/13:10/13to10/14:10/14to10/15:10/15to11/15:11/15to12/15:12/15to13/15:13/15to14/15:14/15to15/15:15/15totop15:,32,False,True
48,107,485,378,left15to0/15,15/0tobottom15,left15to0/15:0/15to1/15:1/15to2/15:2/15to3/15:3/15to4/15:4/15to5/15:5/15to6/15:6/15to7/15:7/15to8/15:8/15to9/15:9/15to10/15:10/15to10/14:10/14to10/13:10/13to10/12:10/12to10/11:10/11to10/10:10/10to10/9:10/9to10/8:10/8to10/7:10/7to10/6:10/6to10/5:10/5to10/4:10/4to10/3:10/3to10/2:10/2to10/1:10/1to10/0:10/0to11/0:11/0to12/0:12/0to13/0:13/0to14/0:14/0to15/0:15/0tobottom15:,32,False,True
498,107,318,211,0/1to0/2,4/14to4/13,0/1to0/2:0/2to0/3:0/3to0/4:0/4to0/5:0/5to0/6:0/6to0/7:0/7to0/8:0/8to0/9:0/9to0/10:0/10to0/11:0/11to0/12:0/12to0/13:0/13to0/14:0/14to1/14:1/14to2/14:2/14to3/14:3/14to4/14:4/14to4/13:,18,False,True
3209,108,415,307,13/14to13/13,1/4to2/4,13/14to13/13:13/13to12/13:12/13to12/12:12/12to11/12:11/12to10/12:10/12to9/12:9/12to8/12:8/12to7/12:7/12to6/12:6/12to5/12:5/12to4/12:4/12to3/12:3/12to2/12:2/12to1/12:1/12to1/11:1/11to1/10:1/10to1/9:1/9to1/8:1/8to1/7:1/7to1/6:1/6to1/5:1/5to1/4:1/4to2/4:,23,True,True
2088,108,225,117,7/14to6/14,6/6to6/5,7/14to6/14:6/14to6/13:6/13to6/12:6/12to6/11:6/11to6/10:6/10to6/9:6/9to6/8:6/8to6/7:6/7to6/6:6/6to6/5:,10,False,True
720,108,158,50,7/4to8/4,9/3to10/3,7/4to8/4:8/4to8/3:8/3to9/3:9/3to10/3:,4,True,True
1445,108,286,178,8/14to9/14,14/7to15/7,8/14to9/14:9/14to10/14:10/14to10/13:10/13to10/12:10/12to10/11:10/11to10/10:10/10to10/9:10/9to10/8:10/8to10/7:10/7to11/7:11/7to12/7:12/7to13/7:13/7to14/7:14/7to15/7:,14,False,True
56,108,546,438,left15to0/15,15/0tobottom15,left15to0/15:0/15to0/14:0/14to0/13:0/13to0/12:0/12to0/11:0/11to0/10:0/10to0/9:0/9to0/8:0/8to0/7:0/7to0/6:0/6to0/5:0/5to0/4:0/4to0/3:0/3to0/2:0/2to1/2:1/2to2/2:2/2to3/2:3/2to4/2:4/2to5/2:5/2to6/2:6/2to7/2:7/2to8/2:8/2to9/2:9/2to10/2:10/2to10/1:10/1to11/1:11/1to11/0:11/0to12/0:12/0to13/0:13/0to14/0:14/0to15/0:15/0tobottom15:,32,True,True
904,108,227,119,8/9to7/9,3/7to4/7,8/9to7/9:7/9to6/9:6/9to5/9:5/9to4/9:4/9to3/9:3/9to3/8:3/8to3/7:3/7to4/7:,8,True,True
613,109,323,214,2/5to2/4,12/0to13/0,2/5to2/4:2/4to3/4:3/4to4/4:4/4to5/4:5/4to6/4:6/4to7/4:7/4to8/4:8/4to9/4:9/4to10/4:10/4to10/3:10/3to10/2:10/2to10/1:10/1to10/0:10/0to11/0:11/0to12/0:12/0to13/0:,16,False,True
2226,109,196,87,10/1to9/1,5/0to4/0,10/1to9/1:9/1to8/1:8/1to7/1:7/1to6/1:6/1to5/1:5/1to5/0:5/0to4/0:,7,True,True
917,110,364,254,3/6to3/5,14/11to15/11,3/6to3/5:3/5to3/6:3/6to3/7:3/7to3/8:3/8to3/9:3/9to3/10:3/10to3/11:3/11to4/11:4/11to5/11:5/11to6/11:6/11to7/11:7/11to8/11:8/11to9/11:9/11to10/11:10/11to11/11:11/11to12/11:12/11to13/11:13/11to14/11:14/11to15/11:,19,True,True
346,110,493,383,right0to15/0,0/15totop0,right0to15/0:15/0to14/0:14/0to13/0:13/0to12/0:12/0to11/0:11/0to11/1:11/1to10/1:10/1to9/1:9/1to8/1:8/1to7/1:7/1to6/1:6/1to5/1:5/1to4/1:4/1to3/1:3/1to2/1:2/1to1/1:1/1to0/1:0/1to0/2:0/2to0/3:0/3to0/4:0/4to0/5:0/5to0/6:0/6to0/7:0/7to0/8:0/8to0/9:0/9to0/10:0/10to0/11:0/11to0/12:0/12to0/13:0/13to0/14:0/14to0/15:0/15totop0:,32,True,True
1167,110,342,232,bottom2to2/0,7/13to7/12,bottom2to2/0:2/0to2/1:2/1to2/2:2/2to2/3:2/3to2/4:2/4to2/5:2/5to2/6:2/6to2/7:2/7to2/8:2/8to2/9:2/9to2/10:2/10to2/11:2/11to2/12:2/12to2/13:2/13to3/13:3/13to4/13:4/13to5/13:5/13to6/13:6/13to7/13:7/13to7/12:,20,True,True
2782,110,196,86,3/4to3/5,1/8to1/9,3/4to3/5:3/5to2/5:2/5to1/5:1/5to1/6:1/6to1/7:1/7to1/8:1/8to1/9:,7,True,True
2486,111,178,67,9/14to8/14,6/13to6/12,9/14to8/14:8/14to7/14:7/14to6/14:6/14to6/13:6/13to6/12:,5,False,True
1490,111,174,63,bottom7to7/0,8/3to8/4,bottom7to7/0:7/0to7/1:7/1to7/2:7/2to7/3:7/3to8/3:8/3to8/4:,6,False,True
2952,111,259,148,6/6to5/6,1/12to1/13,6/6to5/6:5/6to4/6:4/6to3/6:3/6to2/6:2/6to1/6:1/6to1/7:1/7to1/8:1/8to1/9:1/9to1/10:1/10to1/11:1/11to1/12:1/12to1/13:,12,False,True
412,111,245,134,8/1to9/1,13/5to14/5,8/1to9/1:9/1to10/1:10/1to10/2:10/2to10/3:10/3to10/4:10/4to10/5:10/5to11/5:11/5to12/5:12/5to13/5:13/5to14/5:,10,False,True
1033,111,321,210,top8to8/15,10/0to9/0,top8to8/15:8/15to8/14:8/14to8/13:8/13to8/12:8/12to8/11:8/11to8/10:8/10to8/9:8/9to8/8:8/8to8/7:8/7to8/6:8/6to8/5:8/5to8/4:8/4to8/3:8/3to8/2:8/2to9/2:9/2to10/2:10/2to10/1:10/1to10/0:10/0to9/0:,19,True,True
3371,112,176,64,3/13to2/13,4/15totop4,3/13to2/13:2/13to2/14:2/14to2/15:2/15to3/15:3/15to4/15:4/15totop4:,6,False,True
3158,112,170,58,15/6to15/5,14/7to13/7,15/6to15/5:15/5to14/5:14/5to14/6:14/6to14/7:14/7to13/7:,5,False,True
3024,112,239,127,3/4to4/4,7/9to7/10,3/4to4/4:4/4to4/5:4/5to4/6:4/6to4/7:4/7to4/8:4/8to4/9:4/9to5/9:5/9to6/9:6/9to7/9:7/9to7/10:,10,False,True
2893,112,321,209,15/11to14/11,8/2to7/2,15/11to14/11:14/11to13/11:13/11to12/11:12/11to11/11:11/11to10/11:10/11to9/11:9/11to8/11:8/11to8/10:8/10to8/9:8/9to8/8:8/8to8/7:8/7to8/6:8/6to8/5:8/5to8/4:8/4to8/3:8/3to8/2:8/2to7/2:,17,False,True
1713,113,331,218,13/2to13/3,4/9to5/9,13/2to13/3:13/3to12/3:12/3to11/3:11/3to10/3:10/3to9/3:9/3to8/3:8/3to7/3:7/3to6/3:6/3to5/3:5/3to4/3:4/3to4/4:4/4to4/5:4/5to4/6:4/6to4/7:4/7to4/8:4/8to4/9:4/9to5/9:,17,False,True
399,113,508,395,right0to15/0,0/15totop0,right0to15/0:15/0to14/0:14/0to13/0:13/0to12/0:12/0to11/0:11/0to10/0:10/0to9/0:9/0to8/0:8/0to7/0:7/0to6/0:6/0to5/0:5/0to4/0:4/0to3/0:3/0to2/0:2/0to1/0:1/0to0/0:0/0to0/1:0/1to0/2:0/2to0/3:0/3to0/4:0/4to0/5:0/5to0/6:0/6to0/7:0/7to0/8:0/8to0/9:0/9to0/10:0/10to0/11:0/11to0/12:0/12to0/13:0/13to0/14:0/14to0/15:0/15totop0:,32,False,True
1694,114,381,267,6/0to7/0,13/6to14/6,6/0to7/0:7/0to7/1:7/1to7/2:7/2to7/3:7/3to7/4:7/4to7/5:7/5to8/5:8/5to9/5:9/5to10/5:10/5to10/6:10/6to11/6:11/6to12/6:12/6to13/6:13/6to14/6:,14,True,True
2162,114,218,104,6/9to6/10,11/9to12/9,6/9to6/10:6/10to7/10:7/10to8/10:8/10to9/10:9/10to10/10:10/10to10/9:10/9to11/9:11/9to12/9:,8,False,True
2246,114,186,72,1/13to1/12,1/8to2/8,1/13to1/12:1/12to1/11:1/11to1/10:1/10to1/9:1/9to1/8:1/8to2/8:,6,False,True
1906,115,208,93,15/5to14/5,13/10to14/10,15/5to14/5:14/5to13/5:13/5to13/6:13/6to13/7:13/7to13/8:13/8to13/9:13/9to13/10:13/10to14/10:,8,False,True
2764,115,474,359,bottom15to15/0,0/12to1/12,bottom15to15/0:15/0to14/0:14/0to13/0:13/0to12/0:12/0to11/0:11/0to10/0:10/0to9/0:9/0to8/0:8/0to7/0:7/0to6/0:6/0to5/0:5/0to4/0:4/0to3/0:3/0to2/0:2/0to1/0:1/0to0/0:0/0to0/1:0/1to0/2:0/2to0/3:0/3to0/4:0/4to0/5:0/5to0/6:0/6to0/7:0/7to0/8:0/8to0/9:0/9to0/10:0/10to0/11:0/11to0/12:0/12to1/12:,29,False,True
1916,115,398,283,1/9to2/9,15/2toright2,1/9to2/9:2/9to3/9:3/9to4/9:4/9to5/9:5/9to6/9:6/9to7/9:7/9to8/9:8/9to9/9:9/9to10/9:10/9to10/8:10/8to10/7:10/7to10/6:10/6to10/5:10/5to10/4:10/4to10/3:10/3to10/2:10/2to11/2:11/2to12/2:12/2to13/2:13/2to14/2:14/2to15/2:15/2toright2:,22,False,True
912,115,301,186,11/8to11/9,3/15totop3,11/8to11/9:11/9to11/10:11/10to10/10:10/10to9/10:9/10to8/10:8/10to7/10:7/10to6/10:6/10to5/10:5/10to4/10:4/10to3/10:3/10to3/11:3/11to3/12:3/12to3/13:3/13to3/14:3/14to3/15:3/15totop3:,16,True,True
2551,115,424,309,15/5to14/5,0/0toleft0,15/5to14/5:14/5to13/5:13/5to12/5:12/5to11/5:11/5to10/5:10/5to9/5:9/5to8/5:8/5to7/5:7/5to6/5:6/5to5/5:5/5to4/5:4/5to3/5:3/5to2/5:2/5to1/5:1/5to0/5:0/5to0/4:0/4to0/3:0/3to0/2:0/2to0/1:0/1to0/0:0/0toleft0:,21,False,True
2927,115,233,118,3/14to4/14,5/7to6/7,3/14to4/14:4/14to4/13:4/13to4/12:4/12to4/11:4/11to4/10:4/10to4/9:4/9to4/8:4/8to4/7:4/7to5/7:5/7to6/7:,10,True,True
2628,115,255,140,9/6to9/7,6/1to7/1,9/6to9/7:9/7to8/7:8/7to7/7:7/7to6/7:6/7to6/6:6/6to6/5:6/5to6/4:6/4to6/3:6/3to6/2:6/2to6/1:6/1to7/1:,11,True,True
205,116,500,384,right15to15/15,0/0tobottom0,right15to15/15:15/15to14/15:14/15to13/15:13/15to12/15:12/15to11/15:11/15to10/15:10/15to9/15:9/15to8/15:8/15to7/15:7/15to6/15:6/15to5/15:5/15to4/15:4/15to3/15:3/15to2/15:2/15to1/15:1/15to0/15:0/15to0/14:0/14to0/13:0/13to0/12:0/12to0/11:0/11to0/10:0/10to0/9:0/9to0/8:0/8to0/7:0/7to0/6:0/6to0/5:0/5to0/4:0/4to0/3:0/3to0/2:0/2to0/1:0/1to0/0:0/0tobottom0:,32,True,True
1528,116,192,76,9/7to9/8,9/10to9/11,9/7to9/8:9/8to8/8:8/8to8/9:8/9to8/10:8/10to9/10:9/10to9/11:,6,True,True
3122,117,307,190,5/2to4/2,6/15totop6,5/2to4/2:4/2to4/3:4/3to4/4:4/4to4/5:4/5to4/6:4/6to4/7:4/7to4/8:4/8to4/9:4/9to4/10:4/10to4/11:4/11to4/12:4/12to4/13:4/13to4/14:4/14to4/15:4/15to5/15:5/15to6/15:6/15totop6:,17,True,True
1507,117,263,146,15/7to15/8,13/0to14/0,15/7to15/8:15/8to14/8:14/8to13/8:13/8to13/7:13/7to13/6:13/6to13/5:13/5to13/4:13/4to13/3:13/3to13/2:13/2to13/1:13/1to13/0:13/0to14/0:,12,False,True
1743,118,279,161,9/2to10/2,12/11to13/11,9/2to10/2:10/2to10/3:10/3to11/3:11/3to12/3:12/3to12/4:12/4to12/5:12/5to12/6:12/6to12/7:12/7to12/8:12/8to12/9:12/9to12/10:12/10to12/11:12/11to13/11:,13,True,True
3149,118,193,75,4/7to3/7,3/11to2/11,4/7to3/7:3/7to3/8:3/8to3/9:3/9to3/10:3/10to3/11:3/11to2/11:,6,True,True
1359,118,196,78,6/2to6/1,2/0tobottom2,6/2to6/1:6/1to5/1:5/1to4/1:4/1to3/1:3/1to2/1:2/1to2/0:2/0tobottom2:,7,False,True
839,118,325,207,0/7to1/7,10/2to10/1,0/7to1/7:1/7to1/6:1/6to1/5:1/5to1/4:1/4to1/3:1/3to2/3:2/3to3/3:3/3to4/3:4/3to5/3:5/3to6/3:6/3to7/3:7/3to8/3:8/3to9/3:9/3to10/3:10/3to10/2:10/2to10/1:,16,True,True
2949,118,220,102,6/4to6/5,5/0to6/0,6/4to6/5:6/5to5/5:5/5to5/4:5/4to5/3:5/3to5/2:5/2to5/1:5/1to5/0:5/0to6/0:,8,False,True
1590,119,245,126,13/10to13/11,10/6to9/6,13/10to13/11:13/11to12/11:12/11to11/11:11/11to11/10:11/10to11/9:11/9to11/8:11/8to10/8:10/8to10/7:10/7to10/6:10/6to9/6:,10,True,True
222,119,503,384,right15to15/15,0/0tobottom0,right15to15/15:15/15to14/15:14/15to13/15:13/15to12/15:12/15to11/15:11/15to10/15:10/15to9/15:9/15to8/15:8/15to7/15:7/15to6/15:6/15to5/15:5/15to4/15:4/15to3/15:3/15to2/15:2/15to1/15:1/15to0/15:0/15to0/14:0/14to0/13:0/13to0/12:0/12to0/11:0/11to0/10:0/10to0/9:0/9to0/8:0/8to0/7:0/7to0/6:0/6to0/5:0/5to0/4:0/4to0/3:0/3to0/2:0/2to0/1:0/1to0/0:0/0tobottom0:,32,True,True
2007,119,344,225,1/5to2/5,14/3to15/3,1/5to2/5:2/5to2/4:2/4to2/3:2/3to3/3:3/3to4/3:4/3to5/3:5/3to6/3:6/3to7/3:7/3to8/3:8/3to9/3:9/3to10/3:10/3to11/3:11/3to12/3:12/3to13/3:13/3to14/3:14/3to15/3:,16,True,True
2358,119,364,245,3/14to3/15,12/7to12/8,3/14to3/15:3/15to3/14:3/14to3/13:3/13to3/12:3/12to3/11:3/11to3/10:3/10to3/9:3/9to3/8:3/8to4/8:4/8to5/8:5/8to6/8:6/8to7/8:7/8to8/8:8/8to9/8:9/8to10/8:10/8to10/7:10/7to11/7:11/7to12/7:12/7to12/8:,19,True,True
370,120,506,386,right0to15/0,0/15totop0,right0to15/0:15/0to14/0:14/0to13/0:13/0to12/0:12/0to11/0:11/0to10/0:10/0to9/0:9/0to8/0:8/0to7/0:7/0to6/0:6/0to5/0:5/0to4/0:4/0to3/0:3/0to2/0:2/0to1/0:1/0to0/0:0/0to0/1:0/1to0/2:0/2to0/3:0/3to0/4:0/4to0/5:0/5to0/6:0/6to0/7:0/7to0/8:0/8to0/9:0/9to0/10:0/10to0/11:0/11to0/12:0/12to0/13:0/13to0/14:0/14to0/15:0/15totop0:,32,True,True
1504,120,357,237,0/8to1/8,10/15totop10,0/8to1/8:1/8to1/9:1/9to1/10:1/10to1/11:1/11to1/12:1/12to1/13:1/13to1/14:1/14to2/14:2/14to3/14:3/14to4/14:4/14to5/14:5/14to6/14:6/14to7/14:7/14to8/14:8/14to9/14:9/14to10/14:10/14to10/15:10/15totop10:,18,True,True
1129,120,301,181,left14to0/14,10/12to11/12,left14to0/14:0/14to1/14:1/14to2/14:2/14to3/14:3/14to4/14:4/14to5/14:5/14to6/14:6/14to7/14:7/14to8/14:8/14to9/14:9/14to10/14:10/14to10/13:10/13to10/12:10/12to11/12:,14,False,True
1020,120,300,180,3/11to3/10,7/1to8/1,3/11to3/10:3/10to3/9:3/9to3/8:3/8to3/7:3/7to3/6:3/6to3/5:3/5to3/4:3/4to3/3:3/3to3/2:3/2to3/1:3/1to4/1:4/1to5/1:5/1to6/1:6/1to7/1:7/1to8/1:,15,True,True
2370,121,256,135,15/11to14/11,10/7to11/7,15/11to14/11:14/11to13/11:13/11to12/11:12/11to11/11:11/11to10/11:10/11to10/10:10/10to10/9:10/9to10/8:10/8to10/7:10/7to11/7:,10,False,True
1485,122,242,120,15/13to14/13,8/13to8/14,15/13to14/13:14/13to13/13:13/13to12/13:12/13to11/13:11/13to10/13:10/13to9/13:9/13to8/13:8/13to8/14:,8,False,True
41,122,494,372,left15to0/15,15/0tobottom15,left15to0/15:0/15to1/15:1/15to2/15:2/15to3/15:3/15to4/15:4/15to5/15:5/15to6/15:6/15to7/15:7/15to8/15:8/15to9/15:9/15to10/15:10/15to10/14:10/14to10/13:10/13to10/12:10/12to10/11:10/11to10/10:10/10to10/9:10/9to10/8:10/8to10/7:10/7to10/6:10/6to10/5:10/5to10/4:10/4to10/3:10/3to10/2:10/2to10/1:10/1to10/0:10/0to11/0:11/0to12/0:12/0to13/0:13/0to14/0:14/0to15/0:15/0tobottom15:,32,False,True
1725,122,199,77,9/5to9/4,9/2to10/2,9/5to9/4:9/4to8/4:8/4to8/3:8/3to8/2:8/2to9/2:9/2to10/2:,6,True,True
3264,122,302,180,13/0to12/0,8/9to7/9,13/0to12/0:12/0to11/0:11/0to10/0:10/0to9/0:9/0to8/0:8/0to8/1:8/1to8/2:8/2to8/3:8/3to8/4:8/4to8/5:8/5to8/6:8/6to8/7:8/7to8/8:8/8to8/9:8/9to7/9:,15,False,True
943,122,180,58,6/6to5/6,5/3to5/2,6/6to5/6:5/6to5/5:5/5to5/4:5/4to5/3:5/3to5/2:,5,False,True
1468,122,187,65,8/8to7/8,6/6to6/5,8/8to7/8:7/8to6/8:6/8to6/7:6/7to6/6:6/6to6/5:,5,False,True
427,122,354,232,1/4to1/5,10/7to10/8,1/4to1/5:1/5to2/5:2/5to3/5:3/5to4/5:4/5to5/5:5/5to6/5:6/5to7/5:7/5to8/5:8/5to9/5:9/5to10/5:10/5to10/6:10/6to10/7:10/7to10/8:,13,False,True
2084,122,216,94,12/6to12/5,13/0to14/0,12/6to12/5:12/5to12/4:12/4to12/3:12/3to12/2:12/2to12/1:12/1to12/0:12/0to13/0:13/0to14/0:,8,False,True
812,123,346,223,14/5to14/4,3/3to3/2,14/5to14/4:14/4to13/4:13/4to12/4:12/4to11/4:11/4to10/4:10/4to9/4:9/4to8/4:8/4to7/4:7/4to6/4:6/4to5/4:5/4to4/4:4/4to3/4:3/4to3/3:3/3to3/2:,14,True,True
2157,123,287,164,3/9to4/9,13/10to14/10,3/9to4/9:4/9to5/9:5/9to6/9:6/9to7/9:7/9to8/9:8/9to9/9:9/9to10/9:10/9to10/10:10/10to11/10:11/10to12/10:12/10to13/10:13/10to14/10:,12,False,True
658,123,301,178,13/11to13/12,7/6to6/6,13/11to13/12:13/12to12/12:12/12to11/12:11/12to10/12:10/12to9/12:9/12to8/12:8/12to7/12:7/12to7/11:7/11to7/10:7/10to7/9:7/9to7/8:7/8to7/7:7/7to7/6:7/6to6/6:,14,True,True
2032,123,254,131,5/10to4/10,4/0tobottom4,5/10to4/10:4/10to4/9:4/9to4/8:4/8to4/7:4/7to4/6:4/6to4/5:4/5to4/4:4/4to4/3:4/3to4/2:4/2to4/1:4/1to4/0:4/0tobottom4:,12,True,True
1551,123,379,256,11/13to11/14,2/4to2/3,11/13to11/14:11/14to10/14:10/14to9/14:9/14to8/14:8/14to7/14:7/14to6/14:6/14to5/14:5/14to4/14:4/14to3/14:3/14to2/14:2/14to2/13:2/13to2/12:2/12to2/11:2/11to2/10:2/10to2/9:2/9to2/8:2/8to2/7:2/7to2/6:2/6to2/5:2/5to2/4:2/4to2/3:,21,False,True
2951,123,310,187,5/14to5/13,7/1to7/2,5/14to5/13:5/13to5/12:5/12to5/11:5/11to5/10:5/10to5/9:5/9to5/8:5/8to5/7:5/7to5/6:5/6to5/5:5/5to5/4:5/4to5/3:5/3to5/2:5/2to5/1:5/1to6/1:6/1to7/1:7/1to7/2:,16,True,True
1423,124,357,233,12/2to11/2,4/12to4/13,12/2to11/2:11/2to10/2:10/2to9/2:9/2to8/2:8/2to7/2:7/2to6/2:6/2to5/2:5/2to4/2:4/2to4/3:4/3to4/4:4/4to4/5:4/5to4/6:4/6to4/7:4/7to4/8:4/8to4/9:4/9to4/10:4/10to4/11:4/11to4/12:4/12to4/13:,19,False,True
899,124,356,232,5/4to6/4,14/10to14/9,5/4to6/4:6/4to7/4:7/4to8/4:8/4to9/4:9/4to10/4:10/4to10/5:10/5to10/6:10/6to10/7:10/7to10/8:10/8to10/9:10/9to10/10:10/10to11/10:11/10to12/10:12/10to13/10:13/10to14/10:14/10to14/9:,16,False,True
1628,124,376,252,13/7to13/6,3/1to4/1,13/7to13/6:13/6to12/6:12/6to11/6:11/6to10/6:10/6to9/6:9/6to8/6:8/6to7/6:7/6to6/6:6/6to5/6:5/6to4/6:4/6to3/6:3/6to3/5:3/5to3/4:3/4to3/3:3/3to3/2:3/2to3/1:3/1to4/1:,17,False,True
384,124,509,385,right0to15/0,0/15totop0,right0to15/0:15/0to14/0:14/0to13/0:13/0to12/0:12/0to11/0:11/0to10/0:10/0to9/0:9/0to8/0:8/0to7/0:7/0to6/0:6/0to5/0:5/0to4/0:4/0to3/0:3/0to2/0:2/0to1/0:1/0to0/0:0/0to0/1:0/1to0/2:0/2to0/3:0/3to0/4:0/4to0/5:0/5to0/6:0/6to0/7:0/7to0/8:0/8to0/9:0/9to0/10:0/10to0/11:0/11to0/12:0/12to0/13:0/13to0/14:0/14to0/15:0/15totop0:,32,False,True
1057,125,408,283,1/7to1/8,13/15totop13,1/7to1/8:1/8to2/8:2/8to3/8:3/8to4/8:4/8to5/8:5/8to6/8:6/8to7/8:7/8to8/8:8/8to9/8:9/8to10/8:10/8to10/9:10/9to10/10:10/10to10/11:10/11to10/12:10/12to10/13:10/13to10/14:10/14to10/15:10/15to11/15:11/15to12/15:12/15to13/15:13/15totop13:,21,False,True
799,125,165,40,8/7to8/6,9/6to10/6,8/7to8/6:8/6to9/6:9/6to10/6:,3,False,True
1545,125,241,116,3/9to3/8,3/0to4/0,3/9to3/8:3/8to3/7:3/7to3/6:3/6to3/5:3/5to3/4:3/4to3/3:3/3to3/2:3/2to3/1:3/1to3/0:3/0to4/0:,10,False,True
2217,125,361,236,11/10to11/11,0/5to0/4,11/10to11/11:11/11to10/11:10/11to9/11:9/11to8/11:8/11to7/11:7/11to6/11:6/11to5/11:5/11to4/11:4/11to3/11:3/11to2/11:2/11to1/11:1/11to0/11:0/11to0/10:0/10to0/9:0/9to0/8:0/8to0/7:0/7to0/6:0/6to0/5:0/5to0/4:,19,True,True
39,125,502,377,left15to0/15,15/0tobottom15,left15to0/15:0/15to1/15:1/15to2/15:2/15to3/15:3/15to4/15:4/15to5/15:5/15to6/15:6/15to7/15:7/15to8/15:8/15to9/15:9/15to10/15:10/15to10/14:10/14to10/13:10/13to10/12:10/12to10/11:10/11to10/10:10/10to10/9:10/9to10/8:10/8to10/7:10/7to10/6:10/6to10/5:10/5to10/4:10/4to10/3:10/3to10/2:10/2to10/1:10/1to10/0:10/0to11/0:11/0to12/0:12/0to13/0:13/0to14/0:14/0to15/0:15/0tobottom15:,32,False,True
633,126,174,48,9/10to8/10,9/11to10/11,9/10to8/10:8/10to8/11:8/11to9/11:9/11to10/11:,4,False,True
167,126,501,375,left0to0/0,15/15totop15,left0to0/0:0/0to1/0:1/0to2/0:2/0to3/0:3/0to4/0:4/0to5/0:5/0to6/0:6/0to7/0:7/0to8/0:8/0to9/0:9/0to10/0:10/0to10/1:10/1to10/2:10/2to10/3:10/3to10/4:10/4to10/5:10/5to10/6:10/6to10/7:10/7to10/8:10/8to10/9:10/9to10/10:10/10to10/11:10/11to10/12:10/12to10/13:10/13to10/14:10/14to10/15:10/15to11/15:11/15to12/15:12/15to13/15:13/15to14/15:14/15to15/15:15/15totop15:,32,False,True
2115,126,192,66,top2to2/15,4/13to4/14,top2to2/15:2/15to2/14:2/14to2/13:2/13to3/13:3/13to4/13:4/13to4/14:,6,False,True
1240,126,200,74,12/6to11/6,8/7to7/7,12/6to11/6:11/6to10/6:10/6to9/6:9/6to8/6:8/6to8/7:8/7to7/7:,6,False,True
3151,126,248,122,9/12to10/12,12/7to12/8,9/12to10/12:10/12to10/11:10/11to10/10:10/10to11/10:11/10to11/9:11/9to11/8:11/8to11/7:11/7to12/7:12/7to12/8:,9,True,True
146,126,510,384,left0to0/0,15/15totop15,left0to0/0:0/0to1/0:1/0to2/0:2/0to3/0:3/0to4/0:4/0to5/0:5/0to6/0:6/0to7/0:7/0to8/0:8/0to9/0:9/0to10/0:10/0to10/1:10/1to10/2:10/2to10/3:10/3to10/4:10/4to10/5:10/5to10/6:10/6to10/7:10/7to10/8:10/8to10/9:10/9to10/10:10/10to10/11:10/11to10/12:10/12to10/13:10/13to10/14:10/14to10/15:10/15to11/15:11/15to12/15:12/15to13/15:13/15to14/15:14/15to15/15:15/15totop15:,32,False,True
2560,126,253,127,1/10to1/9,1/0to2/0,1/10to1/9:1/9to1/8:1/8to1/7:1/7to1/6:1/6to1/5:1/5to1/4:1/4to1/3:1/3to1/2:1/2to1/1:1/1to1/0:1/0to2/0:,11,True,True
3233,127,287,160,5/9to5/8,10/15totop10,5/9to5/8:5/8to5/9:5/9to5/10:5/10to5/11:5/11to5/12:5/12to5/13:5/13to6/13:6/13to7/13:7/13to8/13:8/13to9/13:9/13to10/13:10/13to10/14:10/14to10/15:10/15totop10:,14,True,True
1932,127,318,191,8/10to9/10,12/0to13/0,8/10to9/10:9/10to10/10:10/10to11/10:11/10to11/9:11/9to11/8:11/8to11/7:11/7to11/6:11/6to11/5:11/5to11/4:11/4to11/3:11/3to11/2:11/2to11/1:11/1to11/0:11/0to12/0:12/0to13/0:,15,True,True
1212,127,178,51,6/7to5/7,5/5to6/5,6/7to5/7:5/7to5/6:5/6to5/5:5/5to6/5:,4,True,True
3116,127,203,76,10/7to10/6,12/4to12/3,10/7to10/6:10/6to10/5:10/5to11/5:11/5to12/5:12/5to12/4:12/4to12/3:,6,True,True
1608,127,242,115,13/3to12/3,12/11to12/12,13/3to12/3:12/3to12/4:12/4to12/5:12/5to12/6:12/6to12/7:12/7to12/8:12/8to12/9:12/9to12/10:12/10to12/11:12/11to12/12:,10,False,True
2490,127,244,117,11/5to12/5,13/12to14/12,11/5to12/5:12/5to12/6:12/6to12/7:12/7to12/8:12/8to12/9:12/9to12/10:12/10to12/11:12/11to12/12:12/12to13/12:13/12to14/12:,10,False,True
1862,127,273,146,7/8to7/9,4/2to5/2,7/8to7/9:7/9to6/9:6/9to5/9:5/9to4/9:4/9to4/8:4/8to4/7:4/7to4/6:4/6to4/5:4/5to4/4:4/4to4/3:4/3to4/2:4/2to5/2:,12,False,True
2075,128,226,98,5/11to5/10,7/6to7/7,5/11to5/10:5/10to5/9:5/9to5/8:5/8to5/7:5/7to5/6:5/6to6/6:6/6to7/6:7/6to7/7:,8,True,True
1493,128,229,101,3/7to2/7,1/12to1/13,3/7to2/7:2/7to1/7:1/7to1/8:1/8to1/9:1/9to1/10:1/10to1/11:1/11to1/12:1/12to1/13:,8,True,True
1728,128,200,72,4/1to3/1,0/2to1/2,4/1to3/1:3/1to2/1:2/1to1/1:1/1to0/1:0/1to0/2:0/2to1/2:,6,True,True
886,128,280,152,13/6to12/6,4/8to5/8,13/6to12/6:12/6to11/6:11/6to10/6:10/6to9/6:9/6to8/6:8/6to7/6:7/6to6/6:6/6to5/6:5/6to4/6:4/6to4/7:4/7to4/8:4/8to5/8:,12,False,True
341,129,511,382,right0to15/0,0/15totop0,right0to15/0:15/0to14/0:14/0to13/0:13/0to12/0:12/0to11/0:11/0to10/0:10/0to9/0:9/0to8/0:8/0to7/0:7/0to6/0:6/0to5/0:5/0to4/0:4/0to3/0:3/0to2/0:2/0to1/0:1/0to0/0:0/0to0/1:0/1to0/2:0/2to0/3:0/3to0/4:0/4to0/5:0/5to0/6:0/6to0/7:0/7to0/8:0/8to0/9:0/9to0/10:0/10to0/11:0/11to0/12:0/12to0/13:0/13to0/14:0/14to0/15:0/15totop0:,32,True,True
359,129,519,390,right0to15/0,0/15totop0,right0to15/0:15/0to14/0:14/0to13/0:13/0to12/0:12/0to11/0:11/0to10/0:10/0to9/0:9/0to8/0:8/0to7/0:7/0to6/0:6/0to5/0:5/0to4/0:4/0to3/0:3/0to2/0:2/0to1/0:1/0to0/0:0/0to0/1:0/1to0/2:0/2to0/3:0/3to0/4:0/4to0/5:0/5to0/6:0/6to0/7:0/7to0/8:0/8to0/9:0/9to0/10:0/10to0/11:0/11to0/12:0/12to0/13:0/13to0/14:0/14to0/15:0/15totop0:,32,False,True
1317,129,352,223,13/7to13/6,5/12to5/13,13/7to13/6:13/6to12/6:12/6to11/6:11/6to10/6:10/6to9/6:9/6to8/6:8/6to7/6:7/6to6/6:6/6to5/6:5/6to5/7:5/7to5/8:5/8to5/9:5/9to5/10:5/10to5/11:5/11to5/12:5/12to5/13:,16,False,True
377,130,538,408,right0to15/0,0/15totop0,right0to15/0:15/0to14/0:14/0to13/0:13/0to12/0:12/0to11/0:11/0to11/1:11/1to10/1:10/1to9/1:9/1to8/1:8/1to7/1:7/1to6/1:6/1to5/1:5/1to4/1:4/1to3/1:3/1to2/1:2/1to1/1:1/1to0/1:0/1to0/2:0/2to0/3:0/3to0/4:0/4to0/5:0/5to0/6:0/6to0/7:0/7to0/8:0/8to0/9:0/9to0/10:0/10to0/11:0/11to0/12:0/12to0/13:0/13to0/14:0/14to0/15:0/15totop0:,32,True,True
532,130,379,249,2/5to2/6,11/11to12/11,2/5to2/6:2/6to3/6:3/6to4/6:4/6to5/6:5/6to6/6:6/6to7/6:7/6to8/6:8/6to9/6:9/6to10/6:10/6to10/7:10/7to10/8:10/8to10/9:10/9to10/10:10/10to10/11:10/11to11/11:11/11to12/11:,16,False,True
210,130,503,373,right15to15/15,0/0tobottom0,right15to15/15:15/15to14/15:14/15to13/15:13/15to12/15:12/15to11/15:11/15to10/15:10/15to9/15:9/15to8/15:8/15to7/15:7/15to6/15:6/15to5/15:5/15to4/15:4/15to3/15:3/15to2/15:2/15to1/15:1/15to0/15:0/15to0/14:0/14to0/13:0/13to0/12:0/12to0/11:0/11to0/10:0/10to0/9:0/9to0/8:0/8to0/7:0/7to0/6:0/6to0/5:0/5to0/4:0/4to0/3:0/3to0/2:0/2to0/1:0/1to0/0:0/0tobottom0:,32,False,True
1055,130,293,163,15/1to15/2,13/12to13/13,15/1to15/2:15/2to14/2:14/2to13/2:13/2to13/3:13/3to13/4:13/4to13/5:13/5to13/6:13/6to13/7:13/7to13/8:13/8to13/9:13/9to13/10:13/10to13/11:13/11to13/12:13/12to13/13:,14,False,True
1063,130,351,221,2/7to2/6,11/8to12/8,2/7to2/6:2/6to3/6:3/6to4/6:4/6to5/6:5/6to6/6:6/6to7/6:7/6to8/6:8/6to9/6:9/6to10/6:10/6to10/7:10/7to10/8:10/8to11/8:11/8to12/8:,13,False,True
933,130,324,194,13/6to13/5,6/1to6/0,13/6to13/5:13/5to12/5:12/5to11/5:11/5to10/5:10/5to9/5:9/5to8/5:8/5to7/5:7/5to6/5:6/5to6/4:6/4to6/3:6/3to6/2:6/2to6/1:6/1to6/0:,13,False,True
2691,130,227,97,13/11to12/11,12/5to12/4,13/11to12/11:12/11to12/10:12/10to12/9:12/9to12/8:12/8to12/7:12/7to12/6:12/6to12/5:12/5to12/4:,8,True,True
343,130,531,401,right0to15/0,0/15totop0,right0to15/0:15/0to14/0:14/0to13/0:13/0to12/0:12/0to11/0:11/0to10/0:10/0to9/0:9/0to8/0:8/0to7/0:7/0to6/0:6/0to5/0:5/0to4/0:4/0to3/0:3/0to2/0:2/0to1/0:1/0to0/0:0/0to0/1:0/1to0/2:0/2to0/3:0/3to0/4:0/4to0/5:0/5to0/6:0/6to0/7:0/7to0/8:0/8to0/9:0/9to0/10:0/10to0/11:0/11to0/12:0/12to0/13:0/13to0/14:0/14to0/15:0/15totop0:,32,False,True
2684,131,312,181,4/1to5/1,5/14to6/14,4/1to5/1:5/1to5/2:5/2to5/3:5/3to5/4:5/4to5/5:5/5to5/6:5/6to5/7:5/7to5/8:5/8to5/9:5/9to5/10:5/10to5/11:5/11to5/12:5/12to5/13:5/13to5/14:5/14to6/14:,15,True,True
1279,131,231,100,8/5to8/6,13/5to14/5,8/5to8/6:8/6to9/6:9/6to10/6:10/6to10/5:10/5to11/5:11/5to12/5:12/5to13/5:13/5to14/5:,8,True,True
2817,131,302,171,0/15to1/15,9/12to9/13,0/15to1/15:1/15to1/14:1/14to1/13:1/13to1/12:1/12to2/12:2/12to3/12:3/12to4/12:4/12to5/12:5/12to6/12:6/12to7/12:7/12to8/12:8/12to9/12:9/12to9/13:,13,False,True
1488,131,251,120,4/0to4/1,3/8to2/8,4/0to4/1:4/1to3/1:3/1to3/2:3/2to3/3:3/3to3/4:3/4to3/5:3/5to3/6:3/6to3/7:3/7to3/8:3/8to2/8:,10,True,True
2491,131,312,181,3/2to3/3,8/10to9/10,3/2to3/3:3/3to3/4:3/4to3/5:3/5to3/6:3/6to3/7:3/7to3/8:3/8to3/9:3/9to3/10:3/10to4/10:4/10to5/10:5/10to6/10:6/10to7/10:7/10to8/10:8/10to9/10:,14,True,True
2196,132,206,74,8/12to9/12,11/10to12/10,8/12to9/12:9/12to10/12:10/12to10/11:10/11to10/10:10/10to11/10:11/10to12/10:,6,False,True
134,132,515,383,left0to0/0,15/15totop15,left0to0/0:0/0to1/0:1/0to2/0:2/0to3/0:3/0to4/0:4/0to5/0:5/0to6/0:6/0to7/0:7/0to8/0:8/0to9/0:9/0to10/0:10/0to10/1:10/1to10/2:10/2to10/3:10/3to10/4:10/4to10/5:10/5to10/6:10/6to10/7:10/7to10/8:10/8to10/9:10/9to10/10:10/10to10/11:10/11to10/12:10/12to10/13:10/13to10/14:10/14to10/15:10/15to11/15:11/15to12/15:12/15to13/15:13/15to14/15:14/15to15/15:15/15totop15:,32,False,True
2121,132,291,159,5/8to5/9,14/10to14/9,5/8to5/9:5/9to6/9:6/9to7/9:7/9to8/9:8/9to9/9:9/9to10/9:10/9to11/9:11/9to12/9:12/9to12/10:12/10to13/10:13/10to14/10:14/10to14/9:,12,True,True
2286,133,392,259,11/2to11/1,1/9to2/9,11/2to11/1:11/1to10/1:10/1to9/1:9/1to8/1:8/1to7/1:7/1to6/1:6/1to5/1:5/1to4/1:4/1to3/1:3/1to2/1:2/1to1/1:1/1to1/2:1/2to1/3:1/3to1/4:1/4to1/5:1/5to1/6:1/6to1/7:1/7to1/8:1/8to1/9:1/9to2/9:,20,False,True
1675,134,278,144,4/12to3/12,7/6to7/5,4/12to3/12:3/12to3/11:3/11to3/10:3/10to3/9:3/9to3/8:3/8to3/7:3/7to3/6:3/6to4/6:4/6to5/6:5/6to6/6:6/6to7/6:7/6to7/5:,12,False,True
2710,134,388,254,3/3to3/2,10/15totop10,3/3to3/2:3/2to4/2:4/2to5/2:5/2to6/2:6/2to7/2:7/2to8/2:8/2to9/2:9/2to10/2:10/2to10/3:10/3to10/4:10/4to10/5:10/5to10/6:10/6to10/7:10/7to10/8:10/8to10/9:10/9to10/10:10/10to10/11:10/11to10/12:10/12to10/13:10/13to10/14:10/14to10/15:10/15totop10:,22,False,True
2180,134,402,268,1/4to1/5,14/7to14/6,1/4to1/5:1/5to1/6:1/6to1/7:1/7to2/7:2/7to3/7:3/7to4/7:4/7to5/7:5/7to6/7:6/7to7/7:7/7to8/7:8/7to9/7:9/7to10/7:10/7to11/7:11/7to12/7:12/7to13/7:13/7to14/7:14/7to14/6:,17,True,True
99,134,514,380,left15to0/15,15/0tobottom15,left15to0/15:0/15to0/14:0/14to0/13:0/13to0/12:0/12to0/11:0/11to0/10:0/10to0/9:0/9to0/8:0/8to0/7:0/7to0/6:0/6to0/5:0/5to0/4:0/4to0/3:0/3to0/2:0/2to0/1:0/1to0/0:0/0to1/0:1/0to2/0:2/0to3/0:3/0to4/0:4/0to5/0:5/0to6/0:6/0to7/0:7/0to8/0:8/0to9/0:9/0to10/0:10/0to11/0:11/0to12/0:12/0to13/0:13/0to14/0:14/0to15/0:15/0tobottom15:,32,True,True
2899,135,223,88,10/13to10/12,5/12to4/12,10/13to10/12:10/12to9/12:9/12to8/12:8/12to7/12:7/12to6/12:6/12to5/12:5/12to4/12:,7,False,True
1300,135,302,167,1/14to1/13,1/1to0/1,1/14to1/13:1/13to1/12:1/12to1/11:1/11to1/10:1/10to1/9:1/9to1/8:1/8to1/7:1/7to1/6:1/6to1/5:1/5to1/4:1/4to1/3:1/3to1/2:1/2to1/1:1/1to0/1:,14,True,True
1711,136,186,50,3/5to4/5,4/7to5/7,3/5to4/5:4/5to4/6:4/6to4/7:4/7to5/7:,4,True,True
2860,136,409,273,14/5to14/4,3/9to3/10,14/5to14/4:14/4to13/4:13/4to12/4:12/4to11/4:11/4to10/4:10/4to9/4:9/4to8/4:8/4to7/4:7/4to6/4:6/4to5/4:5/4to4/4:4/4to3/4:3/4to3/5:3/5to3/6:3/6to3/7:3/7to3/8:3/8to3/9:3/9to3/10:,18,False,True
141,136,531,395,left0to0/0,15/15totop15,left0to0/0:0/0to1/0:1/0to2/0:2/0to3/0:3/0to4/0:4/0to5/0:5/0to6/0:6/0to7/0:7/0to8/0:8/0to9/0:9/0to10/0:10/0to10/1:10/1to10/2:10/2to10/3:10/3to10/4:10/4to10/5:10/5to10/6:10/6to10/7:10/7to10/8:10/8to10/9:10/9to10/10:10/10to10/11:10/11to10/12:10/12to10/13:10/13to10/14:10/14to10/15:10/15to11/15:11/15to12/15:12/15to13/15:13/15to14/15:14/15to15/15:15/15totop15:,32,False,True
2813,137,321,184,2/4to3/4,9/10to10/10,2/4to3/4:3/4to3/5:3/5to3/6:3/6to3/7:3/7to3/8:3/8to3/9:3/9to3/10:3/10to4/10:4/10to5/10:5/10to6/10:6/10to7/10:7/10to8/10:8/10to9/10:9/10to10/10:,14,False,True
1179,137,498,361,right1to15/1,0/11to0/12,right1to15/1:15/1to14/1:14/1to13/1:13/1to12/1:12/1to11/1:11/1to10/1:10/1to9/1:9/1to8/1:8/1to7/1:7/1to6/1:6/1to5/1:5/1to4/1:4/1to3/1:3/1to2/1:2/1to1/1:1/1to0/1:0/1to0/2:0/2to0/3:0/3to0/4:0/4to0/5:0/5to0/6:0/6to0/7:0/7to0/8:0/8to0/9:0/9to0/10:0/10to0/11:0/11to0/12:,27,False,True
2585,137,210,73,7/10to7/9,9/7to9/8,7/10to7/9:7/9to7/8:7/8to7/7:7/7to8/7:8/7to9/7:9/7to9/8:,6,True,True
2658,137,186,49,11/9to11/10,10/9to10/8,11/9to11/10:11/10to10/10:10/10to10/9:10/9to10/8:,4,True,True
2354,137,235,98,2/1to3/1,6/4to7/4,2/1to3/1:3/1to3/2:3/2to3/3:3/3to3/4:3/4to4/4:4/4to5/4:5/4to6/4:6/4to7/4:,8,False,True
1213,137,289,152,6/13to5/13,0/7toleft7,6/13to5/13:5/13to4/13:4/13to3/13:3/13to2/13:2/13to1/13:1/13to0/13:0/13to0/12:0/12to0/11:0/11to0/10:0/10to0/9:0/9to0/8:0/8to0/7:0/7toleft7:,13,True,True
3037,138,327,189,5/0to5/1,10/10to11/10,5/0to5/1:5/1to5/2:5/2to5/3:5/3to5/4:5/4to5/5:5/5to5/6:5/6to5/7:5/7to5/8:5/8to6/8:6/8to7/8:7/8to8/8:8/8to9/8:9/8to10/8:10/8to10/9:10/9to10/10:10/10to11/10:,16,True,True
188,139,537,398,left0to0/0,15/15totop15,left0to0/0:0/0to1/0:1/0to2/0:2/0to3/0:3/0to4/0:4/0to5/0:5/0to6/0:6/0to7/0:7/0to8/0:8/0to9/0:9/0to10/0:10/0to10/1:10/1to10/2:10/2to10/3:10/3to10/4:10/4to10/5:10/5to10/6:10/6to10/7:10/7to10/8:10/8to10/9:10/9to10/10:10/10to10/11:10/11to10/12:10/12to10/13:10/13to10/14:10/14to10/15:10/15to11/15:11/15to12/15:12/15to13/15:13/15to14/15:14/15to15/15:15/15totop15:,32,False,True
1976,139,268,129,5/13to4/13,0/9to0/8,5/13to4/13:4/13to3/13:3/13to2/13:2/13to1/13:1/13to0/13:0/13to0/12:0/12to0/11:0/11to0/10:0/10to0/9:0/9to0/8:,10,False,True
1242,139,402,263,9/1to9/0,10/12to10/13,9/1to9/0:9/0to9/1:9/1to9/2:9/2to9/3:9/3to9/4:9/4to9/5:9/5to9/6:9/6to9/7:9/7to9/8:9/8to9/9:9/9to9/10:9/10to9/11:9/11to10/11:10/11to10/12:10/12to10/13:,15,True,True
821,140,251,111,2/11to2/12,6/15to7/15,2/11to2/12:2/12to2/13:2/13to2/14:2/14to2/15:2/15to3/15:3/15to4/15:4/15to5/15:5/15to6/15:6/15to7/15:,9,True,True
1940,140,291,151,top13to13/15,5/13to6/13,top13to13/15:13/15to12/15:12/15to11/15:11/15to10/15:10/15to9/15:9/15to8/15:8/15to7/15:7/15to6/15:6/15to5/15:5/15to5/14:5/14to5/13:5/13to6/13:,12,True,True
2763,140,254,114,7/9to7/10,4/6to4/5,7/9to7/10:7/10to6/10:6/10to5/10:5/10to4/10:4/10to4/9:4/9to4/8:4/8to4/7:4/7to4/6:4/6to4/5:,9,False,True
745,141,284,143,11/12to11/11,13/3to14/3,11/12to11/11:11/11to11/10:11/10to11/9:11/9to11/8:11/8to11/7:11/7to11/6:11/6to11/5:11/5to11/4:11/4to11/3:11/3to12/3:12/3to13/3:13/3to14/3:,12,False,True
1779,141,289,148,5/3to4/3,5/13to5/12,5/3to4/3:4/3to4/4:4/4to4/5:4/5to4/6:4/6to4/7:4/7to4/8:4/8to4/9:4/9to4/10:4/10to4/11:4/11to4/12:4/12to4/13:4/13to5/13:5/13to5/12:,13,True,True
1435,141,349,208,right6to15/6,6/1to5/1,right6to15/6:15/6to14/6:14/6to13/6:13/6to12/6:12/6to11/6:11/6to10/6:10/6to9/6:9/6to8/6:8/6to7/6:7/6to6/6:6/6to6/5:6/5to6/4:6/4to6/3:6/3to6/2:6/2to6/1:6/1to5/1:,16,False,True
1742,141,307,166,12/8to12/7,6/12to6/13,12/8to12/7:12/7to11/7:11/7to10/7:10/7to9/7:9/7to8/7:8/7to7/7:7/7to6/7:6/7to6/8:6/8to6/9:6/9to6/10:6/10to6/11:6/11to6/12:6/12to6/13:,13,False,True
3009,141,176,35,14/13to14/12,13/12to13/13,14/13to14/12:14/12to13/12:13/12to13/13:,3,False,True
21,142,521,379,left15to0/15,15/0tobottom15,left15to0/15:0/15to1/15:1/15to2/15:2/15to3/15:3/15to4/15:4/15to5/15:5/15to6/15:6/15to7/15:7/15to8/15:8/15to9/15:9/15to10/15:10/15to10/14:10/14to10/13:10/13to10/12:10/12to10/11:10/11to10/10:10/10to10/9:10/9to10/8:10/8to10/7:10/7to10/6:10/6to10/5:10/5to10/4:10/4to10/3:10/3to10/2:10/2to10/1:10/1to10/0:10/0to11/0:11/0to12/0:12/0to13/0:13/0to14/0:14/0to15/0:15/0tobottom15:,32,False,True
1775,142,271,129,13/4to13/5,8/5to8/6,13/4to13/5:13/5to12/5:12/5to11/5:11/5to10/5:10/5to9/5:9/5to8/5:8/5to8/6:,7,True,True
3103,142,428,286,1/9to1/8,15/1to15/0,1/9to1/8:1/8to1/7:1/7to1/6:1/6to1/5:1/5to1/4:1/4to1/3:1/3to2/3:2/3to3/3:3/3to4/3:4/3to5/3:5/3to6/3:6/3to7/3:7/3to8/3:8/3to9/3:9/3to10/3:10/3to10/2:10/2to11/2:11/2to12/2:12/2to12/1:12/1to13/1:13/1to14/1:14/1to15/1:15/1to15/0:,23,True,True
1979,143,261,118,8/7to7/7,3/9to4/9,8/7to7/7:7/7to6/7:6/7to5/7:5/7to4/7:4/7to3/7:3/7to3/8:3/8to3/9:3/9to4/9:,8,True,True
1855,143,446,303,14/5to13/5,4/14to5/14,14/5to13/5:13/5to12/5:12/5to11/5:11/5to10/5:10/5to9/5:9/5to8/5:8/5to7/5:7/5to6/5:6/5to5/5:5/5to4/5:4/5to4/6:4/6to4/7:4/7to4/8:4/8to4/9:4/9to4/10:4/10to4/11:4/11to4/12:4/12to4/13:4/13to4/14:4/14to5/14:,20,True,True
3330,143,366,223,right4to15/4,8/12to8/13,right4to15/4:15/4to14/4:14/4to13/4:13/4to12/4:12/4to12/5:12/5to11/5:11/5to10/5:10/5to9/5:9/5to8/5:8/5to8/6:8/6to8/7:8/7to8/8:8/8to8/9:8/9to8/10:8/10to8/11:8/11to8/12:8/12to8/13:,17,True,True
3042,143,213,70,7/11to7/10,3/10to3/11,7/11to7/10:7/10to6/10:6/10to5/10:5/10to4/10:4/10to3/10:3/10to3/11:,6,True,True
529,144,330,186,right5to15/5,6/4to6/3,right5to15/5:15/5to14/5:14/5to13/5:13/5to12/5:12/5to11/5:11/5to10/5:10/5to9/5:9/5to8/5:8/5to7/5:7/5to6/5:6/5to6/4:6/4to6/3:,12,False,True
1953,144,371,227,1/7to2/7,10/13to10/14,1/7to2/7:2/7to3/7:3/7to4/7:4/7to5/7:5/7to6/7:6/7to7/7:7/7to8/7:8/7to9/7:9/7to10/7:10/7to10/8:10/8to10/9:10/9to10/10:10/10to10/11:10/11to10/12:10/12to10/13:10/13to10/14:,16,False,True
593,144,255,111,15/7to15/8,10/10to11/10,15/7to15/8:15/8to14/8:14/8to13/8:13/8to12/8:12/8to11/8:11/8to10/8:10/8to10/9:10/9to10/10:10/10to11/10:,9,False,True
1572,144,309,165,5/3to6/3,15/2toright2,5/3to6/3:6/3to6/2:6/2to7/2:7/2to8/2:8/2to9/2:9/2to10/2:10/2to11/2:11/2to12/2:12/2to13/2:13/2to14/2:14/2to15/2:15/2toright2:,12,True,True
1981,144,472,328,0/13to0/12,11/0tobottom11,0/13to0/12:0/12to1/12:1/12to2/12:2/12to3/12:3/12to4/12:4/12to5/12:5/12to6/12:6/12to7/12:7/12to8/12:8/12to9/12:9/12to10/12:10/12to10/11:10/11to10/10:10/10to10/9:10/9to10/8:10/8to10/7:10/7to10/6:10/6to10/5:10/5to10/4:10/4to10/3:10/3to10/2:10/2to10/1:10/1to10/0:10/0to11/0:11/0tobottom11:,25,False,True
1527,145,422,277,9/1to9/0,15/15totop15,9/1to9/0:9/0to10/0:10/0to10/1:10/1to10/2:10/2to10/3:10/3to10/4:10/4to10/5:10/5to10/6:10/6to10/7:10/7to10/8:10/8to10/9:10/9to10/10:10/10to10/11:10/11to10/12:10/12to10/13:10/13to10/14:10/14to10/15:10/15to11/15:11/15to12/15:12/15to13/15:13/15to14/15:14/15to15/15:15/15totop15:,23,False,True
217,145,528,383,right15to15/15,0/0tobottom0,right15to15/15:15/15to14/15:14/15to13/15:13/15to12/15:12/15to11/15:11/15to10/15:10/15to9/15:9/15to8/15:8/15to7/15:7/15to6/15:6/15to5/15:5/15to4/15:4/15to3/15:3/15to2/15:2/15to1/15:1/15to0/15:0/15to0/14:0/14to0/13:0/13to0/12:0/12to0/11:0/11to0/10:0/10to0/9:0/9to0/8:0/8to0/7:0/7to0/6:0/6to0/5:0/5to0/4:0/4to0/3:0/3to0/2:0/2to0/1:0/1to0/0:0/0tobottom0:,32,False,True
2315,145,349,204,2/10to3/10,11/11to12/11,2/10to3/10:3/10to4/10:4/10to5/10:5/10to6/10:6/10to7/10:7/10to8/10:8/10to9/10:9/10to10/10:10/10to10/11:10/11to11/11:11/11to12/11:,11,False,True
3061,146,237,91,7/5to7/4,9/0tobottom9,7/5to7/4:7/4to7/3:7/3to7/2:7/2to7/1:7/1to7/0:7/0to8/0:8/0to9/0:9/0tobottom9:,8,True,True
1119,146,393,247,0/4to1/4,15/3toright3,0/4to1/4:1/4to2/4:2/4to3/4:3/4to4/4:4/4to5/4:5/4to6/4:6/4to7/4:7/4to8/4:8/4to9/4:9/4to10/4:10/4to10/3:10/3to11/3:11/3to12/3:12/3to13/3:13/3to14/3:14/3to15/3:15/3toright3:,17,False,True
136,147,540,393,left0to0/0,15/15totop15,left0to0/0:0/0to1/0:1/0to2/0:2/0to3/0:3/0to4/0:4/0to5/0:5/0to6/0:6/0to7/0:7/0to8/0:8/0to9/0:9/0to10/0:10/0to10/1:10/1to10/2:10/2to10/3:10/3to10/4:10/4to10/5:10/5to10/6:10/6to10/7:10/7to10/8:10/8to10/9:10/9to10/10:10/10to10/11:10/11to10/12:10/12to10/13:10/13to10/14:10/14to10/15:10/15to11/15:11/15to12/15:12/15to13/15:13/15to14/15:14/15to15/15:15/15totop15:,32,False,True
2935,148,402,254,15/6to15/7,6/0to5/0,15/6to15/7:15/7to14/7:14/7to13/7:13/7to12/7:12/7to11/7:11/7to10/7:10/7to9/7:9/7to8/7:8/7to7/7:7/7to6/7:6/7to6/6:6/6to6/5:6/5to6/4:6/4to6/3:6/3to6/2:6/2to6/1:6/1to6/0:6/0to5/0:,18,False,True
2268,148,473,325,0/0to1/0,12/12to12/13,0/0to1/0:1/0to2/0:2/0to3/0:3/0to4/0:4/0to5/0:5/0to6/0:6/0to7/0:7/0to8/0:8/0to9/0:9/0to10/0:10/0to10/1:10/1to10/2:10/2to10/3:10/3to10/4:10/4to10/5:10/5to10/6:10/6to10/7:10/7to10/8:10/8to10/9:10/9to10/10:10/10to10/11:10/11to10/12:10/12to11/12:11/12to12/12:12/12to12/13:,25,False,True
1689,149,229,80,10/14to10/15,5/15totop5,10/14to10/15:10/15to9/15:9/15to8/15:8/15to7/15:7/15to6/15:6/15to5/15:5/15totop5:,7,False,True
3309,149,436,287,0/0to1/0,8/15to9/15,0/0to1/0:1/0to1/1:1/1to1/2:1/2to1/3:1/3to1/4:1/4to1/5:1/5to1/6:1/6to1/7:1/7to1/8:1/8to1/9:1/9to1/10:1/10to1/11:1/11to1/12:1/12to1/13:1/13to1/14:1/14to1/15:1/15to2/15:2/15to3/15:3/15to4/15:4/15to5/15:5/15to6/15:6/15to7/15:7/15to8/15:8/15to9/15:,24,True,True
3107,149,231,82,9/12to9/13,11/15to11/14,9/12to9/13:9/13to10/13:10/13to10/14:10/14to11/14:11/14to11/15:11/15to11/14:,6,True,True
1126,149,338,189,left6to0/6,6/13to6/14,left6to0/6:0/6to0/7:0/7to0/8:0/8to0/9:0/9to0/10:0/10to0/11:0/11to0/12:0/12to0/13:0/13to1/13:1/13to2/13:2/13to3/13:3/13to4/13:4/13to5/13:5/13to6/13:6/13to6/14:,15,True,True
1196,150,337,187,2/5to3/5,11/3to11/4,2/5to3/5:3/5to4/5:4/5to5/5:5/5to6/5:6/5to7/5:7/5to8/5:8/5to9/5:9/5to10/5:10/5to10/4:10/4to11/4:11/4to11/3:11/3to11/4:,12,True,True
330,150,535,385,right0to15/0,0/15totop0,right0to15/0:15/0to14/0:14/0to13/0:13/0to12/0:12/0to11/0:11/0to10/0:10/0to9/0:9/0to8/0:8/0to7/0:7/0to6/0:6/0to5/0:5/0to4/0:4/0to3/0:3/0to2/0:2/0to1/0:1/0to0/0:0/0to0/1:0/1to0/2:0/2to0/3:0/3to0/4:0/4to0/5:0/5to0/6:0/6to0/7:0/7to0/8:0/8to0/9:0/9to0/10:0/10to0/11:0/11to0/12:0/12to0/13:0/13to0/14:0/14to0/15:0/15totop0:,32,False,True
203,150,535,385,right15to15/15,0/0tobottom0,right15to15/15:15/15to14/15:14/15to13/15:13/15to12/15:12/15to11/15:11/15to10/15:10/15to9/15:9/15to8/15:8/15to7/15:7/15to6/15:6/15to5/15:5/15to4/15:4/15to3/15:3/15to2/15:2/15to1/15:1/15to0/15:0/15to0/14:0/14to0/13:0/13to0/12:0/12to0/11:0/11to0/10:0/10to0/9:0/9to0/8:0/8to0/7:0/7to0/6:0/6to0/5:0/5to0/4:0/4to0/3:0/3to0/2:0/2to0/1:0/1to0/0:0/0tobottom0:,32,False,True
2308,150,368,218,14/9to13/9,1/10to1/11,14/9to13/9:13/9to12/9:12/9to11/9:11/9to10/9:10/9to9/9:9/9to8/9:8/9to7/9:7/9to6/9:6/9to5/9:5/9to4/9:4/9to3/9:3/9to2/9:2/9to1/9:1/9to1/10:1/10to1/11:,15,False,True
1772,151,192,41,8/9to7/9,7/8to6/8,8/9to7/9:7/9to7/8:7/8to6/8:,3,True,True
484,151,324,173,11/1to10/1,0/1toleft1,11/1to10/1:10/1to9/1:9/1to8/1:8/1to7/1:7/1to6/1:6/1to5/1:5/1to4/1:4/1to3/1:3/1to2/1:2/1to1/1:1/1to0/1:0/1toleft1:,12,True,True
255,153,536,383,right15to15/15,0/0tobottom0,right15to15/15:15/15to14/15:14/15to13/15:13/15to12/15:12/15to11/15:11/15to10/15:10/15to9/15:9/15to8/15:8/15to7/15:7/15to6/15:6/15to5/15:5/15to4/15:4/15to3/15:3/15to2/15:2/15to1/15:1/15to0/15:0/15to0/14:0/14to0/13:0/13to0/12:0/12to0/11:0/11to0/10:0/10to0/9:0/9to0/8:0/8to0/7:0/7to0/6:0/6to0/5:0/5to0/4:0/4to0/3:0/3to0/2:0/2to0/1:0/1to0/0:0/0tobottom0:,32,False,True
566,153,351,198,0/8to0/7,8/1to8/2,0/8to0/7:0/7to0/6:0/6to0/5:0/5to0/4:0/4to0/3:0/3to0/2:0/2to0/1:0/1to1/1:1/1to2/1:2/1to3/1:3/1to4/1:4/1to5/1:5/1to6/1:6/1to7/1:7/1to8/1:8/1to8/2:,16,False,True
1574,153,295,142,5/13to6/13,13/11to14/11,5/13to6/13:6/13to6/12:6/12to6/11:6/11to7/11:7/11to8/11:8/11to9/11:9/11to10/11:10/11to11/11:11/11to12/11:12/11to13/11:13/11to14/11:,11,True,True
2134,153,271,118,15/9to15/8,12/13to12/14,15/9to15/8:15/8to14/8:14/8to13/8:13/8to12/8:12/8to12/9:12/9to12/10:12/10to12/11:12/11to12/12:12/12to12/13:12/13to12/14:,10,False,True
1925,153,224,71,left11to0/11,2/12to3/12,left11to0/11:0/11to0/12:0/12to1/12:1/12to2/12:2/12to3/12:,5,False,True
703,154,224,70,10/0to9/0,9/4to9/5,10/0to9/0:9/0to9/1:9/1to9/2:9/2to9/3:9/3to9/4:9/4to9/5:,6,False,True
2114,154,383,229,15/2to15/1,3/5to4/5,15/2to15/1:15/1to14/1:14/1to13/1:13/1to12/1:12/1to11/1:11/1to10/1:10/1to9/1:9/1to8/1:8/1to7/1:7/1to6/1:6/1to5/1:5/1to4/1:4/1to3/1:3/1to3/2:3/2to3/3:3/3to3/4:3/4to3/5:3/5to4/5:,18,False,True
1350,155,389,234,14/5to13/5,3/7to4/7,14/5to13/5:13/5to12/5:12/5to11/5:11/5to10/5:10/5to9/5:9/5to8/5:8/5to7/5:7/5to6/5:6/5to5/5:5/5to4/5:4/5to3/5:3/5to3/6:3/6to3/7:3/7to4/7:,14,True,True
102,156,544,388,left0to0/0,15/15totop15,left0to0/0:0/0to0/1:0/1to0/2:0/2to0/3:0/3to0/4:0/4to0/5:0/5to0/6:0/6to0/7:0/7to0/8:0/8to0/9:0/9to0/10:0/10to0/11:0/11to0/12:0/12to0/13:0/13to0/14:0/14to1/14:1/14to2/14:2/14to3/14:3/14to4/14:4/14to5/14:5/14to6/14:6/14to7/14:7/14to8/14:8/14to9/14:9/14to10/14:10/14to10/15:10/15to11/15:11/15to12/15:12/15to13/15:13/15to14/15:14/15to15/15:15/15totop15:,32,True,True
1204,156,398,242,15/11to15/12,2/14to2/15,15/11to15/12:15/12to14/12:14/12to13/12:13/12to12/12:12/12to11/12:11/12to10/12:10/12to9/12:9/12to8/12:8/12to7/12:7/12to6/12:6/12to5/12:5/12to4/12:4/12to3/12:3/12to2/12:2/12to2/13:2/13to2/14:2/14to2/15:,17,True,True
1010,156,425,269,left10to0/10,7/2to7/1,left10to0/10:0/10to0/9:0/9to0/8:0/8to0/7:0/7to0/6:0/6to0/5:0/5to0/4:0/4to0/3:0/3to0/2:0/2to1/2:1/2to2/2:2/2to3/2:3/2to4/2:4/2to5/2:5/2to6/2:6/2to7/2:7/2to7/1:,17,False,True
314,156,538,382,right0to15/0,0/15totop0,right0to15/0:15/0to14/0:14/0to13/0:13/0to12/0:12/0to11/0:11/0to10/0:10/0to9/0:9/0to8/0:8/0to7/0:7/0to6/0:6/0to5/0:5/0to4/0:4/0to3/0:3/0to2/0:2/0to1/0:1/0to0/0:0/0to0/1:0/1to0/2:0/2to0/3:0/3to0/4:0/4to0/5:0/5to0/6:0/6to0/7:0/7to0/8:0/8to0/9:0/9to0/10:0/10to0/11:0/11to0/12:0/12to0/13:0/13to0/14:0/14to0/15:0/15totop0:,32,False,True
584,156,259,103,5/12to5/11,1/13to1/14,5/12to5/11:5/11to4/11:4/11to3/11:3/11to2/11:2/11to1/11:1/11to1/12:1/12to1/13:1/13to1/14:,8,True,True
2743,156,329,173,4/14to5/14,12/9to12/8,4/14to5/14:5/14to6/14:6/14to7/14:7/14to8/14:8/14to9/14:9/14to10/14:10/14to10/13:10/13to10/12:10/12to10/11:10/11to10/10:10/10to10/9:10/9to11/9:11/9to12/9:12/9to12/8:,14,False,True
2617,156,350,194,12/6to12/7,0/9toleft9,12/6to12/7:12/7to11/7:11/7to10/7:10/7to9/7:9/7to8/7:8/7to7/7:7/7to6/7:6/7to5/7:5/7to4/7:4/7to3/7:3/7to2/7:2/7to1/7:1/7to0/7:0/7to0/8:0/8to0/9:0/9toleft9:,16,False,True
1509,157,218,61,14/8to14/9,15/11to15/10,14/8to14/9:14/9to14/10:14/10to14/11:14/11to15/11:15/11to15/10:,5,False,True
879,157,193,36,14/15to13/15,13/14to12/14,14/15to13/15:13/15to13/14:13/14to12/14:,3,True,True
2073,157,378,221,10/8to10/7,0/4to1/4,10/8to10/7:10/7to9/7:9/7to8/7:8/7to7/7:7/7to6/7:6/7to5/7:5/7to4/7:4/7to3/7:3/7to2/7:2/7to1/7:1/7to0/7:0/7to0/6:0/6to0/5:0/5to0/4:0/4to1/4:,15,True,True
952,158,255,97,8/3to9/3,12/0tobottom12,8/3to9/3:9/3to9/2:9/2to10/2:10/2to10/1:10/1to11/1:11/1to11/0:11/0to12/0:12/0tobottom12:,8,True,True
1464,158,298,140,14/4to14/5,11/12to12/12,14/4to14/5:14/5to13/5:13/5to12/5:12/5to11/5:11/5to11/6:11/6to11/7:11/7to11/8:11/8to11/9:11/9to11/10:11/10to11/11:11/11to11/12:11/12to12/12:,12,True,True
2051,158,256,98,2/12to2/11,7/10to8/10,2/12to2/11:2/11to2/10:2/10to3/10:3/10to4/10:4/10to5/10:5/10to6/10:6/10to7/10:7/10to8/10:,8,False,True
40,158,553,395,left15to0/15,15/0tobottom15,left15to0/15:0/15to0/14:0/14to0/13:0/13to0/12:0/12to0/11:0/11to0/10:0/10to0/9:0/9to0/8:0/8to0/7:0/7to0/6:0/6to0/5:0/5to0/4:0/4to0/3:0/3to0/2:0/2to1/2:1/2to2/2:2/2to3/2:3/2to4/2:4/2to5/2:5/2to6/2:6/2to7/2:7/2to8/2:8/2to9/2:9/2to10/2:10/2to10/1:10/1to11/1:11/1to11/0:11/0to12/0:12/0to13/0:13/0to14/0:14/0to15/0:15/0tobottom15:,32,True,True
2556,159,255,96,5/12to4/12,3/7to4/7,5/12to4/12:4/12to3/12:3/12to3/11:3/11to3/10:3/10to3/9:3/9to3/8:3/8to3/7:3/7to4/7:,8,False,True
741,159,283,124,1/1to1/2,1/11to2/11,1/1to1/2:1/2to1/3:1/3to1/4:1/4to1/5:1/5to1/6:1/6to1/7:1/7to1/8:1/8to1/9:1/9to1/10:1/10to1/11:1/11to2/11:,11,False,True
1665,160,243,83,15/11to14/11,13/7to12/7,15/11to14/11:14/11to13/11:13/11to13/10:13/10to13/9:13/9to13/8:13/8to13/7:13/7to12/7:,7,True,True
1877,160,281,121,9/5to8/5,5/0to4/0,9/5to8/5:8/5to7/5:7/5to6/5:6/5to5/5:5/5to5/4:5/4to5/3:5/3to5/2:5/2to5/1:5/1to5/0:5/0to4/0:,10,True,True
639,161,429,268,0/1to1/1,14/5to15/5,0/1to1/1:1/1to2/1:2/1to3/1:3/1to4/1:4/1to5/1:5/1to6/1:6/1to7/1:7/1to8/1:8/1to9/1:9/1to10/1:10/1to10/2:10/2to10/3:10/3to10/4:10/4to10/5:10/5to11/5:11/5to12/5:12/5to13/5:13/5to14/5:14/5to15/5:,19,False,True
949,161,459,298,2/6to3/6,12/15to13/15,2/6to3/6:3/6to4/6:4/6to5/6:5/6to6/6:6/6to7/6:7/6to8/6:8/6to9/6:9/6to10/6:10/6to10/7:10/7to10/8:10/8to10/9:10/9to10/10:10/10to10/11:10/11to10/12:10/12to10/13:10/13to10/14:10/14to10/15:10/15to11/15:11/15to12/15:12/15to13/15:,20,False,True
708,162,239,77,8/8to8/9,11/10to11/11,8/8to8/9:8/9to8/10:8/10to9/10:9/10to10/10:10/10to11/10:11/10to11/11:,6,True,True
1948,162,259,97,11/7to11/6,12/1to12/2,11/7to11/6:11/6to11/5:11/5to11/4:11/4to11/3:11/3to11/2:11/2to11/1:11/1to12/1:12/1to12/2:,8,False,True
1990,162,388,226,1/11to2/11,15/14toright14,1/11to2/11:2/11to3/11:3/11to4/11:4/11to5/11:5/11to6/11:6/11to7/11:7/11to8/11:8/11to9/11:9/11to10/11:10/11to10/12:10/12to10/13:10/13to10/14:10/14to11/14:11/14to12/14:12/14to13/14:13/14to14/14:14/14to15/14:15/14toright14:,18,False,True
20,163,558,395,left15to0/15,15/0tobottom15,left15to0/15:0/15to0/14:0/14to0/13:0/13to0/12:0/12to0/11:0/11to0/10:0/10to0/9:0/9to0/8:0/8to0/7:0/7to0/6:0/6to0/5:0/5to0/4:0/4to0/3:0/3to0/2:0/2to0/1:0/1to0/0:0/0to1/0:1/0to2/0:2/0to3/0:3/0to4/0:4/0to5/0:5/0to6/0:6/0to7/0:7/0to8/0:8/0to9/0:9/0to10/0:10/0to11/0:11/0to12/0:12/0to13/0:13/0to14/0:14/0to15/0:15/0tobottom15:,32,True,True
449,163,413,250,left2to0/2,12/4to12/3,left2to0/2:0/2to1/2:1/2to2/2:2/2to3/2:3/2to4/2:4/2to5/2:5/2to6/2:6/2to7/2:7/2to8/2:8/2to9/2:9/2to10/2:10/2to10/3:10/3to10/4:10/4to11/4:11/4to12/4:12/4to12/3:,16,False,True
1912,163,320,157,12/12to11/12,3/15totop3,12/12to11/12:11/12to10/12:10/12to9/12:9/12to8/12:8/12to7/12:7/12to6/12:6/12to5/12:5/12to4/12:4/12to3/12:3/12to3/13:3/13to3/14:3/14to3/15:3/15totop3:,13,False,True
2516,163,323,160,7/3to8/3,8/15totop8,7/3to8/3:8/3to8/4:8/4to8/5:8/5to8/6:8/6to8/7:8/7to8/8:8/8to8/9:8/9to8/10:8/10to8/11:8/11to8/12:8/12to8/13:8/13to8/14:8/14to8/15:8/15totop8:,14,False,True
765,164,245,81,7/3to6/3,3/3to3/2,7/3to6/3:6/3to5/3:5/3to4/3:4/3to3/3:3/3to3/2:,5,False,True
3213,164,225,61,3/13to2/13,1/15totop1,3/13to2/13:2/13to1/13:1/13to1/14:1/14to1/15:1/15totop1:,5,True,True
665,164,376,212,bottom2to2/0,13/4to13/5,bottom2to2/0:2/0to2/1:2/1to2/2:2/2to2/3:2/3to2/4:2/4to3/4:3/4to4/4:4/4to5/4:5/4to6/4:6/4to7/4:7/4to8/4:8/4to9/4:9/4to10/4:10/4to11/4:11/4to12/4:12/4to13/4:13/4to13/5:,17,True,True
2412,164,265,101,14/10to13/10,9/10to9/11,14/10to13/10:13/10to12/10:12/10to12/11:12/11to11/11:11/11to10/11:10/11to9/11:9/11to9/10:9/10to9/11:,8,True,True
1361,165,243,78,left3to0/3,2/0to3/0,left3to0/3:0/3to0/2:0/2to0/1:0/1to0/0:0/0to1/0:1/0to2/0:2/0to3/0:,7,True,True
2524,165,247,82,13/11to13/10,12/15totop12,13/11to13/10:13/10to12/10:12/10to12/11:12/11to12/12:12/12to12/13:12/13to12/14:12/14to12/15:12/15totop12:,8,True,True
2844,166,490,324,14/15to13/15,0/5to0/4,14/15to13/15:13/15to12/15:12/15to11/15:11/15to10/15:10/15to9/15:9/15to8/15:8/15to7/15:7/15to6/15:6/15to5/15:5/15to4/15:4/15to3/15:3/15to2/15:2/15to1/15:1/15to0/15:0/15to0/14:0/14to0/13:0/13to0/12:0/12to0/11:0/11to0/10:0/10to0/9:0/9to0/8:0/8to0/7:0/7to0/6:0/6to0/5:0/5to0/4:,25,False,True
1793,166,289,123,6/9to5/9,1/11to0/11,6/9to5/9:5/9to4/9:4/9to3/9:3/9to2/9:2/9to1/9:1/9to1/10:1/10to1/11:1/11to0/11:,8,True,True
2863,166,416,250,13/7to13/6,2/0tobottom2,13/7to13/6:13/6to12/6:12/6to11/6:11/6to10/6:10/6to9/6:9/6to8/6:8/6to7/6:7/6to6/6:6/6to5/6:5/6to4/6:4/6to3/6:3/6to2/6:2/6to2/5:2/5to2/4:2/4to2/3:2/3to2/2:2/2to2/1:2/1to2/0:2/0tobottom2:,19,False,True
1515,166,390,224,2/8to3/8,12/4to12/5,2/8to3/8:3/8to3/7:3/7to3/6:3/6to3/5:3/5to4/5:4/5to5/5:5/5to6/5:6/5to7/5:7/5to8/5:8/5to9/5:9/5to10/5:10/5to10/4:10/4to11/4:11/4to12/4:12/4to12/5:,15,True,True
3177,167,236,69,1/6to1/5,1/1to1/0,1/6to1/5:1/5to1/4:1/4to1/3:1/3to1/2:1/2to1/1:1/1to1/0:,6,False,True
2201,168,258,90,1/11to1/12,4/14to5/14,1/11to1/12:1/12to1/13:1/13to1/14:1/14to2/14:2/14to3/14:3/14to4/14:4/14to5/14:,7,False,True
2184,168,353,185,9/3to10/3,15/11to15/10,9/3to10/3:10/3to10/4:10/4to10/5:10/5to10/6:10/6to10/7:10/7to10/8:10/8to10/9:10/9to10/10:10/10to10/11:10/11to11/11:11/11to12/11:12/11to13/11:13/11to14/11:14/11to15/11:15/11to15/10:,15,False,True
3208,168,330,162,8/7to8/8,4/1to3/1,8/7to8/8:8/8to7/8:7/8to6/8:6/8to5/8:5/8to4/8:4/8to4/7:4/7to4/6:4/6to4/5:4/5to4/4:4/4to4/3:4/3to4/2:4/2to4/1:4/1to3/1:,13,True,True
3298,168,368,200,1/15to1/14,9/11to10/11,1/15to1/14:1/14to1/13:1/13to1/12:1/12to1/11:1/11to2/11:2/11to3/11:3/11to4/11:4/11to5/11:5/11to6/11:6/11to7/11:7/11to8/11:8/11to9/11:9/11to10/11:,13,True,True
2426,168,331,163,5/8to6/8,11/2to12/2,5/8to6/8:6/8to7/8:7/8to8/8:8/8to9/8:9/8to10/8:10/8to10/7:10/7to10/6:10/6to10/5:10/5to10/4:10/4to10/3:10/3to10/2:10/2to11/2:11/2to12/2:,13,False,True
26,168,549,381,left15to0/15,15/0tobottom15,left15to0/15:0/15to1/15:1/15to2/15:2/15to3/15:3/15to4/15:4/15to5/15:5/15to6/15:6/15to7/15:7/15to8/15:8/15to9/15:9/15to10/15:10/15to10/14:10/14to10/13:10/13to10/12:10/12to10/11:10/11to10/10:10/10to10/9:10/9to10/8:10/8to10/7:10/7to10/6:10/6to10/5:10/5to10/4:10/4to10/3:10/3to10/2:10/2to10/1:10/1to10/0:10/0to11/0:11/0to12/0:12/0to13/0:13/0to14/0:14/0to15/0:15/0tobottom15:,32,False,True
747,168,341,173,4/5to4/6,0/14toleft14,4/5to4/6:4/6to3/6:3/6to2/6:2/6to1/6:1/6to0/6:0/6to0/7:0/7to0/8:0/8to0/9:0/9to0/10:0/10to0/11:0/11to0/12:0/12to0/13:0/13to0/14:0/14toleft14:,14,False,True
874,169,254,85,left4to0/4,2/7to3/7,left4to0/4:0/4to0/5:0/5to0/6:0/6to0/7:0/7to1/7:1/7to2/7:2/7to3/7:,7,False,True
1585,169,204,35,1/13to1/14,2/14to2/13,1/13to1/14:1/14to2/14:2/14to2/13:,3,False,True
1744,169,317,148,3/13to3/12,0/6to0/5,3/13to3/12:3/12to2/12:2/12to1/12:1/12to0/12:0/12to0/11:0/11to0/10:0/10to0/9:0/9to0/8:0/8to0/7:0/7to0/6:0/6to0/5:,11,True,True
2406,169,251,82,8/8to9/8,10/12to10/13,8/8to9/8:9/8to9/9:9/9to9/10:9/10to9/11:9/11to10/11:10/11to10/12:10/12to10/13:,7,True,True
1009,169,309,140,4/7to4/6,8/1to9/1,4/7to4/6:4/6to4/5:4/5to4/4:4/4to4/3:4/3to4/2:4/2to4/1:4/1to5/1:5/1to6/1:6/1to7/1:7/1to8/1:8/1to9/1:,11,True,True
3365,169,278,109,12/13to11/13,11/6to12/6,12/13to11/13:11/13to11/12:11/12to11/11:11/11to11/10:11/10to11/9:11/9to11/8:11/8to11/7:11/7to11/6:11/6to12/6:,9,False,True
231,170,582,412,right15to15/15,0/0tobottom0,right15to15/15:15/15to14/15:14/15to13/15:13/15to12/15:12/15to11/15:11/15to11/14:11/14to10/14:10/14to9/14:9/14to8/14:8/14to7/14:7/14to6/14:6/14to5/14:5/14to4/14:4/14to3/14:3/14to2/14:2/14to1/14:1/14to0/14:0/14to0/13:0/13to0/12:0/12to0/11:0/11to0/10:0/10to0/9:0/9to0/8:0/8to0/7:0/7to0/6:0/6to0/5:0/5to0/4:0/4to0/3:0/3to0/2:0/2to0/1:0/1to0/0:0/0tobottom0:,32,True,True
1278,170,328,158,9/9to8/9,2/13to1/13,9/9to8/9:8/9to7/9:7/9to6/9:6/9to5/9:5/9to4/9:4/9to3/9:3/9to2/9:2/9to2/10:2/10to2/11:2/11to2/12:2/12to2/13:2/13to1/13:,12,True,True
3381,171,309,138,14/4to13/4,15/12to15/11,14/4to13/4:13/4to13/5:13/5to13/6:13/6to13/7:13/7to13/8:13/8to13/9:13/9to13/10:13/10to13/11:13/11to13/12:13/12to14/12:14/12to15/12:15/12to15/11:,12,True,True
173,171,571,400,left0to0/0,15/15totop15,left0to0/0:0/0to0/1:0/1to0/2:0/2to0/3:0/3to0/4:0/4to0/5:0/5to0/6:0/6to0/7:0/7to0/8:0/8to0/9:0/9to0/10:0/10to0/11:0/11to0/12:0/12to0/13:0/13to0/14:0/14to1/14:1/14to2/14:2/14to3/14:3/14to4/14:4/14to5/14:5/14to6/14:6/14to7/14:7/14to8/14:8/14to9/14:9/14to10/14:10/14to10/15:10/15to11/15:11/15to12/15:12/15to13/15:13/15to14/15:14/15to15/15:15/15totop15:,32,True,True
3265,171,238,67,13/14to13/13,13/9to12/9,13/14to13/13:13/13to13/12:13/12to13/11:13/11to13/10:13/10to13/9:13/9to12/9:,6,False,True
1552,171,251,80,14/8to13/8,13/13to14/13,14/8to13/8:13/8to13/9:13/9to13/10:13/10to13/11:13/11to13/12:13/12to13/13:13/13to14/13:,7,False,True
105,171,630,459,left0to0/0,15/15totop15,left0to0/0:0/0to0/1:0/1to0/2:0/2to0/3:0/3to0/4:0/4to0/5:0/5to0/6:0/6to0/7:0/7to0/8:0/8to0/9:0/9to0/10:0/10to0/11:0/11to0/12:0/12to0/13:0/13to0/14:0/14to1/14:1/14to2/14:2/14to3/14:3/14to4/14:4/14to5/14:5/14to6/14:6/14to7/14:7/14to8/14:8/14to9/14:9/14to10/14:10/14to10/15:10/15to11/15:11/15to12/15:12/15to13/15:13/15to14/15:14/15to15/15:15/15totop15:,32,True,True
1353,171,439,268,13/11to12/11,3/0to2/0,13/11to12/11:12/11to11/11:11/11to10/11:10/11to9/11:9/11to8/11:8/11to7/11:7/11to6/11:6/11to5/11:5/11to4/11:4/11to3/11:3/11to3/10:3/10to3/9:3/9to3/8:3/8to3/7:3/7to3/6:3/6to3/5:3/5to3/4:3/4to3/3:3/3to3/2:3/2to3/1:3/1to3/0:3/0to2/0:,22,False,True
1189,172,435,263,2/15to3/15,14/11to15/11,2/15to3/15:3/15to3/14:3/14to3/13:3/13to3/12:3/12to3/11:3/11to4/11:4/11to5/11:5/11to6/11:6/11to7/11:7/11to8/11:8/11to9/11:9/11to10/11:10/11to11/11:11/11to12/11:12/11to13/11:13/11to14/11:14/11to15/11:,17,True,True
3085,172,329,157,7/10to8/10,9/0to10/0,7/10to8/10:8/10to8/9:8/9to8/8:8/8to8/7:8/7to8/6:8/6to8/5:8/5to8/4:8/4to8/3:8/3to8/2:8/2to8/1:8/1to8/0:8/0to9/0:9/0to10/0:,13,False,True
3250,173,241,68,10/9to11/9,13/9to14/9,10/9to11/9:11/9to12/9:12/9to13/9:13/9to14/9:,4,False,True
1347,173,281,108,12/14to12/13,5/13to5/12,12/14to12/13:12/13to11/13:11/13to10/13:10/13to9/13:9/13to8/13:8/13to7/13:7/13to6/13:6/13to5/13:5/13to5/12:,9,True,True
3022,174,411,237,9/9to9/8,0/12toleft12,9/9to9/8:9/8to8/8:8/8to7/8:7/8to6/8:6/8to5/8:5/8to4/8:4/8to3/8:3/8to2/8:2/8to1/8:1/8to0/8:0/8to0/9:0/9to0/10:0/10to0/11:0/11to0/12:0/12toleft12:,15,True,True
2936,174,222,48,0/3to0/2,0/0to1/0,0/3to0/2:0/2to0/1:0/1to0/0:0/0to1/0:,4,True,True
2353,174,248,74,2/6to2/5,3/2to4/2,2/6to2/5:2/5to2/4:2/4to2/3:2/3to2/2:2/2to3/2:3/2to4/2:,6,False,True
2104,174,334,160,5/2to5/1,10/4to9/4,5/2to5/1:5/1to6/1:6/1to7/1:7/1to8/1:8/1to9/1:9/1to10/1:10/1to10/2:10/2to10/3:10/3to10/4:10/4to9/4:,10,False,True
2736,175,431,256,left6to0/6,15/3to15/4,left6to0/6:0/6to1/6:1/6to2/6:2/6to3/6:3/6to4/6:4/6to5/6:5/6to6/6:6/6to7/6:7/6to8/6:8/6to9/6:9/6to10/6:10/6to10/5:10/5to10/4:10/4to10/3:10/3to11/3:11/3to12/3:12/3to13/3:13/3to14/3:14/3to15/3:15/3to15/4:,20,False,True
1767,175,337,162,15/10to15/11,8/13to8/14,15/10to15/11:15/11to14/11:14/11to13/11:13/11to12/11:12/11to11/11:11/11to10/11:10/11to9/11:9/11to8/11:8/11to8/12:8/12to8/13:8/13to8/14:,11,False,True
2510,175,407,232,0/0to0/1,10/6to11/6,0/0to0/1:0/1to0/2:0/2to0/3:0/3to0/4:0/4to1/4:1/4to2/4:2/4to3/4:3/4to4/4:4/4to5/4:5/4to6/4:6/4to7/4:7/4to8/4:8/4to9/4:9/4to10/4:10/4to10/5:10/5to10/6:10/6to11/6:,17,True,True
2693,175,376,201,top15to15/15,13/1to13/0,top15to15/15:15/15to14/15:14/15to13/15:13/15to13/14:13/14to13/13:13/13to13/12:13/12to13/11:13/11to13/10:13/10to13/9:13/9to13/8:13/8to13/7:13/7to13/6:13/6to13/5:13/5to13/4:13/4to13/3:13/3to13/2:13/2to13/1:13/1to13/0:,18,False,True
2495,175,267,92,7/9to7/8,3/7to3/6,7/9to7/8:7/8to6/8:6/8to5/8:5/8to4/8:4/8to3/8:3/8to3/7:3/7to3/6:,7,False,True
1466,176,300,124,6/10to7/10,10/13to10/14,6/10to7/10:7/10to7/11:7/11to7/12:7/12to7/13:7/13to8/13:8/13to9/13:9/13to10/13:10/13to10/14:,8,True,True
1666,176,432,256,12/12to12/11,1/4to1/3,12/12to12/11:12/11to11/11:11/11to10/11:10/11to9/11:9/11to8/11:8/11to7/11:7/11to6/11:6/11to5/11:5/11to4/11:4/11to3/11:3/11to2/11:2/11to1/11:1/11to1/10:1/10to1/9:1/9to1/8:1/8to1/7:1/7to1/6:1/6to1/5:1/5to1/4:1/4to1/3:,20,True,True
3199,176,249,73,2/8to1/8,1/4to2/4,2/8to1/8:1/8to1/7:1/7to1/6:1/6to1/5:1/5to1/4:1/4to2/4:,6,False,True
2019,177,257,80,7/7to8/7,8/12to9/12,7/7to8/7:8/7to8/8:8/8to8/9:8/9to8/10:8/10to8/11:8/11to8/12:8/12to9/12:,7,True,True
1618,177,199,22,12/5to12/4,12/4to11/4,12/5to12/4:12/4to11/4:,2,False,True
2621,177,383,206,15/12to15/11,7/4to7/3,15/12to15/11:15/11to14/11:14/11to13/11:13/11to12/11:12/11to11/11:11/11to10/11:10/11to9/11:9/11to8/11:8/11to7/11:7/11to7/10:7/10to7/9:7/9to7/8:7/8to7/7:7/7to7/6:7/6to7/5:7/5to7/4:7/4to7/3:,17,True,True
3047,177,303,126,3/13to3/12,3/3to3/2,3/13to3/12:3/12to3/11:3/11to3/10:3/10to3/9:3/9to3/8:3/8to3/7:3/7to3/6:3/6to3/5:3/5to3/4:3/4to3/3:3/3to3/2:,11,False,True
2030,178,262,84,11/5to10/5,10/10to11/10,11/5to10/5:10/5to10/6:10/6to10/7:10/7to10/8:10/8to10/9:10/9to10/10:10/10to11/10:,7,False,True
2462,178,403,225,left4to0/4,12/4to13/4,left4to0/4:0/4to1/4:1/4to2/4:2/4to3/4:3/4to4/4:4/4to5/4:5/4to6/4:6/4to7/4:7/4to8/4:8/4to9/4:9/4to10/4:10/4to11/4:11/4to12/4:12/4to13/4:,14,True,True
460,178,266,88,8/5to8/6,12/5to12/6,8/5to8/6:8/6to9/6:9/6to10/6:10/6to10/5:10/5to11/5:11/5to12/5:12/5to12/6:,7,False,True
216,179,609,430,right15to15/15,0/0tobottom0,right15to15/15:15/15to14/15:14/15to13/15:13/15to12/15:12/15to11/15:11/15to11/14:11/14to10/14:10/14to9/14:9/14to8/14:8/14to7/14:7/14to6/14:6/14to5/14:5/14to4/14:4/14to3/14:3/14to2/14:2/14to1/14:1/14to0/14:0/14to0/13:0/13to0/12:0/12to0/11:0/11to0/10:0/10to0/9:0/9to0/8:0/8to0/7:0/7to0/6:0/6to0/5:0/5to0/4:0/4to0/3:0/3to0/2:0/2to0/1:0/1to0/0:0/0tobottom0:,32,True,True
1093,179,308,129,9/13to8/13,7/6to8/6,9/13to8/13:8/13to7/13:7/13to7/12:7/12to7/11:7/11to7/10:7/10to7/9:7/9to7/8:7/8to7/7:7/7to7/6:7/6to8/6:,10,True,True
140,179,586,407,left0to0/0,15/15totop15,left0to0/0:0/0to1/0:1/0to2/0:2/0to3/0:3/0to4/0:4/0to5/0:5/0to6/0:6/0to7/0:7/0to8/0:8/0to9/0:9/0to10/0:10/0to10/1:10/1to10/2:10/2to10/3:10/3to10/4:10/4to10/5:10/5to10/6:10/6to10/7:10/7to10/8:10/8to10/9:10/9to10/10:10/10to10/11:10/11to10/12:10/12to10/13:10/13to10/14:10/14to10/15:10/15to11/15:11/15to12/15:12/15to13/15:13/15to14/15:14/15to15/15:15/15totop15:,32,False,True
2278,179,262,83,1/9to0/9,0/3toleft3,1/9to0/9:0/9to0/8:0/8to0/7:0/7to0/6:0/6to0/5:0/5to0/4:0/4to0/3:0/3toleft3:,8,True,True
2499,180,463,283,0/15to1/15,12/5to13/5,0/15to1/15:1/15to2/15:2/15to3/15:3/15to4/15:4/15to5/15:5/15to6/15:6/15to7/15:7/15to8/15:8/15to9/15:9/15to10/15:10/15to10/14:10/14to10/13:10/13to10/12:10/12to10/11:10/11to10/10:10/10to10/9:10/9to10/8:10/8to10/7:10/7to10/6:10/6to10/5:10/5to11/5:11/5to12/5:12/5to13/5:,23,False,True
752,181,263,82,15/8to15/9,15/15toright15,15/8to15/9:15/9to15/10:15/10to15/11:15/11to15/12:15/12to15/13:15/13to15/14:15/14to15/15:15/15toright15:,8,False,True
329,181,567,386,right0to15/0,0/15totop0,right0to15/0:15/0to14/0:14/0to13/0:13/0to12/0:12/0to11/0:11/0to11/1:11/1to10/1:10/1to9/1:9/1to8/1:8/1to7/1:7/1to6/1:6/1to5/1:5/1to4/1:4/1to3/1:3/1to2/1:2/1to1/1:1/1to0/1:0/1to0/2:0/2to0/3:0/3to0/4:0/4to0/5:0/5to0/6:0/6to0/7:0/7to0/8:0/8to0/9:0/9to0/10:0/10to0/11:0/11to0/12:0/12to0/13:0/13to0/14:0/14to0/15:0/15totop0:,32,True,True
111,181,649,468,left0to0/0,15/15totop15,left0to0/0:0/0to0/1:0/1to0/2:0/2to0/3:0/3to0/4:0/4to0/5:0/5to0/6:0/6to0/7:0/7to0/8:0/8to0/9:0/9to0/10:0/10to0/11:0/11to0/12:0/12to0/13:0/13to0/14:0/14to1/14:1/14to2/14:2/14to3/14:3/14to4/14:4/14to5/14:5/14to6/14:6/14to7/14:7/14to8/14:8/14to9/14:9/14to10/14:10/14to10/15:10/15to11/15:11/15to12/15:12/15to13/15:13/15to14/15:14/15to15/15:15/15totop15:,32,True,True
73,181,563,382,left15to0/15,15/0tobottom15,left15to0/15:0/15to1/15:1/15to2/15:2/15to3/15:3/15to4/15:4/15to5/15:5/15to6/15:6/15to7/15:7/15to8/15:8/15to9/15:9/15to10/15:10/15to10/14:10/14to10/13:10/13to10/12:10/12to10/11:10/11to10/10:10/10to10/9:10/9to10/8:10/8to10/7:10/7to10/6:10/6to10/5:10/5to10/4:10/4to10/3:10/3to10/2:10/2to10/1:10/1to10/0:10/0to11/0:11/0to12/0:12/0to13/0:13/0to14/0:14/0to15/0:15/0tobottom15:,32,False,True
1418,182,378,196,11/3to10/3,2/9to2/10,11/3to10/3:10/3to10/4:10/4to9/4:9/4to8/4:8/4to7/4:7/4to6/4:6/4to5/4:5/4to4/4:4/4to3/4:3/4to2/4:2/4to2/5:2/5to2/6:2/6to2/7:2/7to2/8:2/8to2/9:2/9to2/10:,16,True,True
831,182,337,155,12/0to12/1,14/10to15/10,12/0to12/1:12/1to12/2:12/2to12/3:12/3to12/4:12/4to12/5:12/5to12/6:12/6to12/7:12/7to12/8:12/8to12/9:12/9to12/10:12/10to13/10:13/10to14/10:14/10to15/10:,13,True,True
1733,182,298,116,14/14to13/14,13/6to13/5,14/14to13/14:13/14to13/13:13/13to13/12:13/12to13/11:13/11to13/10:13/10to13/9:13/9to13/8:13/8to13/7:13/7to13/6:13/6to13/5:,10,True,True
3335,183,274,91,11/11to11/12,14/14to15/14,11/11to11/12:11/12to11/13:11/13to11/14:11/14to12/14:12/14to13/14:13/14to14/14:14/14to15/14:,7,True,True
3218,185,269,84,right3to15/3,15/9to14/9,right3to15/3:15/3to15/4:15/4to15/5:15/5to15/6:15/6to15/7:15/7to15/8:15/8to15/9:15/9to14/9:,8,True,True
1128,185,428,243,3/3to4/3,14/7to15/7,3/3to4/3:4/3to4/4:4/4to4/5:4/5to5/5:5/5to6/5:6/5to7/5:7/5to8/5:8/5to9/5:9/5to10/5:10/5to10/6:10/6to11/6:11/6to12/6:12/6to12/7:12/7to13/7:13/7to14/7:14/7to15/7:,16,True,True
2366,185,285,100,8/5to9/5,13/5to14/5,8/5to9/5:9/5to10/5:10/5to11/5:11/5to12/5:12/5to13/5:13/5to14/5:,6,True,True
3114,185,403,218,11/9to10/9,2/3to2/2,11/9to10/9:10/9to9/9:9/9to8/9:8/9to7/9:7/9to6/9:6/9to5/9:5/9to4/9:4/9to3/9:3/9to2/9:2/9to2/8:2/8to2/7:2/7to2/6:2/6to2/5:2/5to2/4:2/4to2/3:2/3to2/2:,16,False,True
2890,186,239,53,7/10to8/10,9/9to9/8,7/10to8/10:8/10to8/9:8/9to9/9:9/9to9/8:,4,True,True
1880,186,384,198,4/1to4/2,7/14to8/14,4/1to4/2:4/2to4/3:4/3to4/4:4/4to4/5:4/5to4/6:4/6to4/7:4/7to4/8:4/8to4/9:4/9to4/10:4/10to4/11:4/11to4/12:4/12to4/13:4/13to4/14:4/14to5/14:5/14to6/14:6/14to7/14:7/14to8/14:,17,True,True
2688,186,348,162,14/14to13/14,13/2to12/2,14/14to13/14:13/14to13/13:13/13to13/12:13/12to13/11:13/11to13/10:13/10to13/9:13/9to13/8:13/8to13/7:13/7to13/6:13/6to13/5:13/5to13/4:13/4to13/3:13/3to13/2:13/2to12/2:,14,False,True
2430,186,287,101,14/9to13/9,10/6to9/6,14/9to13/9:13/9to12/9:12/9to11/9:11/9to10/9:10/9to10/8:10/8to10/7:10/7to10/6:10/6to9/6:,8,False,True
2045,186,213,27,left0to0/0,0/1to0/2,left0to0/0:0/0to0/1:0/1to0/2:,3,True,True
1972,186,348,162,9/7to9/8,3/12to3/13,9/7to9/8:9/8to8/8:8/8to7/8:7/8to6/8:6/8to5/8:5/8to4/8:4/8to3/8:3/8to3/9:3/9to3/10:3/10to3/11:3/11to3/12:3/12to3/13:,12,True,True
3012,186,358,172,top9to9/15,9/2to9/1,top9to9/15:9/15to9/14:9/14to9/13:9/13to9/12:9/12to9/11:9/11to9/10:9/10to9/9:9/9to9/8:9/8to9/7:9/7to9/6:9/6to9/5:9/5to9/4:9/4to9/3:9/3to9/2:9/2to9/1:,15,True,True
1616,186,389,203,14/0to13/0,2/2to2/3,14/0to13/0:13/0to12/0:12/0to11/0:11/0to11/1:11/1to10/1:10/1to9/1:9/1to8/1:8/1to7/1:7/1to6/1:6/1to5/1:5/1to4/1:4/1to3/1:3/1to2/1:2/1to2/2:2/2to2/3:,15,True,True
2012,186,337,151,6/3to7/3,7/13to6/13,6/3to7/3:7/3to7/4:7/4to7/5:7/5to7/6:7/6to7/7:7/7to7/8:7/8to7/9:7/9to7/10:7/10to7/11:7/11to7/12:7/12to7/13:7/13to6/13:,12,False,True
2606,187,432,245,2/7to2/6,12/0to13/0,2/7to2/6:2/6to3/6:3/6to4/6:4/6to5/6:5/6to6/6:6/6to7/6:7/6to8/6:8/6to9/6:9/6to10/6:10/6to10/5:10/5to10/4:10/4to10/3:10/3to10/2:10/2to10/1:10/1to10/0:10/0to11/0:11/0to12/0:12/0to13/0:,18,False,True
2753,187,503,316,0/14to1/14,11/2to11/3,0/14to1/14:1/14to2/14:2/14to3/14:3/14to4/14:4/14to5/14:5/14to6/14:6/14to7/14:7/14to8/14:8/14to9/14:9/14to10/14:10/14to10/13:10/13to10/12:10/12to10/11:10/11to10/10:10/10to10/9:10/9to10/8:10/8to10/7:10/7to10/6:10/6to10/5:10/5to10/4:10/4to10/3:10/3to10/2:10/2to11/2:11/2to11/3:,24,False,True
557,188,365,177,9/8to9/7,13/11to14/11,9/8to9/7:9/7to10/7:10/7to10/8:10/8to10/9:10/9to10/10:10/10to10/11:10/11to11/11:11/11to12/11:12/11to13/11:13/11to14/11:,10,False,True
1337,190,385,195,15/9to14/9,9/0to9/1,15/9to14/9:14/9to13/9:13/9to12/9:12/9to11/9:11/9to10/9:10/9to10/8:10/8to10/7:10/7to10/6:10/6to10/5:10/5to10/4:10/4to10/3:10/3to10/2:10/2to10/1:10/1to10/0:10/0to9/0:9/0to9/1:,16,False,True
2877,190,324,134,top2to2/15,4/7to4/8,top2to2/15:2/15to2/14:2/14to2/13:2/13to2/12:2/12to2/11:2/11to2/10:2/10to2/9:2/9to2/8:2/8to2/7:2/7to3/7:3/7to4/7:4/7to4/8:,12,True,True
516,191,410,219,1/11to2/11,13/7to14/7,1/11to2/11:2/11to3/11:3/11to4/11:4/11to5/11:5/11to6/11:6/11to7/11:7/11to8/11:8/11to9/11:9/11to10/11:10/11to10/10:10/10to10/9:10/9to10/8:10/8to10/7:10/7to11/7:11/7to12/7:12/7to13/7:13/7to14/7:,17,False,True
1383,191,360,169,2/10to2/9,6/1to6/0,2/10to2/9:2/9to2/8:2/8to2/7:2/7to2/6:2/6to2/5:2/5to2/4:2/4to2/3:2/3to2/2:2/2to2/1:2/1to3/1:3/1to4/1:4/1to5/1:5/1to6/1:6/1to6/0:,14,False,True
1541,192,328,136,11/9to11/8,15/3to15/4,11/9to11/8:11/8to12/8:12/8to12/7:12/7to12/6:12/6to12/5:12/5to12/4:12/4to12/3:12/3to13/3:13/3to14/3:14/3to15/3:15/3to15/4:,11,True,True
2833,193,322,129,15/15to14/15,12/8to11/8,15/15to14/15:14/15to13/15:13/15to12/15:12/15to12/14:12/14to12/13:12/13to12/12:12/12to12/11:12/11to12/10:12/10to12/9:12/9to12/8:12/8to11/8:,11,False,True
1889,193,334,141,2/12to2/11,8/9to9/9,2/12to2/11:2/11to2/10:2/10to2/9:2/9to3/9:3/9to4/9:4/9to5/9:5/9to6/9:6/9to7/9:7/9to8/9:8/9to9/9:,10,True,True
3200,193,266,73,3/13to2/13,0/11to1/11,3/13to2/13:2/13to1/13:1/13to0/13:0/13to0/12:0/12to0/11:0/11to1/11:,6,True,True
2545,194,375,181,0/10to1/10,6/2to6/3,0/10to1/10:1/10to1/9:1/9to1/8:1/8to1/7:1/7to1/6:1/6to1/5:1/5to1/4:1/4to1/3:1/3to1/2:1/2to2/2:2/2to3/2:3/2to4/2:4/2to5/2:5/2to6/2:6/2to6/3:,15,True,True
2135,195,400,205,right9to15/9,5/4to5/3,right9to15/9:15/9to14/9:14/9to13/9:13/9to12/9:12/9to11/9:11/9to10/9:10/9to9/9:9/9to8/9:8/9to7/9:7/9to6/9:6/9to5/9:5/9to5/8:5/8to5/7:5/7to5/6:5/6to5/5:5/5to5/4:5/4to5/3:,17,False,True
436,196,274,78,6/4to5/4,7/2to7/1,6/4to5/4:5/4to5/3:5/3to5/2:5/2to6/2:6/2to7/2:7/2to7/1:,6,False,True
1988,196,222,26,5/10to6/10,6/10to6/11,5/10to6/10:6/10to6/11:,2,True,True
3013,198,386,188,14/2to13/2,14/15to15/15,14/2to13/2:13/2to13/3:13/3to13/4:13/4to13/5:13/5to13/6:13/6to13/7:13/7to13/8:13/8to13/9:13/9to13/10:13/10to13/11:13/11to13/12:13/12to13/13:13/13to13/14:13/14to13/15:13/15to14/15:14/15to15/15:,16,True,True
1381,198,434,236,11/6to11/7,5/14to6/14,11/6to11/7:11/7to10/7:10/7to9/7:9/7to8/7:8/7to7/7:7/7to6/7:6/7to5/7:5/7to5/8:5/8to5/9:5/9to5/10:5/10to5/11:5/11to5/12:5/12to5/13:5/13to5/14:5/14to6/14:,15,False,True
3292,199,281,82,14/7to13/7,11/5to10/5,14/7to13/7:13/7to12/7:12/7to11/7:11/7to11/6:11/6to11/5:11/5to10/5:,6,False,True
1917,199,430,231,4/13to3/13,8/2to8/1,4/13to3/13:3/13to3/12:3/12to3/11:3/11to3/10:3/10to3/9:3/9to3/8:3/8to3/7:3/7to3/6:3/6to3/5:3/5to3/4:3/4to3/3:3/3to3/2:3/2to4/2:4/2to5/2:5/2to6/2:6/2to7/2:7/2to8/2:8/2to8/1:,18,True,True
1933,199,270,71,10/8to9/8,5/8to5/9,10/8to9/8:9/8to8/8:8/8to7/8:7/8to6/8:6/8to5/8:5/8to5/9:,6,False,True
2969,199,293,94,4/8to4/9,3/4to3/3,4/8to4/9:4/9to3/9:3/9to3/8:3/8to3/7:3/7to3/6:3/6to3/5:3/5to3/4:3/4to3/3:,8,False,True
1275,199,289,90,1/1to0/1,2/4to3/4,1/1to0/1:0/1to0/2:0/2to0/3:0/3to0/4:0/4to1/4:1/4to2/4:2/4to3/4:,7,False,True
1354,200,484,284,14/12to14/13,3/4to3/3,14/12to14/13:14/13to13/13:13/13to12/13:12/13to11/13:11/13to10/13:10/13to9/13:9/13to8/13:8/13to7/13:7/13to6/13:6/13to5/13:5/13to4/13:4/13to3/13:3/13to3/12:3/12to3/11:3/11to3/10:3/10to3/9:3/9to3/8:3/8to3/7:3/7to3/6:3/6to3/5:3/5to3/4:3/4to3/3:,22,False,True
2078,200,342,142,5/8to4/8,7/15to7/14,5/8to4/8:4/8to4/9:4/9to4/10:4/10to4/11:4/11to4/12:4/12to4/13:4/13to4/14:4/14to4/15:4/15to5/15:5/15to6/15:6/15to7/15:7/15to7/14:,12,True,True
823,200,467,267,12/4to12/5,1/12to1/13,12/4to12/5:12/5to11/5:11/5to10/5:10/5to9/5:9/5to8/5:8/5to7/5:7/5to6/5:6/5to5/5:5/5to4/5:4/5to3/5:3/5to2/5:2/5to1/5:1/5to1/6:1/6to1/7:1/7to1/8:1/8to1/9:1/9to1/10:1/10to1/11:1/11to1/12:1/12to1/13:,20,False,True
1969,200,341,141,top7to7/15,13/12to13/13,top7to7/15:7/15to7/14:7/14to7/13:7/13to7/12:7/12to8/12:8/12to9/12:9/12to10/12:10/12to11/12:11/12to12/12:12/12to13/12:13/12to13/13:,11,True,True
1073,200,487,287,6/7to6/8,13/15to13/14,6/7to6/8:6/8to6/9:6/9to6/10:6/10to6/11:6/11to6/12:6/12to6/13:6/13to7/13:7/13to8/13:8/13to9/13:9/13to10/13:10/13to10/14:10/14to11/14:11/14to11/15:11/15to12/15:12/15to13/15:13/15to13/14:,16,True,True
521,200,351,151,8/9to8/10,5/3to5/2,8/9to8/10:8/10to7/10:7/10to6/10:6/10to5/10:5/10to5/9:5/9to5/8:5/8to5/7:5/7to5/6:5/6to5/5:5/5to5/4:5/4to5/3:5/3to5/2:,12,True,True
3198,200,229,29,left5to0/5,0/3toleft3,left5to0/5:0/5to0/4:0/4to0/3:0/3toleft3:,4,False,True
1404,200,300,100,8/5to7/5,4/2to3/2,8/5to7/5:7/5to6/5:6/5to5/5:5/5to4/5:4/5to4/4:4/4to4/3:4/3to4/2:4/2to3/2:,8,False,True
1380,201,410,209,8/0to9/0,15/9to15/8,8/0to9/0:9/0to10/0:10/0to10/1:10/1to10/2:10/2to10/3:10/3to10/4:10/4to10/5:10/5to10/6:10/6to10/7:10/7to10/8:10/8to10/9:10/9to11/9:11/9to12/9:12/9to13/9:13/9to14/9:14/9to15/9:15/9to15/8:,17,False,True
2529,201,478,277,14/6to14/7,3/1to4/1,14/6to14/7:14/7to13/7:13/7to12/7:12/7to11/7:11/7to10/7:10/7to9/7:9/7to8/7:8/7to7/7:7/7to6/7:6/7to5/7:5/7to4/7:4/7to3/7:3/7to3/6:3/6to3/5:3/5to3/4:3/4to3/3:3/3to3/2:3/2to3/1:3/1to4/1:,19,True,True
500,201,409,208,0/2to0/3,11/2to11/1,0/2to0/3:0/3to0/2:0/2to1/2:1/2to2/2:2/2to3/2:3/2to4/2:4/2to5/2:5/2to6/2:6/2to7/2:7/2to8/2:8/2to9/2:9/2to10/2:10/2to11/2:11/2to11/1:,14,True,True
2929,201,456,255,10/0to10/1,2/12to2/13,10/0to10/1:10/1to9/1:9/1to8/1:8/1to7/1:7/1to6/1:6/1to5/1:5/1to4/1:4/1to3/1:3/1to2/1:2/1to2/2:2/2to2/3:2/3to2/4:2/4to2/5:2/5to2/6:2/6to2/7:2/7to2/8:2/8to2/9:2/9to2/10:2/10to2/11:2/11to2/12:2/12to2/13:,21,False,True
2138,201,335,134,left9to0/9,0/0to1/0,left9to0/9:0/9to0/8:0/8to0/7:0/7to0/6:0/6to0/5:0/5to0/4:0/4to0/3:0/3to0/2:0/2to0/1:0/1to0/0:0/0to1/0:,11,False,True
2087,201,495,294,13/13to12/13,4/0to5/0,13/13to12/13:12/13to11/13:11/13to10/13:10/13to9/13:9/13to8/13:8/13to7/13:7/13to6/13:6/13to5/13:5/13to4/13:4/13to4/12:4/12to4/11:4/11to4/10:4/10to4/9:4/9to4/8:4/8to4/7:4/7to4/6:4/6to4/5:4/5to4/4:4/4to4/3:4/3to4/2:4/2to4/1:4/1to4/0:4/0to5/0:,23,False,True
2920,201,585,384,0/0to1/0,14/15to15/15,0/0to1/0:1/0to2/0:2/0to3/0:3/0to4/0:4/0to5/0:5/0to6/0:6/0to7/0:7/0to8/0:8/0to9/0:9/0to10/0:10/0to10/1:10/1to10/2:10/2to10/3:10/3to10/4:10/4to10/5:10/5to10/6:10/6to10/7:10/7to10/8:10/8to10/9:10/9to10/10:10/10to10/11:10/11to10/12:10/12to10/13:10/13to10/14:10/14to10/15:10/15to11/15:11/15to12/15:12/15to13/15:13/15to14/15:14/15to15/15:,30,False,True
3170,202,353,151,9/6to10/6,14/12to15/12,9/6to10/6:10/6to10/7:10/7to10/8:10/8to10/9:10/9to10/10:10/10to10/11:10/11to10/12:10/12to11/12:11/12to12/12:12/12to13/12:13/12to14/12:14/12to15/12:,12,False,True
3351,202,353,151,7/9to7/8,0/8to0/7,7/9to7/8:7/8to6/8:6/8to5/8:5/8to4/8:4/8to3/8:3/8to2/8:2/8to1/8:1/8to0/8:0/8to0/7:,9,True,True
2200,202,455,253,13/13to12/13,2/6to2/5,13/13to12/13:12/13to12/12:12/12to11/12:11/12to10/12:10/12to9/12:9/12to8/12:8/12to7/12:7/12to6/12:6/12to5/12:5/12to4/12:4/12to3/12:3/12to2/12:2/12to2/11:2/11to2/10:2/10to2/9:2/9to2/8:2/8to2/7:2/7to2/6:2/6to2/5:,19,True,True
2957,203,294,91,6/12to7/12,7/6to6/6,6/12to7/12:7/12to7/11:7/11to7/10:7/10to7/9:7/9to7/8:7/8to7/7:7/7to7/6:7/6to6/6:,8,True,True
275,203,588,385,right15to15/15,0/0tobottom0,right15to15/15:15/15to14/15:14/15to13/15:13/15to12/15:12/15to11/15:11/15to10/15:10/15to9/15:9/15to8/15:8/15to7/15:7/15to6/15:6/15to5/15:5/15to4/15:4/15to3/15:3/15to2/15:2/15to1/15:1/15to0/15:0/15to0/14:0/14to0/13:0/13to0/12:0/12to0/11:0/11to0/10:0/10to0/9:0/9to0/8:0/8to0/7:0/7to0/6:0/6to0/5:0/5to0/4:0/4to0/3:0/3to0/2:0/2to0/1:0/1to0/0:0/0tobottom0:,32,False,True
11,203,601,398,left15to0/15,15/0tobottom15,left15to0/15:0/15to0/14:0/14to0/13:0/13to0/12:0/12to0/11:0/11to0/10:0/10to0/9:0/9to0/8:0/8to0/7:0/7to0/6:0/6to0/5:0/5to0/4:0/4to0/3:0/3to0/2:0/2to1/2:1/2to2/2:2/2to3/2:3/2to4/2:4/2to5/2:5/2to6/2:6/2to7/2:7/2to8/2:8/2to9/2:9/2to10/2:10/2to10/1:10/1to11/1:11/1to11/0:11/0to12/0:12/0to13/0:13/0to14/0:14/0to15/0:15/0tobottom15:,32,True,True
336,203,574,371,right0to15/0,0/15totop0,right0to15/0:15/0to14/0:14/0to13/0:13/0to12/0:12/0to11/0:11/0to11/1:11/1to10/1:10/1to9/1:9/1to8/1:8/1to7/1:7/1to6/1:6/1to5/1:5/1to4/1:4/1to3/1:3/1to2/1:2/1to1/1:1/1to0/1:0/1to0/2:0/2to0/3:0/3to0/4:0/4to0/5:0/5to0/6:0/6to0/7:0/7to0/8:0/8to0/9:0/9to0/10:0/10to0/11:0/11to0/12:0/12to0/13:0/13to0/14:0/14to0/15:0/15totop0:,32,True,True
333,203,578,375,right0to15/0,0/15totop0,right0to15/0:15/0to14/0:14/0to13/0:13/0to12/0:12/0to11/0:11/0to10/0:10/0to9/0:9/0to8/0:8/0to7/0:7/0to6/0:6/0to5/0:5/0to4/0:4/0to3/0:3/0to2/0:2/0to1/0:1/0to0/0:0/0to0/1:0/1to0/2:0/2to0/3:0/3to0/4:0/4to0/5:0/5to0/6:0/6to0/7:0/7to0/8:0/8to0/9:0/9to0/10:0/10to0/11:0/11to0/12:0/12to0/13:0/13to0/14:0/14to0/15:0/15totop0:,32,True,True
2345,204,381,177,top7to7/15,5/3to4/3,top7to7/15:7/15to6/15:6/15to5/15:5/15to5/14:5/14to5/13:5/13to5/12:5/12to5/11:5/11to5/10:5/10to5/9:5/9to5/8:5/8to5/7:5/7to5/6:5/6to5/5:5/5to5/4:5/4to5/3:5/3to4/3:,16,False,True
2214,204,470,266,top6to6/15,13/2to13/3,top6to6/15:6/15to6/14:6/14to6/13:6/13to6/12:6/12to6/11:6/11to6/10:6/10to6/9:6/9to6/8:6/8to6/7:6/7to6/6:6/6to6/5:6/5to6/4:6/4to6/3:6/3to7/3:7/3to8/3:8/3to9/3:9/3to10/3:10/3to10/2:10/2to11/2:11/2to12/2:12/2to13/2:13/2to13/3:,22,True,True
3049,204,431,227,11/2to11/1,3/9to2/9,11/2to11/1:11/1to10/1:10/1to9/1:9/1to8/1:8/1to7/1:7/1to6/1:6/1to5/1:5/1to4/1:4/1to3/1:3/1to3/2:3/2to3/3:3/3to3/4:3/4to3/5:3/5to3/6:3/6to3/7:3/7to3/8:3/8to3/9:3/9to2/9:,18,False,True
3307,204,372,168,14/14to14/15,11/6to12/6,14/14to14/15:14/15to13/15:13/15to12/15:12/15to12/14:12/14to12/13:12/13to12/12:12/12to12/11:12/11to12/10:12/10to12/9:12/9to12/8:12/8to12/7:12/7to12/6:12/6to11/6:11/6to12/6:,14,True,True
316,204,591,387,right0to15/0,0/15totop0,right0to15/0:15/0to14/0:14/0to13/0:13/0to12/0:12/0to11/0:11/0to10/0:10/0to9/0:9/0to8/0:8/0to7/0:7/0to6/0:6/0to5/0:5/0to4/0:4/0to3/0:3/0to2/0:2/0to1/0:1/0to0/0:0/0to0/1:0/1to0/2:0/2to0/3:0/3to0/4:0/4to0/5:0/5to0/6:0/6to0/7:0/7to0/8:0/8to0/9:0/9to0/10:0/10to0/11:0/11to0/12:0/12to0/13:0/13to0/14:0/14to0/15:0/15totop0:,32,False,True
2232,204,240,36,12/14to12/13,11/13to11/12,12/14to12/13:12/13to11/13:11/13to11/12:,3,False,True
2328,205,421,216,11/1to10/1,14/13to15/13,11/1to10/1:10/1to10/2:10/2to10/3:10/3to10/4:10/4to10/5:10/5to10/6:10/6to10/7:10/7to10/8:10/8to10/9:10/9to10/10:10/10to10/11:10/11to10/12:10/12to10/13:10/13to11/13:11/13to12/13:12/13to13/13:13/13to14/13:14/13to15/13:,18,False,True
2673,205,410,205,14/5to13/5,5/11to5/12,14/5to13/5:13/5to12/5:12/5to11/5:11/5to10/5:10/5to9/5:9/5to8/5:8/5to7/5:7/5to6/5:6/5to5/5:5/5to5/6:5/6to5/7:5/7to5/8:5/8to5/9:5/9to5/10:5/10to5/11:5/11to5/12:,16,True,True
502,205,434,229,top6to6/15,2/0tobottom2,top6to6/15:6/15to5/15:5/15to4/15:4/15to3/15:3/15to2/15:2/15to2/14:2/14to2/13:2/13to2/12:2/12to2/11:2/11to2/10:2/10to2/9:2/9to2/8:2/8to2/7:2/7to2/6:2/6to2/5:2/5to2/4:2/4to2/3:2/3to2/2:2/2to2/1:2/1to2/0:2/0tobottom2:,21,False,True
1282,205,413,208,7/12to7/11,13/4to13/3,7/12to7/11:7/11to7/10:7/10to7/9:7/9to7/8:7/8to7/7:7/7to7/6:7/6to7/5:7/5to8/5:8/5to9/5:9/5to10/5:10/5to10/4:10/4to11/4:11/4to12/4:12/4to13/4:13/4to13/3:,15,True,True
1219,205,466,261,5/8to5/9,10/12to9/12,5/8to5/9:5/9to5/10:5/10to5/11:5/11to6/11:6/11to7/11:7/11to8/11:8/11to9/11:9/11to10/11:10/11to10/12:10/12to9/12:,10,True,True
2757,206,343,137,top4to4/15,8/9to9/9,top4to4/15:4/15to4/14:4/14to4/13:4/13to4/12:4/12to4/11:4/11to4/10:4/10to4/9:4/9to5/9:5/9to6/9:6/9to7/9:7/9to8/9:8/9to9/9:,12,True,True
2427,206,289,83,5/6to6/6,8/9to9/9,5/6to6/6:6/6to6/7:6/7to6/8:6/8to6/9:6/9to7/9:7/9to8/9:8/9to9/9:,7,False,True
2037,206,348,142,3/0to3/1,5/8to5/9,3/0to3/1:3/1to3/2:3/2to3/3:3/3to3/4:3/4to3/5:3/5to3/6:3/6to3/7:3/7to3/8:3/8to4/8:4/8to5/8:5/8to5/9:,11,True,True
2840,206,244,38,12/11to11/11,10/11to9/11,12/11to11/11:11/11to10/11:10/11to9/11:,3,True,True
2724,207,348,141,8/2to8/1,2/4to2/5,8/2to8/1:8/1to7/1:7/1to6/1:6/1to5/1:5/1to4/1:4/1to3/1:3/1to2/1:2/1to2/2:2/2to2/3:2/3to2/4:2/4to2/5:,11,False,True
3133,207,318,111,0/8to1/8,3/13to3/14,0/8to1/8:1/8to1/9:1/9to1/10:1/10to1/11:1/11to1/12:1/12to1/13:1/13to2/13:2/13to3/13:3/13to3/14:,9,False,True
64,207,581,374,left15to0/15,15/0tobottom15,left15to0/15:0/15to1/15:1/15to2/15:2/15to3/15:3/15to4/15:4/15to5/15:5/15to6/15:6/15to7/15:7/15to8/15:8/15to9/15:9/15to10/15:10/15to10/14:10/14to10/13:10/13to10/12:10/12to10/11:10/11to10/10:10/10to10/9:10/9to10/8:10/8to10/7:10/7to10/6:10/6to10/5:10/5to10/4:10/4to10/3:10/3to10/2:10/2to10/1:10/1to10/0:10/0to11/0:11/0to12/0:12/0to13/0:13/0to14/0:14/0to15/0:15/0tobottom15:,32,False,True
300,207,605,398,right0to15/0,0/15totop0,right0to15/0:15/0to14/0:14/0to13/0:13/0to12/0:12/0to11/0:11/0to11/1:11/1to10/1:10/1to9/1:9/1to8/1:8/1to7/1:7/1to6/1:6/1to5/1:5/1to4/1:4/1to3/1:3/1to2/1:2/1to1/1:1/1to0/1:0/1to0/2:0/2to0/3:0/3to0/4:0/4to0/5:0/5to0/6:0/6to0/7:0/7to0/8:0/8to0/9:0/9to0/10:0/10to0/11:0/11to0/12:0/12to0/13:0/13to0/14:0/14to0/15:0/15totop0:,32,True,True
2373,208,489,281,1/6to2/6,13/14to14/14,1/6to2/6:2/6to2/7:2/7to2/8:2/8to2/9:2/9to2/10:2/10to2/11:2/11to2/12:2/12to2/13:2/13to2/14:2/14to3/14:3/14to4/14:4/14to5/14:5/14to6/14:6/14to7/14:7/14to8/14:8/14to9/14:9/14to10/14:10/14to11/14:11/14to12/14:12/14to13/14:13/14to14/14:,21,True,True
1669,208,233,25,15/13to15/14,15/15toright15,15/13to15/14:15/14to15/15:15/15toright15:,3,False,True
88,209,599,390,left15to0/15,15/0tobottom15,left15to0/15:0/15to0/14:0/14to0/13:0/13to0/12:0/12to0/11:0/11to0/10:0/10to0/9:0/9to0/8:0/8to0/7:0/7to0/6:0/6to0/5:0/5to0/4:0/4to0/3:0/3to0/2:0/2to1/2:1/2to2/2:2/2to3/2:3/2to4/2:4/2to5/2:5/2to6/2:6/2to7/2:7/2to8/2:8/2to9/2:9/2to10/2:10/2to10/1:10/1to11/1:11/1to11/0:11/0to12/0:12/0to13/0:13/0to14/0:14/0to15/0:15/0tobottom15:,32,True,True
181,209,683,474,left0to0/0,15/15totop15,left0to0/0:0/0to0/1:0/1to0/2:0/2to0/3:0/3to0/4:0/4to0/5:0/5to0/6:0/6to0/7:0/7to0/8:0/8to0/9:0/9to0/10:0/10to0/11:0/11to0/12:0/12to0/13:0/13to0/14:0/14to1/14:1/14to2/14:2/14to3/14:3/14to4/14:4/14to5/14:5/14to6/14:6/14to7/14:7/14to8/14:8/14to9/14:9/14to10/14:10/14to10/15:10/15to11/15:11/15to12/15:12/15to13/15:13/15to14/15:14/15to15/15:15/15totop15:,32,True,True
2310,210,321,111,15/5to14/5,9/6to8/6,15/5to14/5:14/5to13/5:13/5to12/5:12/5to11/5:11/5to10/5:10/5to10/6:10/6to9/6:9/6to8/6:,8,False,True
3023,210,385,175,5/7to6/7,15/5toright5,5/7to6/7:6/7to6/6:6/6to6/5:6/5to7/5:7/5to8/5:8/5to9/5:9/5to10/5:10/5to11/5:11/5to12/5:12/5to13/5:13/5to14/5:14/5to15/5:15/5toright5:,13,True,True
3246,210,314,104,11/11to11/10,11/3to11/2,11/11to11/10:11/10to11/9:11/9to11/8:11/8to11/7:11/7to11/6:11/6to11/5:11/5to11/4:11/4to11/3:11/3to11/2:,9,False,True
1605,211,439,228,1/0to1/1,7/12to8/12,1/0to1/1:1/1to1/2:1/2to1/3:1/3to1/4:1/4to1/5:1/5to1/6:1/6to1/7:1/7to1/8:1/8to1/9:1/9to1/10:1/10to1/11:1/11to1/12:1/12to2/12:2/12to3/12:3/12to4/12:4/12to5/12:5/12to6/12:6/12to7/12:7/12to8/12:,19,False,True
2233,211,271,60,5/12to5/13,4/11to4/10,5/12to5/13:5/13to4/13:4/13to4/12:4/12to4/11:4/11to4/10:,5,True,True
1782,211,318,107,7/8to7/7,9/2to9/1,7/8to7/7:7/7to7/6:7/6to7/5:7/5to7/4:7/4to7/3:7/3to7/2:7/2to8/2:8/2to9/2:9/2to9/1:,9,True,True
794,211,336,125,5/4to4/4,0/2toleft2,5/4to4/4:4/4to3/4:3/4to2/4:2/4to1/4:1/4to0/4:0/4to0/3:0/3to0/2:0/2toleft2:,8,False,True
2689,212,445,233,right12to15/12,1/15totop1,right12to15/12:15/12to14/12:14/12to13/12:13/12to12/12:12/12to11/12:11/12to11/13:11/13to10/13:10/13to9/13:9/13to8/13:8/13to7/13:7/13to6/13:6/13to5/13:5/13to4/13:4/13to3/13:3/13to2/13:2/13to1/13:1/13to1/14:1/14to1/15:1/15totop1:,19,True,True
2744,212,439,227,5/15to6/15,12/4to12/3,5/15to6/15:6/15to7/15:7/15to8/15:8/15to9/15:9/15to10/15:10/15to10/14:10/14to10/13:10/13to10/12:10/12to10/11:10/11to10/10:10/10to10/9:10/9to10/8:10/8to10/7:10/7to10/6:10/6to10/5:10/5to10/4:10/4to11/4:11/4to12/4:12/4to12/3:,19,False,True
70,212,588,376,left15to0/15,15/0tobottom15,left15to0/15:0/15to1/15:1/15to2/15:2/15to3/15:3/15to4/15:4/15to5/15:5/15to6/15:6/15to7/15:7/15to8/15:8/15to9/15:9/15to10/15:10/15to10/14:10/14to10/13:10/13to10/12:10/12to10/11:10/11to10/10:10/10to10/9:10/9to10/8:10/8to10/7:10/7to10/6:10/6to10/5:10/5to10/4:10/4to10/3:10/3to10/2:10/2to10/1:10/1to10/0:10/0to11/0:11/0to12/0:12/0to13/0:13/0to14/0:14/0to15/0:15/0tobottom15:,32,False,True
2418,212,403,191,top1to1/15,3/2to3/1,top1to1/15:1/15to1/14:1/14to1/13:1/13to1/12:1/12to1/11:1/11to1/10:1/10to1/9:1/9to1/8:1/8to1/7:1/7to1/6:1/6to1/5:1/5to1/4:1/4to1/3:1/3to1/2:1/2to2/2:2/2to3/2:3/2to3/1:,17,False,True
1894,213,364,151,2/3to3/3,3/14to2/14,2/3to3/3:3/3to3/4:3/4to3/5:3/5to3/6:3/6to3/7:3/7to3/8:3/8to3/9:3/9to3/10:3/10to3/11:3/11to3/12:3/12to3/13:3/13to3/14:3/14to2/14:,13,True,True
164,214,606,392,left0to0/0,15/15totop15,left0to0/0:0/0to1/0:1/0to2/0:2/0to3/0:3/0to4/0:4/0to5/0:5/0to6/0:6/0to7/0:7/0to8/0:8/0to9/0:9/0to10/0:10/0to10/1:10/1to10/2:10/2to10/3:10/3to10/4:10/4to10/5:10/5to10/6:10/6to10/7:10/7to10/8:10/8to10/9:10/9to10/10:10/10to10/11:10/11to10/12:10/12to10/13:10/13to10/14:10/14to10/15:10/15to11/15:11/15to12/15:12/15to13/15:13/15to14/15:14/15to15/15:15/15totop15:,32,False,True
2393,215,299,84,9/10to8/10,8/5to9/5,9/10to8/10:8/10to8/9:8/9to8/8:8/8to8/7:8/7to8/6:8/6to8/5:8/5to9/5:,7,False,True
223,215,671,456,right15to15/15,0/0tobottom0,right15to15/15:15/15to14/15:14/15to13/15:13/15to12/15:12/15to11/15:11/15to11/14:11/14to10/14:10/14to9/14:9/14to8/14:8/14to7/14:7/14to6/14:6/14to5/14:5/14to4/14:4/14to3/14:3/14to2/14:2/14to1/14:1/14to0/14:0/14to0/13:0/13to0/12:0/12to0/11:0/11to0/10:0/10to0/9:0/9to0/8:0/8to0/7:0/7to0/6:0/6to0/5:0/5to0/4:0/4to0/3:0/3to0/2:0/2to0/1:0/1to0/0:0/0tobottom0:,32,True,True
1707,216,255,39,bottom11to11/0,12/1to13/1,bottom11to11/0:11/0to11/1:11/1to12/1:12/1to13/1:,4,True,True
2339,216,313,97,1/5to2/5,3/0to3/1,1/5to2/5:2/5to2/4:2/4to2/3:2/3to2/2:2/2to2/1:2/1to2/0:2/0to3/0:3/0to3/1:,8,False,True
1893,216,327,111,14/14to13/14,7/13to7/12,14/14to13/14:13/14to12/14:12/14to11/14:11/14to10/14:10/14to9/14:9/14to8/14:8/14to7/14:7/14to7/13:7/13to7/12:,9,True,True
269,217,603,386,right15to15/15,0/0tobottom0,right15to15/15:15/15to14/15:14/15to13/15:13/15to12/15:12/15to11/15:11/15to10/15:10/15to9/15:9/15to8/15:8/15to7/15:7/15to6/15:6/15to5/15:5/15to4/15:4/15to3/15:3/15to2/15:2/15to1/15:1/15to0/15:0/15to0/14:0/14to0/13:0/13to0/12:0/12to0/11:0/11to0/10:0/10to0/9:0/9to0/8:0/8to0/7:0/7to0/6:0/6to0/5:0/5to0/4:0/4to0/3:0/3to0/2:0/2to0/1:0/1to0/0:0/0tobottom0:,32,False,True
1371,218,342,124,0/6to0/5,3/1to3/0,0/6to0/5:0/5to0/4:0/4to0/3:0/3to0/2:0/2to0/1:0/1to1/1:1/1to2/1:2/1to3/1:3/1to3/0:,9,True,True
1186,218,321,103,14/3to14/4,14/11to14/12,14/3to14/4:14/4to14/5:14/5to14/6:14/6to14/7:14/7to14/8:14/8to14/9:14/9to14/10:14/10to14/11:14/11to14/12:,9,False,True
2168,218,268,50,12/13to12/14,14/14to14/15,12/13to12/14:12/14to13/14:13/14to14/14:14/14to14/15:,4,False,True
1374,218,530,312,2/8to2/9,15/13toright13,2/8to2/9:2/9to2/10:2/10to2/11:2/11to3/11:3/11to4/11:4/11to5/11:5/11to6/11:6/11to7/11:7/11to8/11:8/11to9/11:9/11to10/11:10/11to10/12:10/12to11/12:11/12to12/12:12/12to12/13:12/13to13/13:13/13to14/13:14/13to15/13:15/13toright13:,19,True,True
1260,219,335,116,6/2to6/1,0/2toleft2,6/2to6/1:6/1to5/1:5/1to4/1:4/1to3/1:3/1to2/1:2/1to1/1:1/1to0/1:0/1to0/2:0/2toleft2:,9,False,True
2517,219,362,143,11/12to11/11,5/8to5/7,11/12to11/11:11/11to10/11:10/11to9/11:9/11to8/11:8/11to7/11:7/11to6/11:6/11to5/11:5/11to5/10:5/10to5/9:5/9to5/8:5/8to5/7:,11,True,True
1086,219,443,224,6/13to6/12,11/0tobottom11,6/13to6/12:6/12to6/11:6/11to6/10:6/10to6/9:6/9to6/8:6/8to6/7:6/7to6/6:6/6to6/5:6/5to6/4:6/4to6/3:6/3to6/2:6/2to7/2:7/2to8/2:8/2to9/2:9/2to10/2:10/2to10/1:10/1to11/1:11/1to11/0:11/0tobottom11:,19,True,True
3195,219,395,176,5/10to6/10,13/6to13/7,5/10to6/10:6/10to6/9:6/9to6/8:6/8to6/7:6/7to6/6:6/6to7/6:7/6to8/6:8/6to9/6:9/6to10/6:10/6to11/6:11/6to12/6:12/6to13/6:13/6to13/7:,13,True,True
1331,220,399,179,13/12to12/12,8/6to9/6,13/12to12/12:12/12to11/12:11/12to11/11:11/11to10/11:10/11to9/11:9/11to8/11:8/11to8/10:8/10to8/9:8/9to8/8:8/8to8/7:8/7to8/6:8/6to9/6:,12,True,True
595,220,307,87,10/13to10/12,5/12to5/13,10/13to10/12:10/12to9/12:9/12to8/12:8/12to7/12:7/12to6/12:6/12to5/12:5/12to5/13:,7,False,True
1102,220,341,121,8/7to8/8,10/2to10/1,8/7to8/8:8/8to9/8:9/8to10/8:10/8to10/7:10/7to10/6:10/6to10/5:10/5to10/4:10/4to10/3:10/3to10/2:10/2to10/1:,10,False,True
2980,220,314,94,left4to0/4,2/0to3/0,left4to0/4:0/4to0/3:0/3to0/2:0/2to0/1:0/1to0/0:0/0to1/0:1/0to2/0:2/0to3/0:,8,True,True
92,220,616,396,left15to0/15,15/0tobottom15,left15to0/15:0/15to1/15:1/15to2/15:2/15to3/15:3/15to4/15:4/15to5/15:5/15to6/15:6/15to7/15:7/15to8/15:8/15to9/15:9/15to10/15:10/15to10/14:10/14to10/13:10/13to10/12:10/12to10/11:10/11to10/10:10/10to10/9:10/9to10/8:10/8to10/7:10/7to10/6:10/6to10/5:10/5to10/4:10/4to10/3:10/3to10/2:10/2to10/1:10/1to10/0:10/0to11/0:11/0to12/0:12/0to13/0:13/0to14/0:14/0to15/0:15/0tobottom15:,32,False,True
2954,220,528,308,15/10to14/10,0/7to0/6,15/10to14/10:14/10to13/10:13/10to12/10:12/10to11/10:11/10to10/10:10/10to9/10:9/10to8/10:8/10to7/10:7/10to6/10:6/10to5/10:5/10to4/10:4/10to3/10:3/10to2/10:2/10to1/10:1/10to0/10:0/10to0/9:0/9to0/8:0/8to0/7:0/7to0/6:,19,True,True
461,221,299,78,14/8to13/8,12/11to12/12,14/8to13/8:13/8to12/8:12/8to12/9:12/9to12/10:12/10to12/11:12/11to12/12:,6,False,True
467,222,399,177,bottom10to10/0,9/13to8/13,bottom10to10/0:10/0to9/0:9/0to9/1:9/1to9/2:9/2to9/3:9/3to9/4:9/4to9/5:9/5to9/6:9/6to9/7:9/7to9/8:9/8to9/9:9/9to9/10:9/10to9/11:9/11to9/12:9/12to9/13:9/13to8/13:,16,True,True
1724,222,329,107,14/14to14/13,8/12to8/11,14/14to14/13:14/13to13/13:13/13to12/13:12/13to11/13:11/13to10/13:10/13to9/13:9/13to8/13:8/13to8/12:8/12to8/11:,9,False,True
2973,223,364,141,10/10to9/10,1/10to1/11,10/10to9/10:9/10to8/10:8/10to7/10:7/10to6/10:6/10to5/10:5/10to4/10:4/10to3/10:3/10to2/10:2/10to1/10:1/10to1/11:,10,True,True
334,223,595,372,right0to15/0,0/15totop0,right0to15/0:15/0to14/0:14/0to13/0:13/0to12/0:12/0to11/0:11/0to10/0:10/0to9/0:9/0to8/0:8/0to7/0:7/0to6/0:6/0to5/0:5/0to4/0:4/0to3/0:3/0to2/0:2/0to1/0:1/0to0/0:0/0to0/1:0/1to0/2:0/2to0/3:0/3to0/4:0/4to0/5:0/5to0/6:0/6to0/7:0/7to0/8:0/8to0/9:0/9to0/10:0/10to0/11:0/11to0/12:0/12to0/13:0/13to0/14:0/14to0/15:0/15totop0:,32,False,True
1484,223,524,301,13/14to13/13,1/4to1/3,13/14to13/13:13/13to12/13:12/13to12/12:12/12to11/12:11/12to10/12:10/12to9/12:9/12to8/12:8/12to7/12:7/12to6/12:6/12to5/12:5/12to4/12:4/12to3/12:3/12to2/12:2/12to1/12:1/12to1/11:1/11to1/10:1/10to1/9:1/9to1/8:1/8to1/7:1/7to1/6:1/6to1/5:1/5to1/4:1/4to1/3:,23,True,True
2058,223,311,88,13/10to13/11,11/8to12/8,13/10to13/11:13/11to12/11:12/11to11/11:11/11to11/10:11/10to11/9:11/9to11/8:11/8to12/8:,7,False,True
1823,223,426,203,9/14to10/14,14/3to14/4,9/14to10/14:10/14to10/13:10/13to10/12:10/12to10/11:10/11to10/10:10/10to10/9:10/9to10/8:10/8to10/7:10/7to10/6:10/6to10/5:10/5to10/4:10/4to10/3:10/3to11/3:11/3to12/3:12/3to13/3:13/3to14/3:14/3to14/4:,17,False,True
1479,224,406,182,4/0to4/1,5/14to5/15,4/0to4/1:4/1to4/2:4/2to4/3:4/3to4/4:4/4to4/5:4/5to4/6:4/6to4/7:4/7to4/8:4/8to4/9:4/9to4/10:4/10to4/11:4/11to4/12:4/12to4/13:4/13to4/14:4/14to5/14:5/14to5/15:,16,False,True
3295,224,576,352,14/1to14/2,0/14toleft14,14/1to14/2:14/2to13/2:13/2to12/2:12/2to11/2:11/2to10/2:10/2to9/2:9/2to8/2:8/2to7/2:7/2to6/2:6/2to5/2:5/2to4/2:4/2to3/2:3/2to2/2:2/2to1/2:1/2to0/2:0/2to0/3:0/3to0/4:0/4to0/5:0/5to0/6:0/6to0/7:0/7to0/8:0/8to0/9:0/9to0/10:0/10to0/11:0/11to0/12:0/12to0/13:0/13to0/14:0/14toleft14:,28,True,True
1239,224,388,164,7/12to7/13,14/9to14/8,7/12to7/13:7/13to7/12:7/12to7/11:7/11to7/10:7/10to7/9:7/9to8/9:8/9to9/9:9/9to10/9:10/9to11/9:11/9to12/9:12/9to13/9:13/9to14/9:14/9to14/8:,13,True,True
3363,224,487,263,6/4to7/4,15/11toright11,6/4to7/4:7/4to7/5:7/5to7/6:7/6to7/7:7/7to7/8:7/8to7/9:7/9to7/10:7/10to7/11:7/11to8/11:8/11to9/11:9/11to10/11:10/11to11/11:11/11to12/11:12/11to13/11:13/11to14/11:14/11to15/11:15/11toright11:,17,True,True
1750,224,510,286,15/6to14/6,0/10toleft10,15/6to14/6:14/6to13/6:13/6to12/6:12/6to11/6:11/6to10/6:10/6to9/6:9/6to8/6:8/6to7/6:7/6to6/6:6/6to5/6:5/6to4/6:4/6to3/6:3/6to2/6:2/6to1/6:1/6to0/6:0/6to0/7:0/7to0/8:0/8to0/9:0/9to0/10:0/10toleft10:,20,False,True
2793,225,419,194,left11to0/11,2/1to3/1,left11to0/11:0/11to0/10:0/10to0/9:0/9to0/8:0/8to0/7:0/7to0/6:0/6to0/5:0/5to0/4:0/4to0/3:0/3to0/2:0/2to0/1:0/1to1/1:1/1to2/1:2/1to3/1:,14,False,True
2987,225,354,129,5/0to5/1,11/1to11/0,5/0to5/1:5/1to5/0:5/0to6/0:6/0to7/0:7/0to8/0:8/0to9/0:9/0to10/0:10/0to11/0:11/0to11/1:11/1to11/0:,10,True,True
2575,225,422,197,5/1to5/2,10/11to9/11,5/1to5/2:5/2to5/3:5/3to5/4:5/4to5/5:5/5to5/6:5/6to5/7:5/7to5/8:5/8to5/9:5/9to5/10:5/10to6/10:6/10to7/10:7/10to8/10:8/10to9/10:9/10to10/10:10/10to10/11:10/11to9/11:,16,True,True
753,226,468,242,3/12to3/11,15/13to15/12,3/12to3/11:3/11to3/12:3/12to3/13:3/13to4/13:4/13to5/13:5/13to6/13:6/13to7/13:7/13to8/13:8/13to9/13:9/13to10/13:10/13to11/13:11/13to12/13:12/13to13/13:13/13to14/13:14/13to15/13:15/13to15/12:,16,True,True
169,227,637,410,left0to0/0,15/15totop15,left0to0/0:0/0to1/0:1/0to2/0:2/0to3/0:3/0to4/0:4/0to5/0:5/0to6/0:6/0to7/0:7/0to8/0:8/0to9/0:9/0to10/0:10/0to10/1:10/1to10/2:10/2to10/3:10/3to10/4:10/4to10/5:10/5to10/6:10/6to10/7:10/7to10/8:10/8to10/9:10/9to10/10:10/10to10/11:10/11to10/12:10/12to10/13:10/13to10/14:10/14to10/15:10/15to11/15:11/15to12/15:12/15to13/15:13/15to14/15:14/15to15/15:15/15totop15:,32,False,True
3283,227,472,245,0/5to0/4,11/9to12/9,0/5to0/4:0/4to1/4:1/4to2/4:2/4to3/4:3/4to4/4:4/4to5/4:5/4to6/4:6/4to7/4:7/4to8/4:8/4to9/4:9/4to10/4:10/4to10/5:10/5to10/6:10/6to10/7:10/7to10/8:10/8to10/9:10/9to11/9:11/9to12/9:,18,False,True
1806,227,378,151,1/5to2/5,8/8to9/8,1/5to2/5:2/5to2/6:2/6to2/7:2/7to2/8:2/8to3/8:3/8to4/8:4/8to5/8:5/8to6/8:6/8to7/8:7/8to8/8:8/8to9/8:,11,True,True
1002,227,504,277,6/2to6/1,11/13to11/14,6/2to6/1:6/1to6/2:6/2to6/3:6/3to6/4:6/4to6/5:6/5to6/6:6/6to6/7:6/7to6/8:6/8to6/9:6/9to6/10:6/10to6/11:6/11to7/11:7/11to8/11:8/11to9/11:9/11to10/11:10/11to10/12:10/12to11/12:11/12to11/13:11/13to11/14:,19,True,True
489,227,428,201,12/5to11/5,1/3to0/3,12/5to11/5:11/5to10/5:10/5to9/5:9/5to8/5:8/5to7/5:7/5to6/5:6/5to5/5:5/5to4/5:4/5to3/5:3/5to2/5:2/5to1/5:1/5to1/4:1/4to1/3:1/3to0/3:,14,True,True
189,228,709,481,left0to0/0,15/15totop15,left0to0/0:0/0to0/1:0/1to0/2:0/2to0/3:0/3to0/4:0/4to0/5:0/5to0/6:0/6to0/7:0/7to0/8:0/8to0/9:0/9to0/10:0/10to0/11:0/11to0/12:0/12to0/13:0/13to1/13:1/13to2/13:2/13to3/13:3/13to4/13:4/13to5/13:5/13to6/13:6/13to7/13:7/13to8/13:8/13to9/13:9/13to10/13:10/13to10/14:10/14to11/14:11/14to11/15:11/15to12/15:12/15to13/15:13/15to14/15:14/15to15/15:15/15totop15:,32,True,True
840,228,287,59,2/9to1/9,3/10to3/9,2/9to1/9:1/9to1/10:1/10to2/10:2/10to3/10:3/10to3/9:,5,False,True
2041,229,451,222,6/5to6/4,13/11to13/12,6/5to6/4:6/4to7/4:7/4to8/4:8/4to9/4:9/4to10/4:10/4to10/5:10/5to10/6:10/6to10/7:10/7to10/8:10/8to10/9:10/9to10/10:10/10to10/11:10/11to11/11:11/11to12/11:12/11to13/11:13/11to13/12:,16,False,True
1538,229,342,113,11/5to11/4,13/0to13/1,11/5to11/4:11/4to11/3:11/3to11/2:11/2to11/1:11/1to11/0:11/0to12/0:12/0to13/0:13/0to13/1:,8,False,True
278,230,619,389,right15to15/15,0/0tobottom0,right15to15/15:15/15to14/15:14/15to13/15:13/15to12/15:12/15to11/15:11/15to10/15:10/15to9/15:9/15to8/15:8/15to7/15:7/15to6/15:6/15to5/15:5/15to4/15:4/15to3/15:3/15to2/15:2/15to1/15:1/15to0/15:0/15to0/14:0/14to0/13:0/13to0/12:0/12to0/11:0/11to0/10:0/10to0/9:0/9to0/8:0/8to0/7:0/7to0/6:0/6to0/5:0/5to0/4:0/4to0/3:0/3to0/2:0/2to0/1:0/1to0/0:0/0tobottom0:,32,False,True
145,230,716,486,left0to0/0,15/15totop15,left0to0/0:0/0to0/1:0/1to0/2:0/2to0/3:0/3to0/4:0/4to0/5:0/5to0/6:0/6to0/7:0/7to0/8:0/8to0/9:0/9to0/10:0/10to0/11:0/11to0/12:0/12to0/13:0/13to1/13:1/13to2/13:2/13to3/13:3/13to4/13:4/13to5/13:5/13to6/13:6/13to7/13:7/13to8/13:8/13to9/13:9/13to10/13:10/13to10/14:10/14to11/14:11/14to11/15:11/15to12/15:12/15to13/15:13/15to14/15:14/15to15/15:15/15totop15:,32,True,True
750,230,341,111,7/5to7/6,4/2to5/2,7/5to7/6:7/6to6/6:6/6to5/6:5/6to4/6:4/6to4/5:4/5to4/4:4/4to4/3:4/3to4/2:4/2to5/2:,9,True,True
368,231,608,377,right0to15/0,0/15totop0,right0to15/0:15/0to14/0:14/0to13/0:13/0to12/0:12/0to11/0:11/0to10/0:10/0to9/0:9/0to8/0:8/0to7/0:7/0to6/0:6/0to5/0:5/0to4/0:4/0to3/0:3/0to2/0:2/0to1/0:1/0to0/0:0/0to0/1:0/1to0/2:0/2to0/3:0/3to0/4:0/4to0/5:0/5to0/6:0/6to0/7:0/7to0/8:0/8to0/9:0/9to0/10:0/10to0/11:0/11to0/12:0/12to0/13:0/13to0/14:0/14to0/15:0/15totop0:,32,False,True
3270,231,391,160,right15to15/15,9/10to9/11,right15to15/15:15/15to14/15:14/15to13/15:13/15to12/15:12/15to11/15:11/15to10/15:10/15to10/14:10/14to10/13:10/13to10/12:10/12to10/11:10/11to10/10:10/10to9/10:9/10to9/11:,13,False,True
3026,231,523,292,15/11to14/11,1/9to1/8,15/11to14/11:14/11to13/11:13/11to12/11:12/11to11/11:11/11to10/11:10/11to9/11:9/11to8/11:8/11to7/11:7/11to6/11:6/11to5/11:5/11to4/11:4/11to3/11:3/11to2/11:2/11to1/11:1/11to1/10:1/10to1/9:1/9to1/8:,17,False,True
2837,231,397,166,10/13to9/13,1/10to0/10,10/13to9/13:9/13to8/13:8/13to7/13:7/13to6/13:6/13to5/13:5/13to4/13:4/13to3/13:3/13to2/13:2/13to1/13:1/13to1/12:1/12to1/11:1/11to1/10:1/10to0/10:,13,True,True
2435,231,509,278,15/10to15/9,2/15to3/15,15/10to15/9:15/9to14/9:14/9to13/9:13/9to12/9:12/9to11/9:11/9to10/9:10/9to9/9:9/9to8/9:8/9to7/9:7/9to6/9:6/9to5/9:5/9to4/9:4/9to3/9:3/9to2/9:2/9to2/10:2/10to2/11:2/11to2/12:2/12to2/13:2/13to2/14:2/14to2/15:2/15to3/15:,21,True,True
3301,231,362,131,4/15to4/14,6/7to7/7,4/15to4/14:4/14to4/13:4/13to4/12:4/12to4/11:4/11to4/10:4/10to4/9:4/9to4/8:4/8to4/7:4/7to5/7:5/7to6/7:6/7to7/7:,11,True,True
1084,231,346,115,12/11to11/11,7/8to8/8,12/11to11/11:11/11to10/11:10/11to9/11:9/11to8/11:8/11to7/11:7/11to7/10:7/10to7/9:7/9to7/8:7/8to8/8:,9,True,True
698,231,447,216,11/6to11/7,3/12to3/13,11/6to11/7:11/7to10/7:10/7to9/7:9/7to8/7:8/7to7/7:7/7to6/7:6/7to5/7:5/7to4/7:4/7to3/7:3/7to3/8:3/8to3/9:3/9to3/10:3/10to3/11:3/11to3/12:3/12to3/13:,15,False,True
3312,231,392,161,bottom11to11/0,14/9to15/9,bottom11to11/0:11/0to11/1:11/1to11/2:11/2to11/3:11/3to11/4:11/4to11/5:11/5to11/6:11/6to11/7:11/7to11/8:11/8to11/9:11/9to12/9:12/9to13/9:13/9to14/9:14/9to15/9:,14,False,True
2314,231,361,130,8/15to7/15,2/13to1/13,8/15to7/15:7/15to6/15:6/15to5/15:5/15to4/15:4/15to3/15:3/15to2/15:2/15to2/14:2/14to2/13:2/13to1/13:,9,True,True
266,232,633,401,right15to15/15,0/0tobottom0,right15to15/15:15/15to14/15:14/15to13/15:13/15to12/15:12/15to11/15:11/15to10/15:10/15to9/15:9/15to8/15:8/15to7/15:7/15to6/15:6/15to5/15:5/15to4/15:4/15to3/15:3/15to2/15:2/15to1/15:1/15to0/15:0/15to0/14:0/14to0/13:0/13to0/12:0/12to0/11:0/11to0/10:0/10to0/9:0/9to0/8:0/8to0/7:0/7to0/6:0/6to0/5:0/5to0/4:0/4to0/3:0/3to0/2:0/2to0/1:0/1to0/0:0/0tobottom0:,32,True,True
1134,232,637,405,15/2to14/2,0/15totop0,15/2to14/2:14/2to13/2:13/2to12/2:12/2to11/2:11/2to10/2:10/2to9/2:9/2to8/2:8/2to7/2:7/2to6/2:6/2to5/2:5/2to4/2:4/2to3/2:3/2to2/2:2/2to1/2:1/2to0/2:0/2to0/3:0/3to0/4:0/4to0/5:0/5to0/6:0/6to0/7:0/7to0/8:0/8to0/9:0/9to0/10:0/10to0/11:0/11to0/12:0/12to0/13:0/13to0/14:0/14to0/15:0/15totop0:,29,True,True
1117,232,503,271,13/1to12/1,4/13to5/13,13/1to12/1:12/1to11/1:11/1to10/1:10/1to9/1:9/1to8/1:8/1to7/1:7/1to6/1:6/1to5/1:5/1to4/1:4/1to4/2:4/2to4/3:4/3to4/4:4/4to4/5:4/5to4/6:4/6to4/7:4/7to4/8:4/8to4/9:4/9to4/10:4/10to4/11:4/11to4/12:4/12to4/13:4/13to5/13:,22,False,True
1141,232,321,89,15/12to15/11,12/10to13/10,15/12to15/11:15/11to14/11:14/11to13/11:13/11to12/11:12/11to12/10:12/10to13/10:,6,True,True
2824,232,308,76,2/5to1/5,0/2to0/1,2/5to1/5:1/5to0/5:0/5to0/4:0/4to0/3:0/3to0/2:0/2to0/1:,6,True,True
2212,232,338,106,3/0to4/0,5/6to5/7,3/0to4/0:4/0to4/1:4/1to4/2:4/2to4/3:4/3to4/4:4/4to4/5:4/5to4/6:4/6to5/6:5/6to5/7:,9,True,True
488,232,571,339,14/0to14/1,1/10to1/11,14/0to14/1:14/1to13/1:13/1to12/1:12/1to12/2:12/2to11/2:11/2to10/2:10/2to9/2:9/2to8/2:8/2to7/2:7/2to6/2:6/2to5/2:5/2to4/2:4/2to3/2:3/2to2/2:2/2to1/2:1/2to1/3:1/3to1/4:1/4to1/5:1/5to1/6:1/6to1/7:1/7to1/8:1/8to1/9:1/9to1/10:1/10to1/11:,24,True,True
2204,234,363,129,9/12to8/12,6/5to5/5,9/12to8/12:8/12to7/12:7/12to6/12:6/12to6/11:6/11to6/10:6/10to6/9:6/9to6/8:6/8to6/7:6/7to6/6:6/6to6/5:6/5to5/5:,11,True,True
1720,234,385,151,4/9to3/9,0/5to0/4,4/9to3/9:3/9to2/9:2/9to1/9:1/9to0/9:0/9to0/8:0/8to0/7:0/7to0/6:0/6to0/5:0/5to0/4:,9,True,True
2544,234,397,163,14/2to13/2,8/8to8/9,14/2to13/2:13/2to12/2:12/2to11/2:11/2to10/2:10/2to9/2:9/2to8/2:8/2to8/3:8/3to8/4:8/4to8/5:8/5to8/6:8/6to8/7:8/7to8/8:8/8to8/9:,13,True,True
2796,234,462,228,2/5to3/5,15/2to15/1,2/5to3/5:3/5to4/5:4/5to5/5:5/5to6/5:6/5to7/5:7/5to8/5:8/5to9/5:9/5to10/5:10/5to10/4:10/4to10/3:10/3to10/2:10/2to11/2:11/2to12/2:12/2to13/2:13/2to14/2:14/2to15/2:15/2to15/1:,17,False,True
46,234,622,388,left15to0/15,15/0tobottom15,left15to0/15:0/15to0/14:0/14to0/13:0/13to0/12:0/12to0/11:0/11to0/10:0/10to0/9:0/9to0/8:0/8to0/7:0/7to0/6:0/6to0/5:0/5to0/4:0/4to0/3:0/3to0/2:0/2to0/1:0/1to0/0:0/0to1/0:1/0to2/0:2/0to3/0:3/0to4/0:4/0to5/0:5/0to6/0:6/0to7/0:7/0to8/0:8/0to9/0:9/0to10/0:10/0to11/0:11/0to12/0:12/0to13/0:13/0to14/0:14/0to15/0:15/0tobottom15:,32,True,True
2192,235,396,161,8/9to9/9,14/12to15/12,8/9to9/9:9/9to9/10:9/10to9/11:9/11to10/11:10/11to10/12:10/12to11/12:11/12to12/12:12/12to13/12:13/12to14/12:14/12to15/12:,10,True,True
1070,235,681,446,left4to0/4,10/7to9/7,left4to0/4:0/4to0/5:0/5to1/5:1/5to2/5:2/5to3/5:3/5to4/5:4/5to5/5:5/5to6/5:6/5to7/5:7/5to8/5:8/5to9/5:9/5to10/5:10/5to10/6:10/6to10/7:10/7to9/7:,15,True,True
441,235,258,23,3/12to3/13,3/13to4/13,3/12to3/13:3/13to4/13:,2,True,True
2702,235,347,112,top0to0/15,4/11to5/11,top0to0/15:0/15to0/14:0/14to0/13:0/13to0/12:0/12to0/11:0/11to1/11:1/11to2/11:2/11to3/11:3/11to4/11:4/11to5/11:,10,False,True
267,235,636,401,right15to15/15,0/0tobottom0,right15to15/15:15/15to14/15:14/15to13/15:13/15to12/15:12/15to11/15:11/15to10/15:10/15to9/15:9/15to8/15:8/15to7/15:7/15to6/15:6/15to5/15:5/15to4/15:4/15to3/15:3/15to2/15:2/15to1/15:1/15to0/15:0/15to0/14:0/14to0/13:0/13to0/12:0/12to0/11:0/11to0/10:0/10to0/9:0/9to0/8:0/8to0/7:0/7to0/6:0/6to0/5:0/5to0/4:0/4to0/3:0/3to0/2:0/2to0/1:0/1to0/0:0/0tobottom0:,32,False,True
78,235,620,385,left15to0/15,15/0tobottom15,left15to0/15:0/15to1/15:1/15to2/15:2/15to3/15:3/15to4/15:4/15to5/15:5/15to6/15:6/15to7/15:7/15to8/15:8/15to9/15:9/15to10/15:10/15to10/14:10/14to10/13:10/13to10/12:10/12to10/11:10/11to10/10:10/10to10/9:10/9to10/8:10/8to10/7:10/7to10/6:10/6to10/5:10/5to10/4:10/4to10/3:10/3to10/2:10/2to10/1:10/1to10/0:10/0to11/0:11/0to12/0:12/0to13/0:13/0to14/0:14/0to15/0:15/0tobottom15:,32,False,True
33,235,624,389,left15to0/15,15/0tobottom15,left15to0/15:0/15to1/15:1/15to2/15:2/15to3/15:3/15to4/15:4/15to5/15:5/15to6/15:6/15to7/15:7/15to8/15:8/15to9/15:9/15to10/15:10/15to10/14:10/14to10/13:10/13to10/12:10/12to10/11:10/11to10/10:10/10to10/9:10/9to10/8:10/8to10/7:10/7to10/6:10/6to10/5:10/5to10/4:10/4to10/3:10/3to10/2:10/2to10/1:10/1to10/0:10/0to11/0:11/0to12/0:12/0to13/0:13/0to14/0:14/0to15/0:15/0tobottom15:,32,False,True
2211,236,388,152,3/12to3/11,1/2to2/2,3/12to3/11:3/11to2/11:2/11to1/11:1/11to1/10:1/10to1/9:1/9to1/8:1/8to1/7:1/7to1/6:1/6to1/5:1/5to1/4:1/4to1/3:1/3to1/2:1/2to2/2:,13,False,True
2964,237,531,294,2/15to2/14,14/6to14/7,2/15to2/14:2/14to2/13:2/13to2/12:2/12to2/11:2/11to2/10:2/10to2/9:2/9to2/8:2/8to2/7:2/7to2/6:2/6to3/6:3/6to4/6:4/6to5/6:5/6to6/6:6/6to7/6:7/6to8/6:8/6to9/6:9/6to10/6:10/6to11/6:11/6to12/6:12/6to13/6:13/6to14/6:14/6to14/7:,22,True,True
1451,237,529,292,1/8to1/7,15/0toright0,1/8to1/7:1/7to1/6:1/6to1/5:1/5to1/4:1/4to1/3:1/3to1/2:1/2to1/1:1/1to1/0:1/0to2/0:2/0to3/0:3/0to4/0:4/0to5/0:5/0to6/0:6/0to7/0:7/0to8/0:8/0to9/0:9/0to10/0:10/0to11/0:11/0to12/0:12/0to13/0:13/0to14/0:14/0to15/0:15/0toright0:,23,True,True
2046,237,323,86,10/2to10/3,15/3toright3,10/2to10/3:10/3to11/3:11/3to12/3:12/3to13/3:13/3to14/3:14/3to15/3:15/3toright3:,7,False,True
2610,238,461,223,10/12to9/12,1/5to0/5,10/12to9/12:9/12to8/12:8/12to7/12:7/12to6/12:6/12to5/12:5/12to4/12:4/12to3/12:3/12to2/12:2/12to1/12:1/12to1/11:1/11to1/10:1/10to1/9:1/9to1/8:1/8to1/7:1/7to1/6:1/6to1/5:1/5to0/5:,17,True,True
29,238,625,387,left15to0/15,15/0tobottom15,left15to0/15:0/15to1/15:1/15to2/15:2/15to3/15:3/15to4/15:4/15to5/15:5/15to6/15:6/15to7/15:7/15to8/15:8/15to9/15:9/15to10/15:10/15to10/14:10/14to10/13:10/13to10/12:10/12to10/11:10/11to10/10:10/10to10/9:10/9to10/8:10/8to10/7:10/7to10/6:10/6to10/5:10/5to10/4:10/4to10/3:10/3to10/2:10/2to10/1:10/1to10/0:10/0to11/0:11/0to12/0:12/0to13/0:13/0to14/0:14/0to15/0:15/0tobottom15:,32,False,True
1246,238,308,70,8/8to7/8,7/12to7/13,8/8to7/8:7/8to7/9:7/9to7/10:7/10to7/11:7/11to7/12:7/12to7/13:,6,False,True
2423,239,486,247,15/10to15/11,4/13to4/14,15/10to15/11:15/11to14/11:14/11to13/11:13/11to12/11:12/11to11/11:11/11to10/11:10/11to9/11:9/11to8/11:8/11to7/11:7/11to6/11:6/11to5/11:5/11to4/11:4/11to4/12:4/12to4/13:4/13to4/14:,15,True,True
2536,240,430,190,13/1to13/2,15/15totop15,13/1to13/2:13/2to13/3:13/3to13/4:13/4to13/5:13/5to13/6:13/6to13/7:13/7to13/8:13/8to13/9:13/9to13/10:13/10to13/11:13/11to13/12:13/12to13/13:13/13to13/14:13/14to13/15:13/15to14/15:14/15to15/15:15/15totop15:,17,True,True
2284,240,328,88,9/11to9/12,6/15totop6,9/11to9/12:9/12to8/12:8/12to7/12:7/12to6/12:6/12to6/13:6/13to6/14:6/14to6/15:6/15totop6:,8,False,True
2511,240,497,257,15/15to14/15,10/1to11/1,15/15to14/15:14/15to13/15:13/15to12/15:12/15to11/15:11/15to10/15:10/15to10/14:10/14to10/13:10/13to10/12:10/12to10/11:10/11to10/10:10/10to10/9:10/9to10/8:10/8to10/7:10/7to10/6:10/6to10/5:10/5to10/4:10/4to10/3:10/3to10/2:10/2to10/1:10/1to11/1:,20,False,True
2117,240,348,108,0/1to0/2,0/10toleft10,0/1to0/2:0/2to0/3:0/3to0/4:0/4to0/5:0/5to0/6:0/6to0/7:0/7to0/8:0/8to0/9:0/9to0/10:0/10toleft10:,10,False,True
2922,241,311,70,4/15to4/14,7/14to8/14,4/15to4/14:4/14to5/14:5/14to6/14:6/14to7/14:7/14to8/14:,5,True,True
3017,241,379,138,6/13to6/14,1/11to1/10,6/13to6/14:6/14to5/14:5/14to4/14:4/14to3/14:3/14to2/14:2/14to1/14:1/14to1/13:1/13to1/12:1/12to1/11:1/11to1/10:,10,False,True
2905,241,346,105,5/0to4/0,6/5to7/5,5/0to4/0:4/0to4/1:4/1to4/2:4/2to4/3:4/3to4/4:4/4to4/5:4/5to5/5:5/5to6/5:6/5to7/5:,9,True,True
247,241,658,417,right15to15/15,0/0tobottom0,right15to15/15:15/15to14/15:14/15to13/15:13/15to12/15:12/15to11/15:11/15to10/15:10/15to9/15:9/15to8/15:8/15to7/15:7/15to6/15:6/15to5/15:5/15to4/15:4/15to3/15:3/15to2/15:2/15to1/15:1/15to0/15:0/15to0/14:0/14to0/13:0/13to0/12:0/12to0/11:0/11to0/10:0/10to0/9:0/9to0/8:0/8to0/7:0/7to0/6:0/6to0/5:0/5to0/4:0/4to0/3:0/3to0/2:0/2to0/1:0/1to0/0:0/0tobottom0:,32,False,True
2033,242,315,73,4/13to4/12,0/12toleft12,4/13to4/12:4/12to3/12:3/12to2/12:2/12to1/12:1/12to0/12:0/12toleft12:,6,False,True
199,242,740,498,left0to0/0,15/15totop15,left0to0/0:0/0to0/1:0/1to0/2:0/2to0/3:0/3to0/4:0/4to0/5:0/5to0/6:0/6to0/7:0/7to0/8:0/8to0/9:0/9to0/10:0/10to0/11:0/11to0/12:0/12to0/13:0/13to0/14:0/14to1/14:1/14to2/14:2/14to3/14:3/14to4/14:4/14to5/14:5/14to6/14:6/14to7/14:7/14to8/14:8/14to9/14:9/14to10/14:10/14to10/15:10/15to11/15:11/15to12/15:12/15to13/15:13/15to14/15:14/15to15/15:15/15totop15:,32,True,True
3105,242,469,227,7/0to8/0,15/10to15/11,7/0to8/0:8/0to8/1:8/1to8/2:8/2to8/3:8/3to8/4:8/4to8/5:8/5to8/6:8/6to8/7:8/7to8/8:8/8to9/8:9/8to10/8:10/8to10/9:10/9to11/9:11/9to12/9:12/9to12/10:12/10to13/10:13/10to14/10:14/10to15/10:15/10to15/11:,19,True,True
3286,242,468,226,11/13to10/13,3/4to4/4,11/13to10/13:10/13to9/13:9/13to8/13:8/13to7/13:7/13to6/13:6/13to5/13:5/13to4/13:4/13to3/13:3/13to3/12:3/12to3/11:3/11to3/10:3/10to3/9:3/9to3/8:3/8to3/7:3/7to3/6:3/6to3/5:3/5to3/4:3/4to4/4:,18,False,True
1269,243,479,236,5/3to5/4,11/12to12/12,5/3to5/4:5/4to5/5:5/5to5/6:5/6to5/7:5/7to5/8:5/8to5/9:5/9to5/10:5/10to5/11:5/11to6/11:6/11to7/11:7/11to8/11:8/11to9/11:9/11to10/11:10/11to10/12:10/12to11/12:11/12to12/12:,16,True,True
1266,243,328,85,left6to0/6,2/9to3/9,left6to0/6:0/6to0/7:0/7to0/8:0/8to0/9:0/9to1/9:1/9to2/9:2/9to3/9:,7,False,True
1032,243,369,126,12/12to11/12,5/10to5/9,12/12to11/12:11/12to10/12:10/12to9/12:9/12to8/12:8/12to7/12:7/12to6/12:6/12to5/12:5/12to5/11:5/11to5/10:5/10to5/9:,10,False,True
2356,243,392,149,8/3to9/3,12/10to13/10,8/3to9/3:9/3to9/4:9/4to9/5:9/5to9/6:9/6to9/7:9/7to9/8:9/8to10/8:10/8to10/9:10/9to11/9:11/9to12/9:12/9to12/10:12/10to13/10:,12,True,True
283,244,707,463,right15to15/15,0/0tobottom0,right15to15/15:15/15to14/15:14/15to13/15:13/15to12/15:12/15to11/15:11/15to11/14:11/14to10/14:10/14to9/14:9/14to8/14:8/14to7/14:7/14to6/14:6/14to5/14:5/14to4/14:4/14to3/14:3/14to2/14:2/14to1/14:1/14to0/14:0/14to0/13:0/13to0/12:0/12to0/11:0/11to0/10:0/10to0/9:0/9to0/8:0/8to0/7:0/7to0/6:0/6to0/5:0/5to0/4:0/4to0/3:0/3to0/2:0/2to0/1:0/1to0/0:0/0tobottom0:,32,True,True
2107,244,274,30,bottom11to11/0,10/0to9/0,bottom11to11/0:11/0to10/0:10/0to9/0:,3,False,True
371,244,617,373,right0to15/0,0/15totop0,right0to15/0:15/0to14/0:14/0to13/0:13/0to12/0:12/0to11/0:11/0to10/0:10/0to9/0:9/0to8/0:8/0to7/0:7/0to6/0:6/0to5/0:5/0to4/0:4/0to3/0:3/0to2/0:2/0to1/0:1/0to0/0:0/0to0/1:0/1to0/2:0/2to0/3:0/3to0/4:0/4to0/5:0/5to0/6:0/6to0/7:0/7to0/8:0/8to0/9:0/9to0/10:0/10to0/11:0/11to0/12:0/12to0/13:0/13to0/14:0/14to0/15:0/15totop0:,32,False,True
198,244,725,481,left0to0/0,15/15totop15,left0to0/0:0/0to0/1:0/1to0/2:0/2to0/3:0/3to0/4:0/4to0/5:0/5to0/6:0/6to0/7:0/7to0/8:0/8to0/9:0/9to0/10:0/10to0/11:0/11to0/12:0/12to0/13:0/13to1/13:1/13to2/13:2/13to3/13:3/13to4/13:4/13to5/13:5/13to6/13:6/13to7/13:7/13to8/13:8/13to9/13:9/13to10/13:10/13to10/14:10/14to11/14:11/14to11/15:11/15to12/15:12/15to13/15:13/15to14/15:14/15to15/15:15/15totop15:,32,True,True
2759,244,545,301,14/6to13/6,3/11to2/11,14/6to13/6:13/6to12/6:12/6to11/6:11/6to11/7:11/7to10/7:10/7to9/7:9/7to8/7:8/7to7/7:7/7to6/7:6/7to5/7:5/7to4/7:4/7to3/7:3/7to3/8:3/8to3/9:3/9to3/10:3/10to3/11:3/11to2/11:,17,True,True
2298,244,398,154,15/1to14/1,13/11to13/12,15/1to14/1:14/1to13/1:13/1to13/2:13/2to13/3:13/3to13/4:13/4to13/5:13/5to13/6:13/6to13/7:13/7to13/8:13/8to13/9:13/9to13/10:13/10to13/11:13/11to13/12:,13,True,True
841,244,324,80,5/10to5/9,5/4to5/3,5/10to5/9:5/9to5/8:5/8to5/7:5/7to5/6:5/6to5/5:5/5to5/4:5/4to5/3:,7,True,True
2523,245,309,64,10/6to11/6,12/7to13/7,10/6to11/6:11/6to12/6:12/6to12/7:12/7to13/7:,4,True,True
1419,245,556,311,13/11to12/11,1/6to1/5,13/11to12/11:12/11to11/11:11/11to10/11:10/11to9/11:9/11to8/11:8/11to7/11:7/11to6/11:6/11to5/11:5/11to4/11:4/11to3/11:3/11to2/11:2/11to1/11:1/11to1/10:1/10to1/9:1/9to1/8:1/8to1/7:1/7to1/6:1/6to1/5:,18,True,True
482,245,311,66,14/3to14/2,12/1to13/1,14/3to14/2:14/2to13/2:13/2to12/2:12/2to12/1:12/1to13/1:,5,True,True
1695,245,443,198,7/4to7/5,15/7toright7,7/4to7/5:7/5to8/5:8/5to9/5:9/5to10/5:10/5to10/6:10/6to10/7:10/7to11/7:11/7to12/7:12/7to13/7:13/7to14/7:14/7to15/7:15/7toright7:,12,False,True
1250,245,416,171,3/8to4/8,15/7toright7,3/8to4/8:4/8to5/8:5/8to6/8:6/8to7/8:7/8to8/8:8/8to9/8:9/8to10/8:10/8to10/7:10/7to11/7:11/7to12/7:12/7to13/7:13/7to14/7:14/7to15/7:15/7toright7:,14,False,True
3071,245,303,58,5/10to4/10,4/7to3/7,5/10to4/10:4/10to4/9:4/9to4/8:4/8to4/7:4/7to3/7:,5,False,True
2680,246,271,25,11/14to10/14,10/14to10/15,11/14to10/14:10/14to10/15:,2,False,True
2561,247,371,124,2/4to2/3,7/0to7/1,2/4to2/3:2/3to2/2:2/2to2/1:2/1to2/0:2/0to3/0:3/0to4/0:4/0to5/0:5/0to6/0:6/0to7/0:7/0to7/1:,10,False,True
2367,247,561,314,top14to14/15,0/6toleft6,top14to14/15:14/15to13/15:13/15to12/15:12/15to11/15:11/15to10/15:10/15to9/15:9/15to8/15:8/15to7/15:7/15to6/15:6/15to5/15:5/15to4/15:4/15to3/15:3/15to2/15:2/15to1/15:1/15to0/15:0/15to0/14:0/14to0/13:0/13to0/12:0/12to0/11:0/11to0/10:0/10to0/9:0/9to0/8:0/8to0/7:0/7to0/6:0/6toleft6:,25,True,True
452,247,466,219,1/12to2/12,9/3to9/4,1/12to2/12:2/12to2/11:2/11to2/10:2/10to2/9:2/9to2/8:2/8to2/7:2/7to2/6:2/6to2/5:2/5to2/4:2/4to2/3:2/3to3/3:3/3to4/3:4/3to5/3:5/3to6/3:6/3to7/3:7/3to8/3:8/3to9/3:9/3to9/4:,18,False,True
2883,247,297,50,2/14to1/14,1/12to2/12,2/14to1/14:1/14to1/13:1/13to1/12:1/12to2/12:,4,True,True
429,247,366,119,9/4to10/4,14/0to14/1,9/4to10/4:10/4to10/3:10/3to10/2:10/2to11/2:11/2to12/2:12/2to12/1:12/1to12/0:12/0to13/0:13/0to14/0:14/0to14/1:,10,True,True
2904,247,293,46,6/9to6/10,7/11to7/12,6/9to6/10:6/10to6/11:6/11to7/11:7/11to7/12:,4,False,True
894,248,531,283,1/14to1/15,10/3to11/3,1/14to1/15:1/15to2/15:2/15to3/15:3/15to4/15:4/15to5/15:5/15to6/15:6/15to7/15:7/15to8/15:8/15to9/15:9/15to10/15:10/15to10/14:10/14to10/13:10/13to10/12:10/12to10/11:10/11to10/10:10/10to10/9:10/9to10/8:10/8to10/7:10/7to10/6:10/6to10/5:10/5to10/4:10/4to10/3:10/3to11/3:,23,False,True
3257,248,468,220,12/1to12/2,5/11to6/11,12/1to12/2:12/2to11/2:11/2to10/2:10/2to9/2:9/2to8/2:8/2to7/2:7/2to6/2:6/2to5/2:5/2to5/3:5/3to5/4:5/4to5/5:5/5to5/6:5/6to5/7:5/7to5/8:5/8to5/9:5/9to5/10:5/10to5/11:5/11to6/11:,18,False,True
410,249,288,39,6/6to7/6,8/6to9/6,6/6to7/6:7/6to8/6:8/6to9/6:,3,False,True
588,250,308,58,15/7to14/7,12/6to11/6,15/7to14/7:14/7to13/7:13/7to12/7:12/7to12/6:12/6to11/6:,5,True,True
252,250,673,423,right15to15/15,0/0tobottom0,right15to15/15:15/15to14/15:14/15to13/15:13/15to12/15:12/15to11/15:11/15to10/15:10/15to9/15:9/15to8/15:8/15to7/15:7/15to6/15:6/15to5/15:5/15to4/15:4/15to3/15:3/15to2/15:2/15to1/15:1/15to0/15:0/15to0/14:0/14to0/13:0/13to0/12:0/12to0/11:0/11to0/10:0/10to0/9:0/9to0/8:0/8to0/7:0/7to0/6:0/6to0/5:0/5to0/4:0/4to0/3:0/3to0/2:0/2to0/1:0/1to0/0:0/0tobottom0:,32,False,True
234,250,677,427,right15to15/15,0/0tobottom0,right15to15/15:15/15to14/15:14/15to13/15:13/15to12/15:12/15to11/15:11/15to10/15:10/15to9/15:9/15to8/15:8/15to7/15:7/15to6/15:6/15to5/15:5/15to4/15:4/15to3/15:3/15to2/15:2/15to1/15:1/15to0/15:0/15to0/14:0/14to0/13:0/13to0/12:0/12to0/11:0/11to0/10:0/10to0/9:0/9to0/8:0/8to0/7:0/7to0/6:0/6to0/5:0/5to0/4:0/4to0/3:0/3to0/2:0/2to0/1:0/1to0/0:0/0tobottom0:,32,True,True
3277,251,479,228,bottom8to8/0,11/15to12/15,bottom8to8/0:8/0to8/1:8/1to8/2:8/2to8/3:8/3to8/4:8/4to8/5:8/5to8/6:8/6to8/7:8/7to8/8:8/8to8/9:8/9to8/10:8/10to8/11:8/11to8/12:8/12to8/13:8/13to8/14:8/14to9/14:9/14to10/14:10/14to10/15:10/15to11/15:11/15to12/15:,20,True,True
1801,251,419,168,2/3to3/3,11/7to11/6,2/3to3/3:3/3to3/4:3/4to3/5:3/5to3/6:3/6to3/7:3/7to4/7:4/7to5/7:5/7to6/7:6/7to7/7:7/7to8/7:8/7to9/7:9/7to10/7:10/7to11/7:11/7to11/6:,14,True,True
3251,251,583,332,2/1to3/1,15/15totop15,2/1to3/1:3/1to4/1:4/1to5/1:5/1to6/1:6/1to7/1:7/1to8/1:8/1to9/1:9/1to10/1:10/1to10/2:10/2to10/3:10/3to10/4:10/4to10/5:10/5to10/6:10/6to10/7:10/7to10/8:10/8to10/9:10/9to10/10:10/10to10/11:10/11to10/12:10/12to10/13:10/13to10/14:10/14to10/15:10/15to11/15:11/15to12/15:12/15to13/15:13/15to14/15:14/15to15/15:15/15totop15:,28,False,True
669,251,529,278,bottom7to7/0,14/15to15/15,bottom7to7/0:7/0to7/1:7/1to7/2:7/2to7/3:7/3to7/4:7/4to7/5:7/5to7/6:7/6to7/7:7/7to7/8:7/8to7/9:7/9to7/10:7/10to7/11:7/11to7/12:7/12to7/13:7/13to8/13:8/13to9/13:9/13to10/13:10/13to10/14:10/14to11/14:11/14to11/15:11/15to12/15:12/15to13/15:13/15to14/15:14/15to15/15:,24,True,True
2734,252,373,121,bottom14to14/0,11/6to10/6,bottom14to14/0:14/0to13/0:13/0to12/0:12/0to11/0:11/0to11/1:11/1to11/2:11/2to11/3:11/3to11/4:11/4to11/5:11/5to11/6:11/6to10/6:,11,False,True
1797,252,338,86,0/5to0/4,4/4to5/4,0/5to0/4:0/4to1/4:1/4to2/4:2/4to3/4:3/4to4/4:4/4to5/4:,6,False,True
2709,252,324,72,5/1to5/2,6/5to6/4,5/1to5/2:5/2to5/3:5/3to5/4:5/4to5/5:5/5to6/5:6/5to6/4:,6,False,True
1132,253,448,195,15/9to14/9,5/5to5/4,15/9to14/9:14/9to13/9:13/9to12/9:12/9to11/9:11/9to11/8:11/8to10/8:10/8to9/8:9/8to8/8:8/8to7/8:7/8to6/8:6/8to5/8:5/8to5/7:5/7to5/6:5/6to5/5:5/5to5/4:,15,True,True
2730,253,445,192,9/0to9/1,4/10to4/11,9/0to9/1:9/1to8/1:8/1to7/1:7/1to6/1:6/1to5/1:5/1to4/1:4/1to4/2:4/2to4/3:4/3to4/4:4/4to4/5:4/5to4/6:4/6to4/7:4/7to4/8:4/8to4/9:4/9to4/10:4/10to4/11:,16,True,True
1719,254,354,100,7/8to6/8,1/9to1/10,7/8to6/8:6/8to5/8:5/8to4/8:4/8to3/8:3/8to2/8:2/8to1/8:1/8to1/9:1/9to1/10:,8,True,True
2950,254,369,115,right12to15/12,10/15totop10,right12to15/12:15/12to14/12:14/12to13/12:13/12to12/12:12/12to11/12:11/12to11/13:11/13to10/13:10/13to10/14:10/14to10/15:10/15totop10:,10,True,True
1549,254,470,216,12/14to11/14,5/4to4/4,12/14to11/14:11/14to10/14:10/14to9/14:9/14to8/14:8/14to7/14:7/14to6/14:6/14to5/14:5/14to5/13:5/13to5/12:5/12to5/11:5/11to5/10:5/10to5/9:5/9to5/8:5/8to5/7:5/7to5/6:5/6to5/5:5/5to5/4:5/4to4/4:,18,False,True
129,254,765,511,left0to0/0,15/15totop15,left0to0/0:0/0to0/1:0/1to0/2:0/2to0/3:0/3to0/4:0/4to0/5:0/5to0/6:0/6to0/7:0/7to0/8:0/8to0/9:0/9to0/10:0/10to0/11:0/11to0/12:0/12to0/13:0/13to0/14:0/14to1/14:1/14to2/14:2/14to3/14:3/14to4/14:4/14to5/14:5/14to6/14:6/14to7/14:7/14to8/14:8/14to9/14:9/14to10/14:10/14to10/15:10/15to11/15:11/15to12/15:12/15to13/15:13/15to14/15:14/15to15/15:15/15totop15:,32,True,True
213,254,686,432,right15to15/15,0/0tobottom0,right15to15/15:15/15to14/15:14/15to13/15:13/15to12/15:12/15to11/15:11/15to10/15:10/15to9/15:9/15to8/15:8/15to7/15:7/15to6/15:6/15to5/15:5/15to4/15:4/15to3/15:3/15to2/15:2/15to1/15:1/15to0/15:0/15to0/14:0/14to0/13:0/13to0/12:0/12to0/11:0/11to0/10:0/10to0/9:0/9to0/8:0/8to0/7:0/7to0/6:0/6to0/5:0/5to0/4:0/4to0/3:0/3to0/2:0/2to0/1:0/1to0/0:0/0tobottom0:,32,False,True
2601,254,456,202,top12to12/15,14/1to14/2,top12to12/15:12/15to12/14:12/14to12/13:12/13to12/12:12/12to12/11:12/11to12/10:12/10to12/9:12/9to12/8:12/8to12/7:12/7to12/6:12/6to12/5:12/5to12/4:12/4to12/3:12/3to12/2:12/2to12/1:12/1to13/1:13/1to14/1:14/1to14/2:,18,True,True
1072,254,433,179,top2to2/15,4/3to4/2,top2to2/15:2/15to2/14:2/14to2/13:2/13to2/12:2/12to2/11:2/11to2/10:2/10to2/9:2/9to2/8:2/8to2/7:2/7to2/6:2/6to2/5:2/5to2/4:2/4to2/3:2/3to3/3:3/3to4/3:4/3to4/2:,16,False,True
1340,254,288,34,7/10to7/11,6/11to6/12,7/10to7/11:7/11to6/11:6/11to6/12:,3,True,True
1892,255,533,278,0/10to0/11,12/6to13/6,0/10to0/11:0/11to0/10:0/10to0/9:0/9to0/8:0/8to1/8:1/8to2/8:2/8to3/8:3/8to4/8:4/8to5/8:5/8to6/8:6/8to7/8:7/8to8/8:8/8to9/8:9/8to10/8:10/8to10/7:10/7to11/7:11/7to11/6:11/6to12/6:12/6to13/6:,19,True,True
982,255,515,260,15/9to15/8,1/3to1/2,15/9to15/8:15/8to14/8:14/8to13/8:13/8to12/8:12/8to11/8:11/8to10/8:10/8to9/8:9/8to8/8:8/8to7/8:7/8to6/8:6/8to5/8:5/8to4/8:4/8to3/8:3/8to2/8:2/8to1/8:1/8to1/7:1/7to1/6:1/6to1/5:1/5to1/4:1/4to1/3:1/3to1/2:,21,True,True
432,255,512,257,14/13to14/12,1/13to0/13,14/13to14/12:14/12to13/12:13/12to12/12:12/12to11/12:11/12to10/12:10/12to9/12:9/12to8/12:8/12to7/12:7/12to6/12:6/12to5/12:5/12to4/12:4/12to3/12:3/12to2/12:2/12to1/12:1/12to1/13:1/13to0/13:,16,False,True
486,256,281,25,2/12to1/12,1/12to1/13,2/12to1/12:1/12to1/13:,2,False,True
2090,256,488,232,15/2to14/2,6/8to6/9,15/2to14/2:14/2to13/2:13/2to12/2:12/2to11/2:11/2to10/2:10/2to9/2:9/2to8/2:8/2to7/2:7/2to6/2:6/2to6/3:6/3to6/4:6/4to6/5:6/5to6/6:6/6to6/7:6/7to6/8:6/8to6/9:,16,False,True
2144,256,508,252,top8to8/15,0/3toleft3,top8to8/15:8/15to7/15:7/15to6/15:6/15to5/15:5/15to4/15:4/15to3/15:3/15to2/15:2/15to1/15:1/15to0/15:0/15to0/14:0/14to0/13:0/13to0/12:0/12to0/11:0/11to0/10:0/10to0/9:0/9to0/8:0/8to0/7:0/7to0/6:0/6to0/5:0/5to0/4:0/4to0/3:0/3toleft3:,22,True,True
1520,257,371,114,9/13to9/12,9/4to9/3,9/13to9/12:9/12to9/11:9/11to9/10:9/10to9/9:9/9to9/8:9/8to9/7:9/7to9/6:9/6to9/5:9/5to9/4:9/4to9/3:,10,False,True
2351,257,389,132,9/6to10/6,10/10to11/10,9/6to10/6:10/6to10/7:10/7to10/8:10/8to11/8:11/8to11/9:11/9to11/10:11/10to10/10:10/10to11/10:,8,True,True
689,257,566,309,14/1to13/1,4/15to3/15,14/1to13/1:13/1to12/1:12/1to11/1:11/1to10/1:10/1to9/1:9/1to8/1:8/1to7/1:7/1to6/1:6/1to5/1:5/1to4/1:4/1to4/2:4/2to4/3:4/3to4/4:4/4to4/5:4/5to4/6:4/6to4/7:4/7to4/8:4/8to4/9:4/9to4/10:4/10to4/11:4/11to4/12:4/12to4/13:4/13to4/14:4/14to4/15:4/15to3/15:,25,False,True
1568,258,351,93,right14to15/14,13/10to13/9,right14to15/14:15/14to14/14:14/14to13/14:13/14to13/13:13/13to13/12:13/12to13/11:13/11to13/10:13/10to13/9:,8,True,True
2408,258,432,174,bottom4to4/0,7/10to8/10,bottom4to4/0:4/0to4/1:4/1to4/2:4/2to4/3:4/3to4/4:4/4to4/5:4/5to4/6:4/6to4/7:4/7to4/8:4/8to4/9:4/9to4/10:4/10to5/10:5/10to6/10:6/10to7/10:7/10to8/10:,15,True,True
743,258,504,246,15/12to15/13,5/6to6/6,15/12to15/13:15/13to14/13:14/13to13/13:13/13to12/13:12/13to11/13:11/13to10/13:10/13to9/13:9/13to8/13:8/13to7/13:7/13to6/13:6/13to5/13:5/13to5/12:5/12to5/11:5/11to5/10:5/10to5/9:5/9to5/8:5/8to5/7:5/7to5/6:5/6to6/6:,19,False,True
319,258,633,375,right0to15/0,0/15totop0,right0to15/0:15/0to14/0:14/0to13/0:13/0to12/0:12/0to11/0:11/0to10/0:10/0to9/0:9/0to8/0:8/0to7/0:7/0to6/0:6/0to5/0:5/0to4/0:4/0to3/0:3/0to2/0:2/0to1/0:1/0to0/0:0/0to0/1:0/1to0/2:0/2to0/3:0/3to0/4:0/4to0/5:0/5to0/6:0/6to0/7:0/7to0/8:0/8to0/9:0/9to0/10:0/10to0/11:0/11to0/12:0/12to0/13:0/13to0/14:0/14to0/15:0/15totop0:,32,False,True
2792,259,306,47,0/12to1/12,2/11to3/11,0/12to1/12:1/12to1/11:1/11to2/11:2/11to3/11:,4,True,True
648,259,377,118,10/8to10/9,12/14to12/15,10/8to10/9:10/9to10/10:10/10to10/11:10/11to10/12:10/12to10/13:10/13to10/14:10/14to11/14:11/14to12/14:12/14to12/15:,9,False,True
726,259,355,96,7/9to7/8,5/4to5/3,7/9to7/8:7/8to6/8:6/8to5/8:5/8to5/7:5/7to5/6:5/6to5/5:5/5to5/4:5/4to5/3:,8,False,True
3224,260,424,164,5/0to4/0,7/9to8/9,5/0to4/0:4/0to4/1:4/1to4/2:4/2to4/3:4/3to4/4:4/4to4/5:4/5to4/6:4/6to4/7:4/7to4/8:4/8to4/9:4/9to5/9:5/9to6/9:6/9to7/9:7/9to8/9:,14,False,True
1523,260,424,164,11/8to10/8,5/14to5/15,11/8to10/8:10/8to9/8:9/8to8/8:8/8to7/8:7/8to6/8:6/8to5/8:5/8to5/9:5/9to5/10:5/10to5/11:5/11to5/12:5/12to5/13:5/13to5/14:5/14to5/15:,13,False,True
972,261,472,211,4/8to4/9,15/4toright4,4/8to4/9:4/9to4/8:4/8to4/7:4/7to4/6:4/6to5/6:5/6to6/6:6/6to7/6:7/6to8/6:8/6to9/6:9/6to10/6:10/6to10/5:10/5to11/5:11/5to12/5:12/5to12/4:12/4to13/4:13/4to14/4:14/4to15/4:15/4toright4:,18,True,True
3050,261,479,218,5/11to6/11,14/5to14/6,5/11to6/11:6/11to7/11:7/11to8/11:8/11to9/11:9/11to10/11:10/11to10/10:10/10to10/9:10/9to10/8:10/8to10/7:10/7to10/6:10/6to10/5:10/5to11/5:11/5to12/5:12/5to13/5:13/5to14/5:14/5to14/6:,16,False,True
1882,261,521,260,0/12to1/12,10/3to10/2,0/12to1/12:1/12to1/11:1/11to1/10:1/10to1/9:1/9to1/8:1/8to1/7:1/7to1/6:1/6to1/5:1/5to1/4:1/4to1/3:1/3to2/3:2/3to3/3:3/3to4/3:4/3to5/3:5/3to6/3:6/3to7/3:7/3to8/3:8/3to9/3:9/3to10/3:10/3to10/2:,20,True,True
3349,261,461,200,12/12to12/13,7/5to7/4,12/12to12/13:12/13to11/13:11/13to10/13:10/13to9/13:9/13to8/13:8/13to7/13:7/13to7/12:7/12to7/11:7/11to7/10:7/10to7/9:7/9to7/8:7/8to7/7:7/7to7/6:7/6to7/5:7/5to7/4:,15,False,True
993,262,513,251,bottom0to0/0,14/5to15/5,bottom0to0/0:0/0to0/1:0/1to0/2:0/2to0/3:0/3to0/4:0/4to1/4:1/4to2/4:2/4to3/4:3/4to4/4:4/4to5/4:5/4to6/4:6/4to7/4:7/4to8/4:8/4to9/4:9/4to10/4:10/4to10/5:10/5to11/5:11/5to12/5:12/5to13/5:13/5to14/5:14/5to15/5:,21,True,True
1195,262,417,155,12/4to12/5,14/15totop14,12/4to12/5:12/5to12/6:12/6to12/7:12/7to12/8:12/8to12/9:12/9to12/10:12/10to12/11:12/11to12/12:12/12to12/13:12/13to12/14:12/14to12/15:12/15to13/15:13/15to14/15:14/15totop14:,14,True,True
2795,262,399,137,13/14to13/13,13/3to13/2,13/14to13/13:13/13to13/12:13/12to13/11:13/11to13/10:13/10to13/9:13/9to13/8:13/8to13/7:13/7to13/6:13/6to13/5:13/5to13/4:13/4to13/3:13/3to13/2:,12,True,True
3346,262,411,149,4/12to3/12,5/4to5/5,4/12to3/12:3/12to3/11:3/11to3/10:3/10to3/9:3/9to3/8:3/8to3/7:3/7to3/6:3/6to3/5:3/5to3/4:3/4to4/4:4/4to5/4:5/4to5/5:,12,False,True
2153,263,358,95,3/2to2/2,3/7to4/7,3/2to2/2:2/2to2/3:2/3to2/4:2/4to2/5:2/5to2/6:2/6to2/7:2/7to3/7:3/7to4/7:,8,False,True
3299,264,335,71,6/11to6/12,7/15to8/15,6/11to6/12:6/12to6/13:6/13to6/14:6/14to6/15:6/15to7/15:7/15to8/15:,6,False,True
1457,264,576,312,5/14to5/13,15/0to15/1,5/14to5/13:5/13to5/12:5/12to5/11:5/11to5/10:5/10to5/9:5/9to5/8:5/8to5/7:5/7to5/6:5/6to5/5:5/5to5/4:5/4to5/3:5/3to5/2:5/2to5/1:5/1to5/0:5/0to6/0:6/0to7/0:7/0to8/0:8/0to9/0:9/0to10/0:10/0to11/0:11/0to12/0:12/0to13/0:13/0to14/0:14/0to15/0:15/0to15/1:,25,True,True
957,265,348,83,5/1to6/1,9/3to9/4,5/1to6/1:6/1to6/2:6/2to6/3:6/3to7/3:7/3to8/3:8/3to9/3:9/3to9/4:,7,False,True
350,265,644,379,right0to15/0,0/15totop0,right0to15/0:15/0to14/0:14/0to13/0:13/0to12/0:12/0to11/0:11/0to10/0:10/0to9/0:9/0to8/0:8/0to7/0:7/0to6/0:6/0to5/0:5/0to4/0:4/0to3/0:3/0to2/0:2/0to1/0:1/0to0/0:0/0to0/1:0/1to0/2:0/2to0/3:0/3to0/4:0/4to0/5:0/5to0/6:0/6to0/7:0/7to0/8:0/8to0/9:0/9to0/10:0/10to0/11:0/11to0/12:0/12to0/13:0/13to0/14:0/14to0/15:0/15totop0:,32,True,True
1003,265,717,452,1/3to1/4,15/15to15/14,1/3to1/4:1/4to1/5:1/5to1/6:1/6to1/7:1/7to1/8:1/8to1/9:1/9to1/10:1/10to1/11:1/11to1/12:1/12to1/13:1/13to1/14:1/14to2/14:2/14to3/14:3/14to4/14:4/14to5/14:5/14to6/14:6/14to7/14:7/14to8/14:8/14to9/14:9/14to10/14:10/14to10/15:10/15to11/15:11/15to12/15:12/15to13/15:13/15to14/15:14/15to15/15:15/15to15/14:,27,True,True
3079,266,293,27,top6to6/15,6/14to6/13,top6to6/15:6/15to6/14:6/14to6/13:,3,True,True
1753,266,485,219,1/1to1/2,14/1to15/1,1/1to1/2:1/2to2/2:2/2to3/2:3/2to4/2:4/2to5/2:5/2to6/2:6/2to7/2:7/2to8/2:8/2to9/2:9/2to10/2:10/2to11/2:11/2to12/2:12/2to12/1:12/1to13/1:13/1to14/1:14/1to15/1:,16,True,True
1926,267,487,220,11/9to10/9,2/14to2/15,11/9to10/9:10/9to9/9:9/9to8/9:8/9to7/9:7/9to6/9:6/9to5/9:5/9to4/9:4/9to3/9:3/9to2/9:2/9to2/10:2/10to2/11:2/11to2/12:2/12to2/13:2/13to2/14:2/14to2/15:,15,True,True
1079,268,455,187,10/4to10/3,0/6to0/7,10/4to10/3:10/3to9/3:9/3to8/3:8/3to7/3:7/3to6/3:6/3to5/3:5/3to4/3:4/3to3/3:3/3to2/3:2/3to1/3:1/3to0/3:0/3to0/4:0/4to0/5:0/5to0/6:0/6to0/7:,15,True,True
2600,268,397,129,15/7to14/7,12/14to12/15,15/7to14/7:14/7to13/7:13/7to12/7:12/7to12/8:12/8to12/9:12/9to12/10:12/10to12/11:12/11to12/12:12/12to12/13:12/13to12/14:12/14to12/15:,11,False,True
995,268,595,327,right11to15/11,3/1to3/0,right11to15/11:15/11to14/11:14/11to13/11:13/11to12/11:12/11to11/11:11/11to10/11:10/11to9/11:9/11to8/11:8/11to7/11:7/11to6/11:6/11to5/11:5/11to4/11:4/11to3/11:3/11to3/10:3/10to3/9:3/9to3/8:3/8to3/7:3/7to3/6:3/6to3/5:3/5to3/4:3/4to3/3:3/3to3/2:3/2to3/1:3/1to3/0:,24,True,True
404,269,392,123,11/6to10/6,8/0tobottom8,11/6to10/6:10/6to10/5:10/5to9/5:9/5to8/5:8/5to8/4:8/4to8/3:8/3to8/2:8/2to8/1:8/1to8/0:8/0tobottom8:,10,True,True
1257,269,346,77,2/2to2/3,5/4to5/5,2/2to2/3:2/3to2/4:2/4to3/4:3/4to4/4:4/4to5/4:5/4to5/5:,6,False,True
1865,269,331,62,11/13to12/13,14/14to15/14,11/13to12/13:12/13to12/14:12/14to13/14:13/14to14/14:14/14to15/14:,5,False,True
1529,269,368,99,15/14to14/14,8/15totop8,15/14to14/14:14/14to13/14:13/14to12/14:12/14to11/14:11/14to10/14:10/14to9/14:9/14to8/14:8/14to8/15:8/15totop8:,9,False,True
1105,270,445,175,1/11to1/10,10/8to10/7,1/11to1/10:1/10to1/9:1/9to2/9:2/9to3/9:3/9to4/9:4/9to5/9:5/9to6/9:6/9to7/9:7/9to8/9:8/9to9/9:9/9to10/9:10/9to10/8:10/8to10/7:,13,True,True
1181,270,459,189,top1to1/15,6/6to6/7,top1to1/15:1/15to1/14:1/14to1/13:1/13to1/12:1/12to1/11:1/11to1/10:1/10to1/9:1/9to1/8:1/8to1/7:1/7to1/6:1/6to2/6:2/6to3/6:3/6to4/6:4/6to5/6:5/6to6/6:6/6to6/7:,16,True,True
1448,271,340,69,7/10to6/10,6/14to7/14,7/10to6/10:6/10to6/11:6/11to6/12:6/12to6/13:6/13to6/14:6/14to7/14:,6,True,True
3217,271,417,146,0/3to0/4,5/7to5/6,0/3to0/4:0/4to0/5:0/5to0/6:0/6to0/7:0/7to1/7:1/7to2/7:2/7to3/7:3/7to4/7:4/7to5/7:5/7to5/6:,10,True,True
2319,271,339,68,12/10to12/9,11/6to10/6,12/10to12/9:12/9to11/9:11/9to11/8:11/8to11/7:11/7to11/6:11/6to10/6:,6,True,True
965,271,377,106,7/1to8/1,10/4to11/4,7/1to8/1:8/1to8/2:8/2to8/3:8/3to8/4:8/4to9/4:9/4to10/4:10/4to11/4:,7,True,True
1786,271,445,174,top12to12/15,11/2to11/1,top12to12/15:12/15to11/15:11/15to11/14:11/14to11/13:11/13to11/12:11/12to11/11:11/11to11/10:11/10to11/9:11/9to11/8:11/8to11/7:11/7to11/6:11/6to11/5:11/5to11/4:11/4to11/3:11/3to11/2:11/2to11/1:,16,False,True
1281,272,494,222,8/14to7/14,0/6to1/6,8/14to7/14:7/14to6/14:6/14to5/14:5/14to4/14:4/14to3/14:3/14to2/14:2/14to1/14:1/14to0/14:0/14to0/13:0/13to0/12:0/12to0/11:0/11to0/10:0/10to0/9:0/9to0/8:0/8to0/7:0/7to0/6:0/6to1/6:,17,False,True
1477,272,326,54,1/1to1/0,4/0tobottom4,1/1to1/0:1/0to2/0:2/0to3/0:3/0to4/0:4/0tobottom4:,5,True,True
3379,272,398,126,4/5to4/6,9/9to9/8,4/5to4/6:4/6to4/7:4/7to4/8:4/8to4/9:4/9to5/9:5/9to6/9:6/9to7/9:7/9to8/9:8/9to9/9:9/9to9/8:,10,True,True
520,272,435,163,2/15to1/15,1/3to1/2,2/15to1/15:1/15to1/14:1/14to1/13:1/13to1/12:1/12to1/11:1/11to1/10:1/10to1/9:1/9to1/8:1/8to1/7:1/7to1/6:1/6to1/5:1/5to1/4:1/4to1/3:1/3to1/2:,14,False,True
2091,273,617,344,right6to15/6,1/13to0/13,right6to15/6:15/6to14/6:14/6to13/6:13/6to12/6:12/6to11/6:11/6to10/6:10/6to9/6:9/6to8/6:8/6to7/6:7/6to6/6:6/6to5/6:5/6to4/6:4/6to3/6:3/6to2/6:2/6to1/6:1/6to1/7:1/7to1/8:1/8to1/9:1/9to1/10:1/10to1/11:1/11to1/12:1/12to1/13:1/13to0/13:,23,True,True
2861,273,356,83,1/7to0/7,0/2toleft2,1/7to0/7:0/7to0/6:0/6to0/5:0/5to0/4:0/4to0/3:0/3to0/2:0/2toleft2:,7,True,True
2762,273,398,125,13/3to13/4,7/2to7/1,13/3to13/4:13/4to12/4:12/4to11/4:11/4to10/4:10/4to9/4:9/4to8/4:8/4to7/4:7/4to7/3:7/3to7/2:7/2to7/1:,10,False,True
2733,274,568,294,0/11to0/10,14/6to15/6,0/11to0/10:0/10to1/10:1/10to2/10:2/10to3/10:3/10to4/10:4/10to5/10:5/10to6/10:6/10to7/10:7/10to8/10:8/10to9/10:9/10to10/10:10/10to10/9:10/9to10/8:10/8to10/7:10/7to10/6:10/6to11/6:11/6to12/6:12/6to13/6:13/6to14/6:14/6to15/6:,20,False,True
691,275,465,190,12/8to11/8,0/8toleft8,12/8to11/8:11/8to10/8:10/8to9/8:9/8to8/8:8/8to7/8:7/8to6/8:6/8to5/8:5/8to4/8:4/8to3/8:3/8to2/8:2/8to1/8:1/8to0/8:0/8toleft8:,13,True,True
2199,275,408,133,12/11to12/12,6/11to6/10,12/11to12/12:12/12to11/12:11/12to10/12:10/12to9/12:9/12to8/12:8/12to7/12:7/12to6/12:6/12to6/11:6/11to6/10:,9,True,True
94,276,651,375,left15to0/15,15/0tobottom15,left15to0/15:0/15to1/15:1/15to2/15:2/15to3/15:3/15to4/15:4/15to5/15:5/15to6/15:6/15to7/15:7/15to8/15:8/15to9/15:9/15to10/15:10/15to10/14:10/14to10/13:10/13to10/12:10/12to10/11:10/11to10/10:10/10to10/9:10/9to10/8:10/8to10/7:10/7to10/6:10/6to10/5:10/5to10/4:10/4to10/3:10/3to10/2:10/2to10/1:10/1to10/0:10/0to11/0:11/0to12/0:12/0to13/0:13/0to14/0:14/0to15/0:15/0tobottom15:,32,False,True
416,276,567,291,0/12to0/11,13/6to14/6,0/12to0/11:0/11to1/11:1/11to2/11:2/11to3/11:3/11to4/11:4/11to5/11:5/11to6/11:6/11to7/11:7/11to8/11:8/11to9/11:9/11to10/11:10/11to10/10:10/10to10/9:10/9to10/8:10/8to10/7:10/7to10/6:10/6to11/6:11/6to12/6:12/6to13/6:13/6to14/6:,20,False,True
403,277,343,66,6/11to7/11,10/11to11/11,6/11to7/11:7/11to8/11:8/11to9/11:9/11to10/11:10/11to11/11:,5,True,True
2394,277,454,177,1/2to2/2,8/8to9/8,1/2to2/2:2/2to2/3:2/3to2/4:2/4to2/5:2/5to2/6:2/6to2/7:2/7to2/8:2/8to3/8:3/8to4/8:4/8to5/8:5/8to6/8:6/8to7/8:7/8to8/8:8/8to9/8:,14,True,True
3183,277,438,161,11/5to10/5,7/13to7/14,11/5to10/5:10/5to9/5:9/5to8/5:8/5to7/5:7/5to7/6:7/6to7/7:7/7to7/8:7/8to7/9:7/9to7/10:7/10to7/11:7/11to7/12:7/12to7/13:7/13to7/14:,13,True,True
2569,277,314,37,14/6to14/7,13/7to13/8,14/6to14/7:14/7to13/7:13/7to13/8:,3,False,True
2047,277,328,51,8/14to8/15,6/15to5/15,8/14to8/15:8/15to7/15:7/15to6/15:6/15to5/15:,4,True,True
2190,277,541,264,right12to15/12,0/15toleft15,right12to15/12:15/12to14/12:14/12to13/12:13/12to12/12:12/12to11/12:11/12to10/12:10/12to9/12:9/12to8/12:8/12to7/12:7/12to6/12:6/12to5/12:5/12to4/12:4/12to3/12:3/12to2/12:2/12to1/12:1/12to0/12:0/12to0/13:0/13to0/14:0/14to0/15:0/15toleft15:,20,True,True
1885,277,487,210,9/15to10/15,12/1to13/1,9/15to10/15:10/15to10/14:10/14to10/13:10/13to10/12:10/12to10/11:10/11to10/10:10/10to10/9:10/9to10/8:10/8to10/7:10/7to10/6:10/6to10/5:10/5to10/4:10/4to10/3:10/3to10/2:10/2to10/1:10/1to11/1:11/1to12/1:12/1to13/1:,18,False,True
2296,278,379,101,1/7to1/8,0/13toleft13,1/7to1/8:1/8to0/8:0/8to0/9:0/9to0/10:0/10to0/11:0/11to0/12:0/12to0/13:0/13toleft13:,8,False,True
519,278,551,273,top3to3/15,11/3to11/4,top3to3/15:3/15to3/14:3/14to3/13:3/13to3/12:3/12to3/11:3/11to3/10:3/10to3/9:3/9to3/8:3/8to3/7:3/7to3/6:3/6to3/5:3/5to3/4:3/4to3/3:3/3to4/3:4/3to5/3:5/3to6/3:6/3to7/3:7/3to8/3:8/3to9/3:9/3to10/3:10/3to11/3:11/3to11/4:,22,True,True
1714,279,454,175,top13to13/15,10/5to10/4,top13to13/15:13/15to12/15:12/15to11/15:11/15to10/15:10/15to10/14:10/14to10/13:10/13to10/12:10/12to10/11:10/11to10/10:10/10to10/9:10/9to10/8:10/8to10/7:10/7to10/6:10/6to10/5:10/5to10/4:,15,False,True
2707,279,427,148,3/4to3/5,8/10to9/10,3/4to3/5:3/5to3/6:3/6to3/7:3/7to3/8:3/8to3/9:3/9to3/10:3/10to4/10:4/10to5/10:5/10to6/10:6/10to7/10:7/10to8/10:8/10to9/10:,12,True,True
220,279,719,440,right15to15/15,0/0tobottom0,right15to15/15:15/15to14/15:14/15to13/15:13/15to12/15:12/15to11/15:11/15to10/15:10/15to9/15:9/15to8/15:8/15to7/15:7/15to6/15:6/15to5/15:5/15to4/15:4/15to3/15:3/15to2/15:2/15to1/15:1/15to0/15:0/15to0/14:0/14to0/13:0/13to0/12:0/12to0/11:0/11to0/10:0/10to0/9:0/9to0/8:0/8to0/7:0/7to0/6:0/6to0/5:0/5to0/4:0/4to0/3:0/3to0/2:0/2to0/1:0/1to0/0:0/0tobottom0:,32,False,True
195,280,654,374,left0to0/0,15/15totop15,left0to0/0:0/0to1/0:1/0to2/0:2/0to3/0:3/0to4/0:4/0to5/0:5/0to6/0:6/0to7/0:7/0to8/0:8/0to9/0:9/0to10/0:10/0to10/1:10/1to10/2:10/2to10/3:10/3to10/4:10/4to10/5:10/5to10/6:10/6to10/7:10/7to10/8:10/8to10/9:10/9to10/10:10/10to10/11:10/11to10/12:10/12to10/13:10/13to10/14:10/14to10/15:10/15to11/15:11/15to12/15:12/15to13/15:13/15to14/15:14/15to15/15:15/15totop15:,32,False,True
790,280,323,43,5/11to5/10,5/9to6/9,5/11to5/10:5/10to5/9:5/9to6/9:,3,False,True
643,281,329,48,11/0to11/1,10/2to10/3,11/0to11/1:11/1to10/1:10/1to10/2:10/2to10/3:,4,True,True
2534,281,509,228,11/12to10/12,6/1to6/0,11/12to10/12:10/12to9/12:9/12to8/12:8/12to7/12:7/12to6/12:6/12to6/11:6/11to6/10:6/10to6/9:6/9to6/8:6/8to6/7:6/7to6/6:6/6to6/5:6/5to6/4:6/4to6/3:6/3to6/2:6/2to6/1:6/1to6/0:,17,False,True
1427,281,463,182,1/0to2/0,2/12to2/13,1/0to2/0:2/0to2/1:2/1to2/2:2/2to2/3:2/3to2/4:2/4to2/5:2/5to2/6:2/6to2/7:2/7to2/8:2/8to2/9:2/9to2/10:2/10to2/11:2/11to2/12:2/12to2/13:,14,False,True
340,282,675,393,right0to15/0,0/15totop0,right0to15/0:15/0to14/0:14/0to13/0:13/0to12/0:12/0to11/0:11/0to11/1:11/1to10/1:10/1to9/1:9/1to8/1:8/1to7/1:7/1to6/1:6/1to5/1:5/1to4/1:4/1to3/1:3/1to2/1:2/1to1/1:1/1to0/1:0/1to0/2:0/2to0/3:0/3to0/4:0/4to0/5:0/5to0/6:0/6to0/7:0/7to0/8:0/8to0/9:0/9to0/10:0/10to0/11:0/11to0/12:0/12to0/13:0/13to0/14:0/14to0/15:0/15totop0:,32,True,True
3118,282,375,93,2/3to2/4,2/10to1/10,2/3to2/4:2/4to2/5:2/5to2/6:2/6to2/7:2/7to2/8:2/8to2/9:2/9to2/10:2/10to1/10:,8,False,True
3281,283,396,113,0/2to0/3,1/10to1/9,0/2to0/3:0/3to0/4:0/4to0/5:0/5to0/6:0/6to0/7:0/7to0/8:0/8to0/9:0/9to0/10:0/10to1/10:1/10to1/9:,10,True,True
2015,283,496,213,15/10to14/10,6/15to5/15,15/10to14/10:14/10to13/10:13/10to12/10:12/10to11/10:11/10to10/10:10/10to9/10:9/10to8/10:8/10to7/10:7/10to6/10:6/10to6/11:6/11to6/12:6/12to6/13:6/13to6/14:6/14to6/15:6/15to5/15:,15,True,True
224,283,720,437,right15to15/15,0/0tobottom0,right15to15/15:15/15to14/15:14/15to13/15:13/15to12/15:12/15to11/15:11/15to10/15:10/15to9/15:9/15to8/15:8/15to7/15:7/15to6/15:6/15to5/15:5/15to4/15:4/15to3/15:3/15to2/15:2/15to1/15:1/15to0/15:0/15to0/14:0/14to0/13:0/13to0/12:0/12to0/11:0/11to0/10:0/10to0/9:0/9to0/8:0/8to0/7:0/7to0/6:0/6to0/5:0/5to0/4:0/4to0/3:0/3to0/2:0/2to0/1:0/1to0/0:0/0tobottom0:,32,False,True
150,283,773,490,left0to0/0,15/15totop15,left0to0/0:0/0to0/1:0/1to0/2:0/2to0/3:0/3to0/4:0/4to0/5:0/5to0/6:0/6to0/7:0/7to0/8:0/8to0/9:0/9to0/10:0/10to0/11:0/11to0/12:0/12to0/13:0/13to0/14:0/14to1/14:1/14to2/14:2/14to3/14:3/14to4/14:4/14to5/14:5/14to6/14:6/14to7/14:7/14to8/14:8/14to9/14:9/14to10/14:10/14to10/15:10/15to11/15:11/15to12/15:12/15to13/15:13/15to14/15:14/15to15/15:15/15totop15:,32,True,True
298,284,727,443,right15to15/15,0/0tobottom0,right15to15/15:15/15to14/15:14/15to13/15:13/15to12/15:12/15to11/15:11/15to10/15:10/15to9/15:9/15to8/15:8/15to7/15:7/15to6/15:6/15to5/15:5/15to4/15:4/15to3/15:3/15to2/15:2/15to1/15:1/15to0/15:0/15to0/14:0/14to0/13:0/13to0/12:0/12to0/11:0/11to0/10:0/10to0/9:0/9to0/8:0/8to0/7:0/7to0/6:0/6to0/5:0/5to0/4:0/4to0/3:0/3to0/2:0/2to0/1:0/1to0/0:0/0tobottom0:,32,False,True
475,284,379,95,10/13to10/12,10/6to10/5,10/13to10/12:10/12to10/11:10/11to10/10:10/10to10/9:10/9to10/8:10/8to10/7:10/7to10/6:10/6to10/5:,8,False,True
2189,284,531,247,4/2to3/2,9/15to9/14,4/2to3/2:3/2to3/3:3/3to3/4:3/4to3/5:3/5to3/6:3/6to3/7:3/7to3/8:3/8to3/9:3/9to3/10:3/10to3/11:3/11to3/12:3/12to3/13:3/13to3/14:3/14to3/15:3/15to4/15:4/15to5/15:5/15to6/15:6/15to7/15:7/15to8/15:8/15to9/15:9/15to9/14:,21,False,True
3148,284,381,97,9/6to9/5,4/6to3/6,9/6to9/5:9/5to8/5:8/5to7/5:7/5to6/5:6/5to5/5:5/5to4/5:4/5to4/6:4/6to3/6:,8,True,True
3051,285,511,226,1/8to2/8,10/15to11/15,1/8to2/8:2/8to2/9:2/9to2/10:2/10to2/11:2/11to2/12:2/12to2/13:2/13to3/13:3/13to4/13:4/13to5/13:5/13to6/13:6/13to7/13:7/13to8/13:8/13to9/13:9/13to10/13:10/13to10/14:10/14to10/15:10/15to11/15:,17,True,True
3310,285,379,94,4/3to3/3,1/7to2/7,4/3to3/3:3/3to2/3:2/3to1/3:1/3to1/4:1/4to1/5:1/5to1/6:1/6to1/7:1/7to2/7:,8,True,True
376,286,669,383,right0to15/0,0/15totop0,right0to15/0:15/0to14/0:14/0to13/0:13/0to12/0:12/0to11/0:11/0to10/0:10/0to9/0:9/0to8/0:8/0to7/0:7/0to6/0:6/0to5/0:5/0to4/0:4/0to3/0:3/0to2/0:2/0to1/0:1/0to0/0:0/0to0/1:0/1to0/2:0/2to0/3:0/3to0/4:0/4to0/5:0/5to0/6:0/6to0/7:0/7to0/8:0/8to0/9:0/9to0/10:0/10to0/11:0/11to0/12:0/12to0/13:0/13to0/14:0/14to0/15:0/15totop0:,32,False,True
1107,287,381,94,12/3to11/3,11/9to12/9,12/3to11/3:11/3to11/4:11/4to11/5:11/5to11/6:11/6to11/7:11/7to11/8:11/8to11/9:11/9to12/9:,8,False,True
2498,287,454,167,3/15to4/15,6/5to6/6,3/15to4/15:4/15to4/14:4/14to4/13:4/13to4/12:4/12to4/11:4/11to4/10:4/10to4/9:4/9to4/8:4/8to4/7:4/7to4/6:4/6to4/5:4/5to5/5:5/5to6/5:6/5to6/6:,14,False,True
2657,287,473,186,14/3to14/4,10/13to10/14,14/3to14/4:14/4to13/4:13/4to12/4:12/4to11/4:11/4to10/4:10/4to10/5:10/5to10/6:10/6to10/7:10/7to10/8:10/8to10/9:10/9to10/10:10/10to10/11:10/11to10/12:10/12to10/13:10/13to10/14:,15,False,True
2558,288,384,96,0/6to1/6,2/11to2/12,0/6to1/6:1/6to1/7:1/7to1/8:1/8to1/9:1/9to1/10:1/10to1/11:1/11to2/11:2/11to2/12:,8,False,True
2468,288,433,145,2/8to3/8,6/1to7/1,2/8to3/8:3/8to3/7:3/7to3/6:3/6to3/5:3/5to3/4:3/4to3/3:3/3to3/2:3/2to3/1:3/1to4/1:4/1to5/1:5/1to6/1:6/1to7/1:,12,False,True
3273,288,461,173,15/0to14/0,6/3to7/3,15/0to14/0:14/0to13/0:13/0to12/0:12/0to11/0:11/0to10/0:10/0to9/0:9/0to8/0:8/0to7/0:7/0to6/0:6/0to6/1:6/1to6/2:6/2to6/3:6/3to7/3:,13,True,True
699,288,440,152,6/13to6/14,5/4to4/4,6/13to6/14:6/14to5/14:5/14to5/13:5/13to5/12:5/12to5/11:5/11to5/10:5/10to5/9:5/9to5/8:5/8to5/7:5/7to5/6:5/6to5/5:5/5to5/4:5/4to4/4:,13,True,True
3138,289,509,220,3/14to3/13,12/8to12/7,3/14to3/13:3/13to4/13:4/13to5/13:5/13to6/13:6/13to7/13:7/13to8/13:8/13to9/13:9/13to10/13:10/13to10/12:10/12to10/11:10/11to10/10:10/10to10/9:10/9to10/8:10/8to11/8:11/8to12/8:12/8to12/7:,16,False,True
768,289,383,94,1/13to0/13,5/14to5/15,1/13to0/13:0/13to0/14:0/14to1/14:1/14to2/14:2/14to3/14:3/14to4/14:4/14to5/14:5/14to5/15:,8,True,True
79,289,660,371,left15to0/15,15/0tobottom15,left15to0/15:0/15to1/15:1/15to2/15:2/15to3/15:3/15to4/15:4/15to5/15:5/15to6/15:6/15to7/15:7/15to8/15:8/15to9/15:9/15to10/15:10/15to10/14:10/14to10/13:10/13to10/12:10/12to10/11:10/11to10/10:10/10to10/9:10/9to10/8:10/8to10/7:10/7to10/6:10/6to10/5:10/5to10/4:10/4to10/3:10/3to10/2:10/2to10/1:10/1to10/0:10/0to11/0:11/0to12/0:12/0to13/0:13/0to14/0:14/0to15/0:15/0tobottom15:,32,False,True
514,289,455,166,6/9to7/9,11/15to11/14,6/9to7/9:7/9to8/9:8/9to9/9:9/9to10/9:10/9to10/10:10/10to10/11:10/11to10/12:10/12to10/13:10/13to10/14:10/14to10/15:10/15to11/15:11/15to11/14:,12,False,True
579,289,538,249,2/8to3/8,12/15to13/15,2/8to3/8:3/8to4/8:4/8to5/8:5/8to6/8:6/8to7/8:7/8to8/8:8/8to9/8:9/8to10/8:10/8to10/9:10/9to10/10:10/10to10/11:10/11to10/12:10/12to10/13:10/13to10/14:10/14to10/15:10/15to11/15:11/15to12/15:12/15to13/15:,18,False,True
2566,289,411,122,5/15to6/15,10/11to10/10,5/15to6/15:6/15to7/15:7/15to8/15:8/15to9/15:9/15to10/15:10/15to10/14:10/14to10/13:10/13to10/12:10/12to10/11:10/11to10/10:,10,False,True
101,290,790,500,left0to0/0,15/15totop15,left0to0/0:0/0to0/1:0/1to0/2:0/2to0/3:0/3to0/4:0/4to0/5:0/5to0/6:0/6to0/7:0/7to0/8:0/8to0/9:0/9to0/10:0/10to0/11:0/11to0/12:0/12to0/13:0/13to0/14:0/14to1/14:1/14to2/14:2/14to3/14:3/14to4/14:4/14to5/14:5/14to6/14:6/14to7/14:7/14to8/14:8/14to9/14:9/14to10/14:10/14to10/15:10/15to11/15:11/15to12/15:12/15to13/15:13/15to14/15:14/15to15/15:15/15totop15:,32,True,True
2024,290,431,141,3/5to4/5,5/13to5/14,3/5to4/5:4/5to4/6:4/6to4/7:4/7to4/8:4/8to4/9:4/9to4/10:4/10to4/11:4/11to4/12:4/12to4/13:4/13to5/13:5/13to5/14:,11,False,True
305,291,684,393,right0to15/0,0/15totop0,right0to15/0:15/0to14/0:14/0to13/0:13/0to12/0:12/0to11/0:11/0to10/0:10/0to9/0:9/0to8/0:8/0to7/0:7/0to6/0:6/0to5/0:5/0to4/0:4/0to3/0:3/0to2/0:2/0to1/0:1/0to0/0:0/0to0/1:0/1to0/2:0/2to0/3:0/3to0/4:0/4to0/5:0/5to0/6:0/6to0/7:0/7to0/8:0/8to0/9:0/9to0/10:0/10to0/11:0/11to0/12:0/12to0/13:0/13to0/14:0/14to0/15:0/15totop0:,32,True,True
2004,291,399,108,9/4to9/5,11/10to12/10,9/4to9/5:9/5to10/5:10/5to11/5:11/5to11/6:11/6to11/7:11/7to11/8:11/8to11/9:11/9to11/10:11/10to12/10:,9,True,True
2318,292,328,36,8/3to8/2,8/1to9/1,8/3to8/2:8/2to8/1:8/1to9/1:,3,True,True
2884,292,380,88,10/4to11/4,15/5to15/6,10/4to11/4:11/4to11/5:11/5to12/5:12/5to13/5:13/5to14/5:14/5to15/5:15/5to15/6:,7,False,True
2347,292,497,205,13/15to12/15,9/3to8/3,13/15to12/15:12/15to12/14:12/14to12/13:12/13to12/12:12/12to12/11:12/11to12/10:12/10to12/9:12/9to12/8:12/8to12/7:12/7to12/6:12/6to12/5:12/5to12/4:12/4to12/3:12/3to11/3:11/3to10/3:10/3to9/3:9/3to8/3:,17,True,True
782,293,648,355,1/13to1/14,15/3toright3,1/13to1/14:1/14to1/13:1/13to1/12:1/12to1/11:1/11to1/10:1/10to1/9:1/9to1/8:1/8to1/7:1/7to1/6:1/6to1/5:1/5to2/5:2/5to3/5:3/5to4/5:4/5to5/5:5/5to6/5:6/5to7/5:7/5to8/5:8/5to9/5:9/5to10/5:10/5to10/4:10/4to11/4:11/4to11/3:11/3to12/3:12/3to13/3:13/3to14/3:14/3to15/3:15/3toright3:,27,True,True
2581,293,481,188,right0to15/0,4/1to4/2,right0to15/0:15/0to14/0:14/0to13/0:13/0to12/0:12/0to11/0:11/0to10/0:10/0to9/0:9/0to8/0:8/0to7/0:7/0to6/0:6/0to5/0:5/0to4/0:4/0to4/1:4/1to4/2:,14,True,True
2202,294,484,190,15/4to15/3,8/10to9/10,15/4to15/3:15/3to14/3:14/3to13/3:13/3to12/3:12/3to11/3:11/3to10/3:10/3to9/3:9/3to8/3:8/3to8/4:8/4to8/5:8/5to8/6:8/6to8/7:8/7to8/8:8/8to8/9:8/9to8/10:8/10to9/10:,16,False,True
387,294,690,396,right0to15/0,0/15totop0,right0to15/0:15/0to14/0:14/0to13/0:13/0to12/0:12/0to11/0:11/0to10/0:10/0to9/0:9/0to8/0:8/0to7/0:7/0to6/0:6/0to5/0:5/0to4/0:4/0to3/0:3/0to2/0:2/0to1/0:1/0to0/0:0/0to0/1:0/1to0/2:0/2to0/3:0/3to0/4:0/4to0/5:0/5to0/6:0/6to0/7:0/7to0/8:0/8to0/9:0/9to0/10:0/10to0/11:0/11to0/12:0/12to0/13:0/13to0/14:0/14to0/15:0/15totop0:,32,False,True
2258,294,364,70,3/9to2/9,3/11to4/11,3/9to2/9:2/9to2/10:2/10to2/11:2/11to3/11:3/11to4/11:,5,False,True
1597,294,342,48,13/7to13/8,13/10to12/10,13/7to13/8:13/8to13/9:13/9to13/10:13/10to12/10:,4,True,True
2466,294,566,272,1/7to2/7,15/0tobottom15,1/7to2/7:2/7to2/6:2/6to2/5:2/5to2/4:2/4to2/3:2/3to2/2:2/2to2/1:2/1to2/0:2/0to3/0:3/0to4/0:4/0to5/0:5/0to6/0:6/0to7/0:7/0to8/0:8/0to9/0:9/0to10/0:10/0to11/0:11/0to12/0:12/0to13/0:13/0to14/0:14/0to15/0:15/0tobottom15:,22,True,True
718,294,370,76,0/12to1/12,3/14to3/13,0/12to1/12:1/12to1/13:1/13to1/14:1/14to2/14:2/14to3/14:3/14to3/13:,6,True,True
544,294,369,75,3/12to2/12,3/10to4/10,3/12to2/12:2/12to2/11:2/11to2/10:2/10to3/10:3/10to4/10:,5,True,True
2493,295,409,114,0/5to0/6,2/11to3/11,0/5to0/6:0/6to0/7:0/7to0/8:0/8to0/9:0/9to0/10:0/10to0/11:0/11to1/11:1/11to2/11:2/11to3/11:,9,True,True
814,295,400,105,8/11to7/11,3/13to3/14,8/11to7/11:7/11to6/11:6/11to5/11:5/11to4/11:4/11to3/11:3/11to3/12:3/12to3/13:3/13to3/14:,8,False,True
602,295,613,318,top14to14/15,0/8toleft8,top14to14/15:14/15to13/15:13/15to12/15:12/15to11/15:11/15to10/15:10/15to9/15:9/15to8/15:8/15to7/15:7/15to6/15:6/15to5/15:5/15to4/15:4/15to3/15:3/15to2/15:2/15to1/15:1/15to0/15:0/15to0/14:0/14to0/13:0/13to0/12:0/12to0/11:0/11to0/10:0/10to0/9:0/9to0/8:0/8toleft8:,23,False,True
2322,295,432,137,1/5to2/5,8/6to8/5,1/5to2/5:2/5to2/6:2/6to3/6:3/6to4/6:4/6to5/6:5/6to6/6:6/6to7/6:7/6to8/6:8/6to8/5:,9,True,True
3005,296,331,35,11/11to11/10,11/9to11/8,11/11to11/10:11/10to11/9:11/9to11/8:,3,True,True
1453,296,335,39,0/15to1/15,2/15to3/15,0/15to1/15:1/15to2/15:2/15to3/15:,3,False,True
958,296,377,81,10/4to10/5,12/8to13/8,10/4to10/5:10/5to10/6:10/6to11/6:11/6to12/6:12/6to12/7:12/7to12/8:12/8to13/8:,7,True,True
180,297,799,502,left0to0/0,15/15totop15,left0to0/0:0/0to0/1:0/1to0/2:0/2to0/3:0/3to0/4:0/4to0/5:0/5to0/6:0/6to0/7:0/7to0/8:0/8to0/9:0/9to0/10:0/10to0/11:0/11to0/12:0/12to0/13:0/13to0/14:0/14to1/14:1/14to2/14:2/14to3/14:3/14to4/14:4/14to5/14:5/14to6/14:6/14to7/14:7/14to8/14:8/14to9/14:9/14to10/14:10/14to10/15:10/15to11/15:11/15to12/15:12/15to13/15:13/15to14/15:14/15to15/15:15/15totop15:,32,True,True
991,297,576,279,12/3to11/3,0/9toleft9,12/3to11/3:11/3to10/3:10/3to9/3:9/3to8/3:8/3to7/3:7/3to6/3:6/3to5/3:5/3to4/3:4/3to3/3:3/3to2/3:2/3to1/3:1/3to0/3:0/3to0/4:0/4to0/5:0/5to0/6:0/6to0/7:0/7to0/8:0/8to0/9:0/9toleft9:,19,True,True
3305,297,402,105,7/3to6/3,2/5to1/5,7/3to6/3:6/3to5/3:5/3to4/3:4/3to3/3:3/3to2/3:2/3to2/4:2/4to2/5:2/5to1/5:,8,False,True
3387,297,319,22,13/1to13/2,13/2to14/2,13/1to13/2:13/2to14/2:,2,False,True
2854,297,429,132,7/0to7/1,3/6to3/7,7/0to7/1:7/1to6/1:6/1to5/1:5/1to4/1:4/1to3/1:3/1to3/2:3/2to3/3:3/3to3/4:3/4to3/5:3/5to3/6:3/6to3/7:,11,False,True
2664,298,543,245,3/8to4/8,14/14to15/14,3/8to4/8:4/8to5/8:5/8to6/8:6/8to7/8:7/8to8/8:8/8to9/8:9/8to10/8:10/8to10/9:10/9to10/10:10/10to10/11:10/11to10/12:10/12to10/13:10/13to10/14:10/14to11/14:11/14to12/14:12/14to13/14:13/14to14/14:14/14to15/14:,18,False,True
1076,298,451,153,8/7to7/7,0/7toleft7,8/7to7/7:7/7to6/7:6/7to5/7:5/7to4/7:4/7to3/7:3/7to2/7:2/7to1/7:1/7to0/7:0/7toleft7:,9,False,True
2023,298,452,154,right15to15/15,14/4to14/3,right15to15/15:15/15to14/15:14/15to14/14:14/14to14/13:14/13to14/12:14/12to14/11:14/11to14/10:14/10to14/9:14/9to14/8:14/8to14/7:14/7to14/6:14/6to14/5:14/5to14/4:14/4to14/3:,14,False,True
3141,299,569,270,2/4to2/5,10/10to10/11,2/4to2/5:2/5to2/6:2/6to2/7:2/7to2/8:2/8to2/9:2/9to2/10:2/10to3/10:3/10to4/10:4/10to5/10:5/10to6/10:6/10to7/10:7/10to8/10:8/10to9/10:9/10to10/10:10/10to10/11:,15,True,True
374,299,697,398,right0to15/0,0/15totop0,right0to15/0:15/0to14/0:14/0to13/0:13/0to12/0:12/0to11/0:11/0to11/1:11/1to10/1:10/1to9/1:9/1to8/1:8/1to7/1:7/1to6/1:6/1to5/1:5/1to4/1:4/1to3/1:3/1to2/1:2/1to1/1:1/1to0/1:0/1to0/2:0/2to0/3:0/3to0/4:0/4to0/5:0/5to0/6:0/6to0/7:0/7to0/8:0/8to0/9:0/9to0/10:0/10to0/11:0/11to0/12:0/12to0/13:0/13to0/14:0/14to0/15:0/15totop0:,32,True,True
777,299,458,159,15/3to15/2,11/9to10/9,15/3to15/2:15/2to14/2:14/2to13/2:13/2to12/2:12/2to12/3:12/3to12/4:12/4to12/5:12/5to12/6:12/6to12/7:12/7to12/8:12/8to11/8:11/8to11/9:11/9to10/9:,13,True,True
1326,299,478,179,12/12to11/12,14/2to15/2,12/12to11/12:11/12to11/11:11/11to11/10:11/10to11/9:11/9to11/8:11/8to11/7:11/7to11/6:11/6to11/5:11/5to11/4:11/4to11/3:11/3to11/2:11/2to12/2:12/2to13/2:13/2to14/2:14/2to15/2:,15,False,True
582,300,550,250,2/3to3/3,14/6to14/5,2/3to3/3:3/3to4/3:4/3to5/3:5/3to6/3:6/3to7/3:7/3to8/3:8/3to9/3:9/3to10/3:10/3to10/4:10/4to10/5:10/5to10/6:10/6to11/6:11/6to12/6:12/6to13/6:13/6to14/6:14/6to14/5:,16,False,True
1264,300,622,322,13/10to13/11,0/14to0/15,13/10to13/11:13/11to12/11:12/11to11/11:11/11to10/11:10/11to9/11:9/11to8/11:8/11to7/11:7/11to6/11:6/11to5/11:5/11to4/11:4/11to3/11:3/11to2/11:2/11to1/11:1/11to0/11:0/11to0/12:0/12to0/13:0/13to0/14:0/14to0/15:,18,True,True
1784,300,369,69,14/13to13/13,11/14to11/15,14/13to13/13:13/13to12/13:12/13to11/13:11/13to11/14:11/14to11/15:,5,False,True
1291,301,521,220,13/5to13/4,1/7to1/8,13/5to13/4:13/4to12/4:12/4to11/4:11/4to10/4:10/4to9/4:9/4to8/4:8/4to7/4:7/4to6/4:6/4to5/4:5/4to4/4:4/4to3/4:3/4to2/4:2/4to1/4:1/4to1/5:1/5to1/6:1/6to1/7:1/7to1/8:,17,False,True
1951,301,448,147,2/14to2/15,0/7to0/6,2/14to2/15:2/15to1/15:1/15to0/15:0/15to0/14:0/14to0/13:0/13to0/12:0/12to0/11:0/11to0/10:0/10to0/9:0/9to0/8:0/8to0/7:0/7to0/6:,12,True,True
295,302,729,427,right15to15/15,0/0tobottom0,right15to15/15:15/15to14/15:14/15to13/15:13/15to12/15:12/15to11/15:11/15to10/15:10/15to9/15:9/15to8/15:8/15to7/15:7/15to6/15:6/15to5/15:5/15to4/15:4/15to3/15:3/15to2/15:2/15to1/15:1/15to0/15:0/15to0/14:0/14to0/13:0/13to0/12:0/12to0/11:0/11to0/10:0/10to0/9:0/9to0/8:0/8to0/7:0/7to0/6:0/6to0/5:0/5to0/4:0/4to0/3:0/3to0/2:0/2to0/1:0/1to0/0:0/0tobottom0:,32,False,True
833,302,627,325,15/15to14/15,5/0to4/0,15/15to14/15:14/15to13/15:13/15to12/15:12/15to11/15:11/15to10/15:10/15to9/15:9/15to8/15:8/15to7/15:7/15to6/15:6/15to5/15:5/15to5/14:5/14to5/13:5/13to5/12:5/12to5/11:5/11to5/10:5/10to5/9:5/9to5/8:5/8to5/7:5/7to5/6:5/6to5/5:5/5to5/4:5/4to5/3:5/3to5/2:5/2to5/1:5/1to5/0:5/0to4/0:,26,False,True
3394,302,456,154,15/6to15/5,13/15totop13,15/6to15/5:15/5to14/5:14/5to13/5:13/5to13/6:13/6to13/7:13/7to13/8:13/8to13/9:13/9to13/10:13/10to13/11:13/11to13/12:13/12to13/13:13/13to13/14:13/14to13/15:13/15totop13:,14,False,True
2038,302,374,72,0/15to1/15,1/11to2/11,0/15to1/15:1/15to1/14:1/14to1/13:1/13to1/12:1/12to1/11:1/11to2/11:,6,False,True
567,302,441,139,2/5to3/5,11/5to11/4,2/5to3/5:3/5to4/5:4/5to5/5:5/5to6/5:6/5to7/5:7/5to8/5:8/5to9/5:9/5to10/5:10/5to11/5:11/5to11/4:,10,False,True
1133,303,646,343,left13to0/13,11/2to12/2,left13to0/13:0/13to1/13:1/13to2/13:2/13to3/13:3/13to4/13:4/13to5/13:5/13to6/13:6/13to7/13:7/13to8/13:8/13to9/13:9/13to10/13:10/13to10/12:10/12to10/11:10/11to10/10:10/10to10/9:10/9to10/8:10/8to10/7:10/7to10/6:10/6to10/5:10/5to10/4:10/4to10/3:10/3to10/2:10/2to11/2:11/2to12/2:,24,False,True
1217,304,423,119,1/13to0/13,1/9to2/9,1/13to0/13:0/13to0/12:0/12to0/11:0/11to0/10:0/10to0/9:0/9to1/9:1/9to2/9:,7,False,True
85,304,680,376,left15to0/15,15/0tobottom15,left15to0/15:0/15to1/15:1/15to2/15:2/15to3/15:3/15to4/15:4/15to5/15:5/15to6/15:6/15to7/15:7/15to8/15:8/15to9/15:9/15to10/15:10/15to10/14:10/14to10/13:10/13to10/12:10/12to10/11:10/11to10/10:10/10to10/9:10/9to10/8:10/8to10/7:10/7to10/6:10/6to10/5:10/5to10/4:10/4to10/3:10/3to10/2:10/2to10/1:10/1to10/0:10/0to11/0:11/0to12/0:12/0to13/0:13/0to14/0:14/0to15/0:15/0tobottom15:,32,False,True
3338,304,384,80,10/12to10/13,15/13toright13,10/12to10/13:10/13to11/13:11/13to12/13:12/13to13/13:13/13to14/13:14/13to15/13:15/13toright13:,7,False,True
1941,304,392,88,5/12to4/12,7/15totop7,5/12to4/12:4/12to4/13:4/13to4/14:4/14to4/15:4/15to5/15:5/15to6/15:6/15to7/15:7/15totop7:,8,True,True
2597,304,461,157,1/10to1/9,9/7to9/6,1/10to1/9:1/9to1/8:1/8to1/7:1/7to2/7:2/7to3/7:3/7to4/7:4/7to5/7:5/7to6/7:6/7to7/7:7/7to8/7:8/7to9/7:9/7to9/6:,12,False,True
3366,304,338,34,13/10to13/9,14/9to14/8,13/10to13/9:13/9to14/9:14/9to14/8:,3,True,True
1157,305,340,35,8/12to8/11,8/10to8/9,8/12to8/11:8/11to8/10:8/10to8/9:,3,False,True
2567,306,595,289,15/13to14/13,4/2to4/1,15/13to14/13:14/13to13/13:13/13to12/13:12/13to11/13:11/13to10/13:10/13to9/13:9/13to8/13:8/13to7/13:7/13to6/13:6/13to5/13:5/13to4/13:4/13to4/12:4/12to4/11:4/11to4/10:4/10to4/9:4/9to4/8:4/8to4/7:4/7to4/6:4/6to4/5:4/5to4/4:4/4to4/3:4/3to4/2:4/2to4/1:,23,True,True
2439,306,366,60,7/4to7/5,9/6to10/6,7/4to7/5:7/5to7/6:7/6to8/6:8/6to9/6:9/6to10/6:,5,False,True
277,306,731,425,right15to15/15,0/0tobottom0,right15to15/15:15/15to14/15:14/15to13/15:13/15to12/15:12/15to11/15:11/15to10/15:10/15to9/15:9/15to8/15:8/15to7/15:7/15to6/15:6/15to5/15:5/15to4/15:4/15to3/15:3/15to2/15:2/15to1/15:1/15to0/15:0/15to0/14:0/14to0/13:0/13to0/12:0/12to0/11:0/11to0/10:0/10to0/9:0/9to0/8:0/8to0/7:0/7to0/6:0/6to0/5:0/5to0/4:0/4to0/3:0/3to0/2:0/2to0/1:0/1to0/0:0/0tobottom0:,32,False,True
381,306,711,405,right0to15/0,0/15totop0,right0to15/0:15/0to14/0:14/0to13/0:13/0to12/0:12/0to11/0:11/0to10/0:10/0to9/0:9/0to8/0:8/0to7/0:7/0to6/0:6/0to5/0:5/0to4/0:4/0to3/0:3/0to2/0:2/0to1/0:1/0to0/0:0/0to0/1:0/1to0/2:0/2to0/3:0/3to0/4:0/4to0/5:0/5to0/6:0/6to0/7:0/7to0/8:0/8to0/9:0/9to0/10:0/10to0/11:0/11to0/12:0/12to0/13:0/13to0/14:0/14to0/15:0/15totop0:,32,True,True
2156,306,479,173,4/1to3/1,2/13to2/14,4/1to3/1:3/1to2/1:2/1to2/2:2/2to2/3:2/3to2/4:2/4to2/5:2/5to2/6:2/6to2/7:2/7to2/8:2/8to2/9:2/9to2/10:2/10to2/11:2/11to2/12:2/12to2/13:2/13to2/14:,15,False,True
2926,307,578,271,15/6to14/6,2/10to1/10,15/6to14/6:14/6to13/6:13/6to12/6:12/6to11/6:11/6to11/7:11/7to10/7:10/7to9/7:9/7to8/7:8/7to7/7:7/7to6/7:6/7to5/7:5/7to4/7:4/7to3/7:3/7to2/7:2/7to2/8:2/8to2/9:2/9to2/10:2/10to1/10:,18,True,True
2962,307,394,87,bottom1to1/0,4/3to5/3,bottom1to1/0:1/0to1/1:1/1to1/2:1/2to1/3:1/3to2/3:2/3to3/3:3/3to4/3:4/3to5/3:,8,False,True
1944,308,555,247,9/14to9/13,10/4to10/3,9/14to9/13:9/13to10/13:10/13to11/13:11/13to11/12:11/12to11/11:11/11to11/10:11/10to11/9:11/9to11/8:11/8to11/7:11/7to11/6:11/6to11/5:11/5to10/5:10/5to10/4:10/4to10/3:,14,True,True
2728,308,443,135,9/1to8/1,5/7to4/7,9/1to8/1:8/1to7/1:7/1to6/1:6/1to5/1:5/1to5/2:5/2to5/3:5/3to5/4:5/4to5/5:5/5to5/6:5/6to5/7:5/7to4/7:,11,True,True
2994,308,475,167,10/14to10/15,0/14toleft14,10/14to10/15:10/15to9/15:9/15to8/15:8/15to7/15:7/15to6/15:6/15to5/15:5/15to4/15:4/15to3/15:3/15to2/15:2/15to1/15:1/15to0/15:0/15to0/14:0/14toleft14:,13,False,True
1330,309,437,128,9/11to9/10,1/10to1/9,9/11to9/10:9/10to8/10:8/10to7/10:7/10to6/10:6/10to5/10:5/10to4/10:4/10to3/10:3/10to2/10:2/10to1/10:1/10to1/9:,10,True,True
2191,309,406,97,left10to0/10,2/15to3/15,left10to0/10:0/10to0/11:0/11to0/12:0/12to0/13:0/13to0/14:0/14to0/15:0/15to1/15:1/15to2/15:2/15to3/15:,9,False,True
3357,309,372,63,10/2to11/2,13/3to13/4,10/2to11/2:11/2to11/3:11/3to12/3:12/3to13/3:13/3to13/4:,5,False,True
2385,309,469,160,top9to9/15,10/4to10/3,top9to9/15:9/15to9/14:9/14to9/13:9/13to9/12:9/12to9/11:9/11to9/10:9/10to9/9:9/9to9/8:9/8to9/7:9/7to9/6:9/6to10/6:10/6to10/5:10/5to10/4:10/4to10/3:,14,True,True
2829,309,373,64,13/2to14/2,14/5to14/6,13/2to14/2:14/2to14/3:14/3to14/4:14/4to14/5:14/5to14/6:,5,False,True
635,310,574,264,15/1to15/2,1/5to0/5,15/1to15/2:15/2to14/2:14/2to13/2:13/2to12/2:12/2to11/2:11/2to10/2:10/2to9/2:9/2to8/2:8/2to7/2:7/2to6/2:6/2to5/2:5/2to4/2:4/2to3/2:3/2to2/2:2/2to1/2:1/2to1/3:1/3to1/4:1/4to1/5:1/5to0/5:,19,False,True
89,310,691,381,left15to0/15,15/0tobottom15,left15to0/15:0/15to0/14:0/14to0/13:0/13to0/12:0/12to0/11:0/11to0/10:0/10to0/9:0/9to0/8:0/8to0/7:0/7to0/6:0/6to0/5:0/5to0/4:0/4to0/3:0/3to0/2:0/2to0/1:0/1to0/0:0/0to1/0:1/0to2/0:2/0to3/0:3/0to4/0:4/0to5/0:5/0to6/0:6/0to7/0:7/0to8/0:8/0to9/0:9/0to10/0:10/0to11/0:11/0to12/0:12/0to13/0:13/0to14/0:14/0to15/0:15/0tobottom15:,32,True,True
845,310,381,71,1/9to1/8,3/7to4/7,1/9to1/8:1/8to1/7:1/7to2/7:2/7to3/7:3/7to4/7:,5,True,True
3180,310,387,77,left3to0/3,3/1to4/1,left3to0/3:0/3to0/2:0/2to0/1:0/1to1/1:1/1to2/1:2/1to3/1:3/1to4/1:,7,True,True
617,310,510,200,4/10to4/11,12/9to13/9,4/10to4/11:4/11to4/10:4/10to4/9:4/9to5/9:5/9to6/9:6/9to7/9:7/9to8/9:8/9to9/9:9/9to10/9:10/9to11/9:11/9to12/9:12/9to13/9:,12,True,True
2270,310,457,147,7/0to6/0,0/5toleft5,7/0to6/0:6/0to5/0:5/0to4/0:4/0to3/0:3/0to2/0:2/0to1/0:1/0to0/0:0/0to0/1:0/1to0/2:0/2to0/3:0/3to0/4:0/4to0/5:0/5toleft5:,13,True,True
1639,310,444,134,11/4to10/4,15/8to15/9,11/4to10/4:10/4to10/5:10/5to10/6:10/6to11/6:11/6to12/6:12/6to12/7:12/7to12/8:12/8to13/8:13/8to14/8:14/8to15/8:15/8to15/9:,11,True,True
1061,311,560,249,14/11to14/12,7/5to7/4,14/11to14/12:14/12to13/12:13/12to12/12:12/12to11/12:11/12to10/12:10/12to9/12:9/12to8/12:8/12to7/12:7/12to7/11:7/11to7/10:7/10to7/9:7/9to7/8:7/8to7/7:7/7to7/6:7/6to7/5:7/5to7/4:,16,False,True
3043,311,505,194,1/8to1/7,8/0to9/0,1/8to1/7:1/7to1/6:1/6to1/5:1/5to1/4:1/4to1/3:1/3to1/2:1/2to1/1:1/1to1/0:1/0to2/0:2/0to3/0:3/0to4/0:4/0to5/0:5/0to6/0:6/0to7/0:7/0to8/0:8/0to9/0:,16,True,True
130,311,707,396,left0to0/0,15/15totop15,left0to0/0:0/0to1/0:1/0to2/0:2/0to3/0:3/0to4/0:4/0to5/0:5/0to6/0:6/0to7/0:7/0to8/0:8/0to9/0:9/0to10/0:10/0to10/1:10/1to10/2:10/2to10/3:10/3to10/4:10/4to10/5:10/5to10/6:10/6to10/7:10/7to10/8:10/8to10/9:10/9to10/10:10/10to10/11:10/11to10/12:10/12to10/13:10/13to10/14:10/14to10/15:10/15to11/15:11/15to12/15:12/15to13/15:13/15to14/15:14/15to15/15:15/15totop15:,32,False,True
1422,312,407,95,9/3to9/4,12/7to13/7,9/3to9/4:9/4to9/5:9/5to10/5:10/5to10/6:10/6to11/6:11/6to12/6:12/6to12/7:12/7to13/7:,8,True,True
1686,312,479,167,8/13to8/12,4/4to3/4,8/13to8/12:8/12to7/12:7/12to6/12:6/12to5/12:5/12to4/12:4/12to4/11:4/11to4/10:4/10to4/9:4/9to4/8:4/8to4/7:4/7to4/6:4/6to4/5:4/5to4/4:4/4to3/4:,14,True,True
2450,313,489,176,10/9to10/8,1/11to1/12,10/9to10/8:10/8to9/8:9/8to8/8:8/8to7/8:7/8to6/8:6/8to5/8:5/8to4/8:4/8to3/8:3/8to2/8:2/8to1/8:1/8to1/9:1/9to1/10:1/10to1/11:1/11to1/12:,14,True,True
880,313,507,194,1/11to2/11,11/13to11/12,1/11to2/11:2/11to3/11:3/11to4/11:4/11to5/11:5/11to6/11:6/11to7/11:7/11to8/11:8/11to9/11:9/11to10/11:10/11to10/12:10/12to11/12:11/12to11/13:11/13to11/12:,13,True,True
3226,313,536,223,13/3to12/3,7/15totop7,13/3to12/3:12/3to11/3:11/3to11/4:11/4to10/4:10/4to9/4:9/4to8/4:8/4to7/4:7/4to7/5:7/5to7/6:7/6to7/7:7/7to7/8:7/8to7/9:7/9to7/10:7/10to7/11:7/11to7/12:7/12to7/13:7/13to7/14:7/14to7/15:7/15totop7:,19,True,True
2641,313,561,248,12/6to11/6,3/0to4/0,12/6to11/6:11/6to10/6:10/6to9/6:9/6to8/6:8/6to7/6:7/6to6/6:6/6to5/6:5/6to4/6:4/6to3/6:3/6to3/5:3/5to3/4:3/4to3/3:3/3to3/2:3/2to3/1:3/1to3/0:3/0to4/0:,16,False,True
2998,314,362,48,10/12to9/12,8/11to8/10,10/12to9/12:9/12to8/12:8/12to8/11:8/11to8/10:,4,False,True
2271,315,425,110,15/9to14/9,12/4to13/4,15/9to14/9:14/9to13/9:13/9to12/9:12/9to12/8:12/8to12/7:12/7to12/6:12/6to12/5:12/5to12/4:12/4to13/4:,9,False,True
2403,315,542,227,9/11to10/11,15/0toright0,9/11to10/11:10/11to10/10:10/10to10/9:10/9to10/8:10/8to10/7:10/7to10/6:10/6to10/5:10/5to10/4:10/4to10/3:10/3to10/2:10/2to10/1:10/1to10/0:10/0to11/0:11/0to12/0:12/0to13/0:13/0to14/0:14/0to15/0:15/0toright0:,18,False,True
3244,315,513,198,5/3to6/3,11/12to12/12,5/3to6/3:6/3to7/3:7/3to8/3:8/3to9/3:9/3to10/3:10/3to10/4:10/4to10/5:10/5to10/6:10/6to10/7:10/7to10/8:10/8to10/9:10/9to10/10:10/10to10/11:10/11to10/12:10/12to11/12:11/12to12/12:,16,False,True
619,315,440,125,7/6to7/7,3/3to2/3,7/6to7/7:7/7to6/7:6/7to5/7:5/7to4/7:4/7to3/7:3/7to3/6:3/6to3/5:3/5to3/4:3/4to3/3:3/3to2/3:,10,True,True
2715,315,448,133,8/3to7/3,6/11to6/12,8/3to7/3:7/3to6/3:6/3to6/4:6/4to6/5:6/5to6/6:6/6to6/7:6/7to6/8:6/8to6/9:6/9to6/10:6/10to6/11:6/11to6/12:,11,True,True
1879,315,415,100,6/1to7/1,9/5to10/5,6/1to7/1:7/1to7/2:7/2to7/3:7/3to7/4:7/4to7/5:7/5to8/5:8/5to9/5:9/5to10/5:,8,False,True
1109,317,556,239,13/3to13/2,5/10to5/11,13/3to13/2:13/2to12/2:12/2to11/2:11/2to10/2:10/2to9/2:9/2to8/2:8/2to7/2:7/2to6/2:6/2to5/2:5/2to5/3:5/3to5/4:5/4to5/5:5/5to5/6:5/6to5/7:5/7to5/8:5/8to5/9:5/9to5/10:5/10to5/11:,18,False,True
1263,317,455,138,6/2to7/2,12/4to13/4,6/2to7/2:7/2to8/2:8/2to9/2:9/2to10/2:10/2to10/3:10/3to10/4:10/4to11/4:11/4to12/4:12/4to13/4:,9,False,True
2380,317,423,106,11/14to11/13,11/8to12/8,11/14to11/13:11/13to11/12:11/12to11/11:11/11to12/11:12/11to12/10:12/10to12/9:12/9to11/9:11/9to11/8:11/8to12/8:,9,True,True
2350,317,601,284,right6to15/6,1/3to1/2,right6to15/6:15/6to14/6:14/6to13/6:13/6to12/6:12/6to11/6:11/6to10/6:10/6to9/6:9/6to8/6:8/6to7/6:7/6to6/6:6/6to5/6:5/6to4/6:4/6to3/6:3/6to2/6:2/6to1/6:1/6to1/5:1/5to1/4:1/4to1/3:1/3to1/2:,19,False,True
2630,318,519,201,9/1to8/1,4/12to4/13,9/1to8/1:8/1to7/1:7/1to6/1:6/1to5/1:5/1to4/1:4/1to4/2:4/2to4/3:4/3to4/4:4/4to4/5:4/5to4/6:4/6to4/7:4/7to4/8:4/8to4/9:4/9to4/10:4/10to4/11:4/11to4/12:4/12to4/13:,17,True,True
42,318,709,391,left15to0/15,15/0tobottom15,left15to0/15:0/15to0/14:0/14to0/13:0/13to0/12:0/12to0/11:0/11to0/10:0/10to0/9:0/9to0/8:0/8to0/7:0/7to0/6:0/6to0/5:0/5to0/4:0/4to0/3:0/3to0/2:0/2to0/1:0/1to0/0:0/0to1/0:1/0to2/0:2/0to3/0:3/0to4/0:4/0to5/0:5/0to6/0:6/0to7/0:7/0to8/0:8/0to9/0:9/0to10/0:10/0to11/0:11/0to12/0:12/0to13/0:13/0to14/0:14/0to15/0:15/0tobottom15:,32,True,True
2512,318,369,51,6/12to5/12,5/10to6/10,6/12to5/12:5/12to5/11:5/11to5/10:5/10to6/10:,4,False,True
2633,318,459,141,1/0to2/0,11/0tobottom11,1/0to2/0:2/0to3/0:3/0to4/0:4/0to5/0:5/0to6/0:6/0to7/0:7/0to8/0:8/0to9/0:9/0to10/0:10/0to11/0:11/0tobottom11:,11,False,True
910,318,427,109,0/9to0/8,6/8to7/8,0/9to0/8:0/8to1/8:1/8to2/8:2/8to3/8:3/8to4/8:4/8to5/8:5/8to6/8:6/8to7/8:,8,True,True
1351,318,536,218,12/8to12/7,1/8to1/9,12/8to12/7:12/7to11/7:11/7to10/7:10/7to9/7:9/7to8/7:8/7to7/7:7/7to6/7:6/7to5/7:5/7to4/7:4/7to3/7:3/7to2/7:2/7to1/7:1/7to1/8:1/8to1/9:,14,True,True
112,319,802,483,left0to0/0,15/15totop15,left0to0/0:0/0to0/1:0/1to0/2:0/2to0/3:0/3to0/4:0/4to0/5:0/5to0/6:0/6to0/7:0/7to0/8:0/8to0/9:0/9to0/10:0/10to0/11:0/11to0/12:0/12to0/13:0/13to0/14:0/14to1/14:1/14to2/14:2/14to3/14:3/14to4/14:4/14to5/14:5/14to6/14:6/14to7/14:7/14to8/14:8/14to9/14:9/14to10/14:10/14to10/15:10/15to11/15:11/15to12/15:12/15to13/15:13/15to14/15:14/15to15/15:15/15totop15:,32,True,True
82,319,706,387,left15to0/15,15/0tobottom15,left15to0/15:0/15to1/15:1/15to2/15:2/15to3/15:3/15to4/15:4/15to5/15:5/15to6/15:6/15to7/15:7/15to8/15:8/15to9/15:9/15to10/15:10/15to10/14:10/14to10/13:10/13to10/12:10/12to10/11:10/11to10/10:10/10to10/9:10/9to10/8:10/8to10/7:10/7to10/6:10/6to10/5:10/5to10/4:10/4to10/3:10/3to10/2:10/2to10/1:10/1to10/0:10/0to11/0:11/0to12/0:12/0to13/0:13/0to14/0:14/0to15/0:15/0tobottom15:,32,False,True
187,319,713,394,left0to0/0,15/15totop15,left0to0/0:0/0to1/0:1/0to2/0:2/0to3/0:3/0to4/0:4/0to5/0:5/0to6/0:6/0to7/0:7/0to8/0:8/0to9/0:9/0to10/0:10/0to10/1:10/1to10/2:10/2to10/3:10/3to10/4:10/4to10/5:10/5to10/6:10/6to10/7:10/7to10/8:10/8to10/9:10/9to10/10:10/10to10/11:10/11to10/12:10/12to10/13:10/13to10/14:10/14to10/15:10/15to11/15:11/15to12/15:12/15to13/15:13/15to14/15:14/15to15/15:15/15totop15:,32,False,True
1516,319,331,12,7/9to7/10,7/9to7/10,7/9to7/10:,1,False,True
883,320,660,340,14/15to14/14,1/5to0/5,14/15to14/14:14/14to13/14:13/14to12/14:12/14to11/14:11/14to10/14:10/14to9/14:9/14to8/14:8/14to7/14:7/14to6/14:6/14to5/14:5/14to4/14:4/14to3/14:3/14to2/14:2/14to1/14:1/14to1/13:1/13to1/12:1/12to1/11:1/11to1/10:1/10to1/9:1/9to1/8:1/8to1/7:1/7to1/6:1/6to1/5:1/5to0/5:,24,False,True
3340,320,472,152,13/3to12/3,12/15totop12,13/3to12/3:12/3to12/4:12/4to12/5:12/5to12/6:12/6to12/7:12/7to12/8:12/8to12/9:12/9to12/10:12/10to12/11:12/11to12/12:12/12to12/13:12/13to12/14:12/14to12/15:12/15totop12:,14,False,True
2676,320,572,252,9/4to9/3,2/15totop2,9/4to9/3:9/3to8/3:8/3to7/3:7/3to6/3:6/3to5/3:5/3to4/3:4/3to3/3:3/3to2/3:2/3to2/4:2/4to2/5:2/5to2/6:2/6to2/7:2/7to2/8:2/8to2/9:2/9to2/10:2/10to2/11:2/11to2/12:2/12to2/13:2/13to2/14:2/14to2/15:2/15totop2:,21,False,True
2674,320,438,118,8/0to9/0,14/2to14/3,8/0to9/0:9/0to10/0:10/0to10/1:10/1to10/2:10/2to11/2:11/2to12/2:12/2to13/2:13/2to14/2:14/2to14/3:,9,False,True
2400,320,435,115,8/2to8/3,9/10to9/11,8/2to8/3:8/3to8/4:8/4to8/5:8/5to8/6:8/6to8/7:8/7to8/8:8/8to8/9:8/9to8/10:8/10to9/10:9/10to9/11:,10,True,True
1149,321,466,145,2/6to2/7,9/9to9/10,2/6to2/7:2/7to2/8:2/8to2/9:2/9to3/9:3/9to4/9:4/9to5/9:5/9to6/9:6/9to7/9:7/9to8/9:8/9to9/9:9/9to9/10:,11,False,True
284,321,753,432,right15to15/15,0/0tobottom0,right15to15/15:15/15to14/15:14/15to13/15:13/15to12/15:12/15to11/15:11/15to10/15:10/15to9/15:9/15to8/15:8/15to7/15:7/15to6/15:6/15to5/15:5/15to4/15:4/15to3/15:3/15to2/15:2/15to1/15:1/15to0/15:0/15to0/14:0/14to0/13:0/13to0/12:0/12to0/11:0/11to0/10:0/10to0/9:0/9to0/8:0/8to0/7:0/7to0/6:0/6to0/5:0/5to0/4:0/4to0/3:0/3to0/2:0/2to0/1:0/1to0/0:0/0tobottom0:,32,True,True
2602,321,507,186,8/7to8/8,2/15to1/15,8/7to8/8:8/8to7/8:7/8to6/8:6/8to5/8:5/8to4/8:4/8to3/8:3/8to2/8:2/8to2/9:2/9to2/10:2/10to2/11:2/11to2/12:2/12to2/13:2/13to2/14:2/14to2/15:2/15to1/15:,15,True,True
2361,322,489,167,8/10to8/11,7/0to6/0,8/10to8/11:8/11to7/11:7/11to7/10:7/10to7/9:7/9to7/8:7/8to7/7:7/7to7/6:7/6to7/5:7/5to7/4:7/4to7/3:7/3to7/2:7/2to7/1:7/1to7/0:7/0to6/0:,14,True,True
1227,322,466,144,13/13to12/13,10/6to10/5,13/13to12/13:12/13to12/12:12/12to12/11:12/11to12/10:12/10to12/9:12/9to12/8:12/8to12/7:12/7to12/6:12/6to11/6:11/6to10/6:10/6to10/5:,11,True,True
540,322,479,157,3/6to4/6,6/15to7/15,3/6to4/6:4/6to4/7:4/7to4/8:4/8to4/9:4/9to4/10:4/10to4/11:4/11to4/12:4/12to4/13:4/13to4/14:4/14to4/15:4/15to5/15:5/15to6/15:6/15to7/15:,13,True,True
2476,322,515,193,13/0to12/0,10/12to9/12,13/0to12/0:12/0to12/1:12/1to12/2:12/2to12/3:12/3to12/4:12/4to12/5:12/5to12/6:12/6to12/7:12/7to12/8:12/8to12/9:12/9to12/10:12/10to12/11:12/11to11/11:11/11to10/11:10/11to10/12:10/12to9/12:,16,True,True
100,322,759,437,left0to0/0,15/15totop15,left0to0/0:0/0to0/1:0/1to0/2:0/2to0/3:0/3to0/4:0/4to0/5:0/5to0/6:0/6to0/7:0/7to0/8:0/8to0/9:0/9to0/10:0/10to0/11:0/11to0/12:0/12to0/13:0/13to1/13:1/13to2/13:2/13to3/13:3/13to4/13:4/13to5/13:5/13to6/13:6/13to7/13:7/13to8/13:8/13to9/13:9/13to10/13:10/13to10/14:10/14to11/14:11/14to11/15:11/15to12/15:12/15to13/15:13/15to14/15:14/15to15/15:15/15totop15:,32,True,True
2823,322,453,131,9/9to10/9,12/4to13/4,9/9to10/9:10/9to10/8:10/8to10/7:10/7to11/7:11/7to11/6:11/6to11/5:11/5to11/4:11/4to12/4:12/4to13/4:,9,True,True
229,322,748,426,right15to15/15,0/0tobottom0,right15to15/15:15/15to14/15:14/15to13/15:13/15to12/15:12/15to11/15:11/15to11/14:11/14to10/14:10/14to9/14:9/14to8/14:8/14to7/14:7/14to6/14:6/14to5/14:5/14to4/14:4/14to3/14:3/14to2/14:2/14to1/14:1/14to0/14:0/14to0/13:0/13to0/12:0/12to0/11:0/11to0/10:0/10to0/9:0/9to0/8:0/8to0/7:0/7to0/6:0/6to0/5:0/5to0/4:0/4to0/3:0/3to0/2:0/2to0/1:0/1to0/0:0/0tobottom0:,32,True,True
1203,323,557,234,2/7to2/8,12/4to13/4,2/7to2/8:2/8to3/8:3/8to4/8:4/8to5/8:5/8to6/8:6/8to7/8:7/8to8/8:8/8to9/8:9/8to10/8:10/8to10/7:10/7to10/6:10/6to10/5:10/5to10/4:10/4to11/4:11/4to12/4:12/4to13/4:,16,False,True
3154,323,396,73,8/3to8/4,10/2to9/2,8/3to8/4:8/4to8/3:8/3to9/3:9/3to10/3:10/3to10/2:10/2to9/2:,6,True,True
226,324,762,438,right15to15/15,0/0tobottom0,right15to15/15:15/15to14/15:14/15to13/15:13/15to12/15:12/15to11/15:11/15to10/15:10/15to9/15:9/15to8/15:8/15to7/15:7/15to6/15:6/15to5/15:5/15to4/15:4/15to3/15:3/15to2/15:2/15to1/15:1/15to0/15:0/15to0/14:0/14to0/13:0/13to0/12:0/12to0/11:0/11to0/10:0/10to0/9:0/9to0/8:0/8to0/7:0/7to0/6:0/6to0/5:0/5to0/4:0/4to0/3:0/3to0/2:0/2to0/1:0/1to0/0:0/0tobottom0:,32,True,True
152,324,803,479,left0to0/0,15/15totop15,left0to0/0:0/0to0/1:0/1to0/2:0/2to0/3:0/3to0/4:0/4to0/5:0/5to0/6:0/6to0/7:0/7to0/8:0/8to0/9:0/9to0/10:0/10to0/11:0/11to0/12:0/12to0/13:0/13to0/14:0/14to1/14:1/14to2/14:2/14to3/14:3/14to4/14:4/14to5/14:5/14to6/14:6/14to7/14:7/14to8/14:8/14to9/14:9/14to10/14:10/14to10/15:10/15to11/15:11/15to12/15:12/15to13/15:13/15to14/15:14/15to15/15:15/15totop15:,32,True,True
2368,324,454,130,14/12to13/12,13/3to14/3,14/12to13/12:13/12to13/11:13/11to13/10:13/10to13/9:13/9to13/8:13/8to13/7:13/7to13/6:13/6to13/5:13/5to13/4:13/4to13/3:13/3to14/3:,11,False,True
2718,324,578,254,12/6to12/7,3/13to3/14,12/6to12/7:12/7to11/7:11/7to10/7:10/7to9/7:9/7to8/7:8/7to7/7:7/7to6/7:6/7to5/7:5/7to4/7:4/7to3/7:3/7to3/8:3/8to3/9:3/9to3/10:3/10to3/11:3/11to3/12:3/12to3/13:3/13to3/14:,17,False,True
628,325,519,194,9/13to9/14,13/4to13/3,9/13to9/14:9/14to10/14:10/14to10/13:10/13to10/12:10/12to10/11:10/11to10/10:10/10to10/9:10/9to10/8:10/8to10/7:10/7to10/6:10/6to10/5:10/5to10/4:10/4to11/4:11/4to12/4:12/4to13/4:13/4to13/3:,16,False,True
1737,325,472,147,8/12to8/11,13/13to13/12,8/12to8/11:8/11to8/12:8/12to8/13:8/13to9/13:9/13to10/13:10/13to11/13:11/13to12/13:12/13to13/13:13/13to13/12:,9,True,True
128,326,816,490,left0to0/0,15/15totop15,left0to0/0:0/0to0/1:0/1to0/2:0/2to0/3:0/3to0/4:0/4to0/5:0/5to0/6:0/6to0/7:0/7to0/8:0/8to0/9:0/9to0/10:0/10to0/11:0/11to0/12:0/12to0/13:0/13to0/14:0/14to1/14:1/14to2/14:2/14to3/14:3/14to4/14:4/14to5/14:5/14to6/14:6/14to7/14:7/14to8/14:8/14to9/14:9/14to10/14:10/14to10/15:10/15to11/15:11/15to12/15:12/15to13/15:13/15to14/15:14/15to15/15:15/15totop15:,32,True,True
2902,326,494,168,11/1to11/2,5/7to4/7,11/1to11/2:11/2to10/2:10/2to9/2:9/2to8/2:8/2to7/2:7/2to6/2:6/2to5/2:5/2to5/3:5/3to5/4:5/4to5/5:5/5to5/6:5/6to5/7:5/7to4/7:,13,True,True
640,326,454,128,1/14to1/13,7/11to8/11,1/14to1/13:1/13to1/12:1/12to1/11:1/11to2/11:2/11to3/11:3/11to4/11:4/11to5/11:5/11to6/11:6/11to7/11:7/11to8/11:,10,False,True
2165,326,365,39,14/3to15/3,15/1toright1,14/3to15/3:15/3to15/2:15/2to15/1:15/1toright1:,4,True,True
2397,327,351,24,14/9to13/9,13/9to12/9,14/9to13/9:13/9to12/9:,2,True,True
2542,327,412,85,10/5to11/5,12/0tobottom12,10/5to11/5:11/5to11/4:11/4to11/3:11/3to11/2:11/2to11/1:11/1to11/0:11/0to12/0:12/0tobottom12:,8,False,True
2274,327,545,218,12/1to12/0,1/3to0/3,12/1to12/0:12/0to11/0:11/0to10/0:10/0to9/0:9/0to8/0:8/0to7/0:7/0to6/0:6/0to5/0:5/0to4/0:4/0to3/0:3/0to2/0:2/0to1/0:1/0to1/1:1/1to1/2:1/2to1/3:1/3to0/3:,16,True,True
916,327,510,183,top15to15/15,10/7to10/6,top15to15/15:15/15to14/15:14/15to13/15:13/15to12/15:12/15to12/14:12/14to12/13:12/13to12/12:12/12to12/11:12/11to12/10:12/10to12/9:12/9to11/9:11/9to10/9:10/9to10/8:10/8to10/7:10/7to10/6:,15,True,True
2158,328,507,179,2/5to1/5,7/11to7/12,2/5to1/5:1/5to1/6:1/6to1/7:1/7to1/8:1/8to1/9:1/9to1/10:1/10to1/11:1/11to2/11:2/11to3/11:3/11to4/11:4/11to5/11:5/11to6/11:6/11to7/11:7/11to7/12:,14,False,True
1390,328,351,23,1/9to1/10,1/10to1/9,1/9to1/10:1/10to1/9:,2,False,True
1437,328,537,209,12/12to12/13,1/15totop1,12/12to12/13:12/13to12/14:12/14to11/14:11/14to10/14:10/14to9/14:9/14to8/14:8/14to7/14:7/14to6/14:6/14to5/14:5/14to4/14:4/14to3/14:3/14to2/14:2/14to1/14:1/14to1/15:1/15totop1:,15,True,True
2266,328,497,169,3/5to2/5,0/15totop0,3/5to2/5:2/5to1/5:1/5to0/5:0/5to0/6:0/6to0/7:0/7to0/8:0/8to0/9:0/9to0/10:0/10to0/11:0/11to0/12:0/12to0/13:0/13to0/14:0/14to0/15:0/15totop0:,14,True,True
2562,328,448,120,1/3to1/4,0/10toleft10,1/3to1/4:1/4to0/4:0/4to0/5:0/5to0/6:0/6to0/7:0/7to0/8:0/8to0/9:0/9to0/10:0/10toleft10:,9,False,True
2634,329,466,137,10/11to10/10,5/13to5/14,10/11to10/10:10/10to9/10:9/10to8/10:8/10to7/10:7/10to6/10:6/10to5/10:5/10to5/11:5/11to5/12:5/12to5/13:5/13to5/14:,10,False,True
1069,330,506,176,4/9to4/10,0/8toleft8,4/9to4/10:4/10to3/10:3/10to2/10:2/10to1/10:1/10to0/10:0/10to0/9:0/9to0/8:0/8toleft8:,8,False,True
2481,331,688,357,1/12to1/13,15/1toright1,1/12to1/13:1/13to1/12:1/12to1/11:1/11to1/10:1/10to1/9:1/9to1/8:1/8to1/7:1/7to1/6:1/6to1/5:1/5to1/4:1/4to1/3:1/3to1/2:1/2to2/2:2/2to3/2:3/2to4/2:4/2to5/2:5/2to6/2:6/2to7/2:7/2to8/2:8/2to9/2:9/2to10/2:10/2to10/1:10/1to11/1:11/1to12/1:12/1to13/1:13/1to14/1:14/1to15/1:15/1toright1:,28,True,True
2515,331,437,106,10/13to9/13,7/8to6/8,10/13to9/13:9/13to8/13:8/13to7/13:7/13to7/12:7/12to7/11:7/11to7/10:7/10to7/9:7/9to7/8:7/8to6/8:,9,True,True
2571,332,600,268,12/3to11/3,0/10toleft10,12/3to11/3:11/3to10/3:10/3to9/3:9/3to8/3:8/3to7/3:7/3to6/3:6/3to5/3:5/3to4/3:4/3to3/3:3/3to2/3:2/3to1/3:1/3to0/3:0/3to0/4:0/4to0/5:0/5to0/6:0/6to0/7:0/7to0/8:0/8to0/9:0/9to0/10:0/10toleft10:,20,True,True
611,332,593,261,right1to15/1,6/12to6/13,right1to15/1:15/1to14/1:14/1to13/1:13/1to12/1:12/1to11/1:11/1to10/1:10/1to9/1:9/1to8/1:8/1to7/1:7/1to6/1:6/1to6/2:6/2to6/3:6/3to6/4:6/4to6/5:6/5to6/6:6/6to6/7:6/7to6/8:6/8to6/9:6/9to6/10:6/10to6/11:6/11to6/12:6/12to6/13:,22,True,True
632,333,514,181,7/1to7/0,6/13to6/14,7/1to7/0:7/0to6/0:6/0to6/1:6/1to6/2:6/2to6/3:6/3to6/4:6/4to6/5:6/5to6/6:6/6to6/7:6/7to6/8:6/8to6/9:6/9to6/10:6/10to6/11:6/11to6/12:6/12to6/13:6/13to6/14:,16,False,True
271,333,753,420,right15to15/15,0/0tobottom0,right15to15/15:15/15to14/15:14/15to13/15:13/15to12/15:12/15to11/15:11/15to10/15:10/15to9/15:9/15to8/15:8/15to7/15:7/15to6/15:6/15to5/15:5/15to4/15:4/15to3/15:3/15to2/15:2/15to1/15:1/15to0/15:0/15to0/14:0/14to0/13:0/13to0/12:0/12to0/11:0/11to0/10:0/10to0/9:0/9to0/8:0/8to0/7:0/7to0/6:0/6to0/5:0/5to0/4:0/4to0/3:0/3to0/2:0/2to0/1:0/1to0/0:0/0tobottom0:,32,False,True
1295,334,665,331,15/2to14/2,3/15totop3,15/2to14/2:14/2to13/2:13/2to12/2:12/2to11/2:11/2to10/2:10/2to9/2:9/2to8/2:8/2to7/2:7/2to6/2:6/2to5/2:5/2to4/2:4/2to3/2:3/2to3/3:3/3to3/4:3/4to3/5:3/5to3/6:3/6to3/7:3/7to3/8:3/8to3/9:3/9to3/10:3/10to3/11:3/11to3/12:3/12to3/13:3/13to3/14:3/14to3/15:3/15totop3:,26,False,True
3164,334,396,62,14/11to15/11,15/15toright15,14/11to15/11:15/11to15/12:15/12to15/13:15/13to15/14:15/14to15/15:15/15toright15:,6,True,True
3136,334,492,158,11/5to11/6,4/5to5/5,11/5to11/6:11/6to10/6:10/6to9/6:9/6to8/6:8/6to7/6:7/6to6/6:6/6to5/6:5/6to4/6:4/6to4/5:4/5to5/5:,10,False,True
3015,334,562,228,12/13to12/14,6/4to6/3,12/13to12/14:12/14to11/14:11/14to10/14:10/14to9/14:9/14to8/14:8/14to7/14:7/14to6/14:6/14to6/13:6/13to6/12:6/12to6/11:6/11to6/10:6/10to6/9:6/9to6/8:6/8to6/7:6/7to6/6:6/6to6/5:6/5to6/4:6/4to6/3:,18,True,True
615,335,479,144,4/13to4/14,12/14to12/15,4/13to4/14:4/14to5/14:5/14to6/14:6/14to7/14:7/14to8/14:8/14to9/14:9/14to10/14:10/14to11/14:11/14to12/14:12/14to12/15:,10,False,True
2910,335,510,175,3/0to2/0,0/11toleft11,3/0to2/0:2/0to1/0:1/0to0/0:0/0to0/1:0/1to0/2:0/2to0/3:0/3to0/4:0/4to0/5:0/5to0/6:0/6to0/7:0/7to0/8:0/8to0/9:0/9to0/10:0/10to0/11:0/11toleft11:,15,False,True
2525,335,498,163,1/15to2/15,4/6to4/7,1/15to2/15:2/15to2/14:2/14to2/13:2/13to2/12:2/12to2/11:2/11to2/10:2/10to2/9:2/9to2/8:2/8to2/7:2/7to2/6:2/6to3/6:3/6to4/6:4/6to4/7:,13,False,True
1325,336,386,50,top1to1/15,1/12to1/11,top1to1/15:1/15to1/14:1/14to1/13:1/13to1/12:1/12to1/11:,5,True,True
2503,336,419,83,10/12to9/12,7/15to8/15,10/12to9/12:9/12to8/12:8/12to7/12:7/12to7/13:7/13to7/14:7/14to7/15:7/15to8/15:,7,True,True
780,336,376,40,11/2to11/1,12/0tobottom12,11/2to11/1:11/1to11/0:11/0to12/0:12/0tobottom12:,4,True,True
2126,337,494,157,0/4to1/4,9/5to9/4,0/4to1/4:1/4to1/5:1/5to2/5:2/5to3/5:3/5to4/5:4/5to5/5:5/5to6/5:6/5to7/5:7/5to8/5:8/5to9/5:9/5to9/4:,11,True,True
2663,337,549,212,12/12to12/13,0/14toleft14,12/12to12/13:12/13to12/14:12/14to11/14:11/14to10/14:10/14to9/14:9/14to8/14:8/14to7/14:7/14to6/14:6/14to5/14:5/14to4/14:4/14to3/14:3/14to2/14:2/14to1/14:1/14to0/14:0/14toleft14:,15,True,True
2118,337,546,209,right15to15/15,0/15toleft15,right15to15/15:15/15to14/15:14/15to13/15:13/15to12/15:12/15to11/15:11/15to10/15:10/15to9/15:9/15to8/15:8/15to7/15:7/15to6/15:6/15to5/15:5/15to4/15:4/15to3/15:3/15to2/15:2/15to1/15:1/15to0/15:0/15toleft15:,17,True,True
1272,338,414,76,1/10to1/11,0/15totop0,1/10to1/11:1/11to0/11:0/11to0/12:0/12to0/13:0/13to0/14:0/14to0/15:0/15totop0:,7,True,True
256,338,756,418,right15to15/15,0/0tobottom0,right15to15/15:15/15to14/15:14/15to13/15:13/15to12/15:12/15to11/15:11/15to10/15:10/15to9/15:9/15to8/15:8/15to7/15:7/15to6/15:6/15to5/15:5/15to4/15:4/15to3/15:3/15to2/15:2/15to1/15:1/15to0/15:0/15to0/14:0/14to0/13:0/13to0/12:0/12to0/11:0/11to0/10:0/10to0/9:0/9to0/8:0/8to0/7:0/7to0/6:0/6to0/5:0/5to0/4:0/4to0/3:0/3to0/2:0/2to0/1:0/1to0/0:0/0tobottom0:,32,False,True
1522,338,660,322,1/15to2/15,12/1to12/2,1/15to2/15:2/15to3/15:3/15to4/15:4/15to5/15:5/15to6/15:6/15to7/15:7/15to8/15:8/15to9/15:9/15to10/15:10/15to10/14:10/14to10/13:10/13to10/12:10/12to10/11:10/11to10/10:10/10to10/9:10/9to10/8:10/8to10/7:10/7to10/6:10/6to10/5:10/5to10/4:10/4to10/3:10/3to10/2:10/2to10/1:10/1to11/1:11/1to12/1:12/1to12/2:,26,False,True
22,339,713,374,left15to0/15,15/0tobottom15,left15to0/15:0/15to1/15:1/15to2/15:2/15to3/15:3/15to4/15:4/15to5/15:5/15to6/15:6/15to7/15:7/15to8/15:8/15to9/15:9/15to10/15:10/15to10/14:10/14to10/13:10/13to10/12:10/12to10/11:10/11to10/10:10/10to10/9:10/9to10/8:10/8to10/7:10/7to10/6:10/6to10/5:10/5to10/4:10/4to10/3:10/3to10/2:10/2to10/1:10/1to10/0:10/0to11/0:11/0to12/0:12/0to13/0:13/0to14/0:14/0to15/0:15/0tobottom15:,32,False,True
3171,339,511,172,2/1to3/1,6/10to6/9,2/1to3/1:3/1to3/2:3/2to3/3:3/3to3/4:3/4to3/5:3/5to3/6:3/6to3/7:3/7to3/8:3/8to3/9:3/9to3/10:3/10to4/10:4/10to5/10:5/10to6/10:6/10to6/9:,14,False,True
1808,340,448,108,8/5to8/6,4/9to5/9,8/5to8/6:8/6to7/6:7/6to6/6:6/6to5/6:5/6to4/6:4/6to4/7:4/7to4/8:4/8to4/9:4/9to5/9:,9,False,True
1489,340,639,299,2/3to2/2,14/12to15/12,2/3to2/2:2/2to3/2:3/2to4/2:4/2to5/2:5/2to6/2:6/2to7/2:7/2to8/2:8/2to9/2:9/2to10/2:10/2to10/3:10/3to10/4:10/4to10/5:10/5to10/6:10/6to10/7:10/7to10/8:10/8to10/9:10/9to10/10:10/10to10/11:10/11to10/12:10/12to11/12:11/12to12/12:12/12to13/12:13/12to14/12:14/12to15/12:,24,False,True
3014,340,560,220,9/4to9/3,0/7toleft7,9/4to9/3:9/3to8/3:8/3to7/3:7/3to6/3:6/3to5/3:5/3to4/3:4/3to3/3:3/3to2/3:2/3to1/3:1/3to0/3:0/3to0/4:0/4to0/5:0/5to0/6:0/6to0/7:0/7toleft7:,15,True,True
604,340,516,176,14/6to13/6,8/10to8/11,14/6to13/6:13/6to12/6:12/6to11/6:11/6to10/6:10/6to9/6:9/6to8/6:8/6to8/7:8/7to8/8:8/8to8/9:8/9to8/10:8/10to8/11:,11,True,True
1271,340,568,228,2/10to3/10,10/2to9/2,2/10to3/10:3/10to4/10:4/10to5/10:5/10to6/10:6/10to7/10:7/10to8/10:8/10to9/10:9/10to10/10:10/10to10/9:10/9to10/8:10/8to10/7:10/7to10/6:10/6to10/5:10/5to10/4:10/4to10/3:10/3to10/2:10/2to9/2:,17,False,True
3092,341,388,47,3/7to3/6,3/4to3/3,3/7to3/6:3/6to3/5:3/5to3/4:3/4to3/3:,4,False,True
1867,341,467,126,2/12to2/13,8/15totop8,2/12to2/13:2/13to2/14:2/14to2/15:2/15to3/15:3/15to4/15:4/15to5/15:5/15to6/15:6/15to7/15:7/15to8/15:8/15totop8:,10,True,True
2081,342,591,249,12/1to11/1,5/12to4/12,12/1to11/1:11/1to10/1:10/1to9/1:9/1to8/1:8/1to7/1:7/1to6/1:6/1to5/1:5/1to5/2:5/2to5/3:5/3to5/4:5/4to5/5:5/5to5/6:5/6to5/7:5/7to5/8:5/8to5/9:5/9to5/10:5/10to5/11:5/11to5/12:5/12to4/12:,19,False,True
1253,342,666,324,0/14to1/14,13/4to14/4,0/14to1/14:1/14to2/14:2/14to3/14:3/14to4/14:4/14to5/14:5/14to6/14:6/14to7/14:7/14to8/14:8/14to9/14:9/14to10/14:10/14to10/13:10/13to10/12:10/12to10/11:10/11to10/10:10/10to10/9:10/9to10/8:10/8to10/7:10/7to10/6:10/6to10/5:10/5to10/4:10/4to11/4:11/4to12/4:12/4to13/4:13/4to14/4:,24,False,True
2708,342,520,178,4/10to5/10,15/8toright8,4/10to5/10:5/10to5/9:5/9to6/9:6/9to7/9:7/9to8/9:8/9to9/9:9/9to10/9:10/9to10/8:10/8to11/8:11/8to12/8:12/8to13/8:13/8to14/8:14/8to15/8:15/8toright8:,14,True,True
2636,343,586,243,15/3to14/3,3/7to3/8,15/3to14/3:14/3to13/3:13/3to12/3:12/3to11/3:11/3to10/3:10/3to9/3:9/3to8/3:8/3to7/3:7/3to6/3:6/3to5/3:5/3to4/3:4/3to3/3:3/3to3/4:3/4to3/5:3/5to3/6:3/6to3/7:3/7to3/8:,17,False,True
3334,343,417,74,10/6to9/6,8/3to9/3,10/6to9/6:9/6to8/6:8/6to8/5:8/5to8/4:8/4to8/3:8/3to9/3:,6,False,True
184,344,757,413,left0to0/0,15/15totop15,left0to0/0:0/0to1/0:1/0to2/0:2/0to3/0:3/0to4/0:4/0to5/0:5/0to6/0:6/0to7/0:7/0to8/0:8/0to9/0:9/0to10/0:10/0to10/1:10/1to10/2:10/2to10/3:10/3to10/4:10/4to10/5:10/5to10/6:10/6to10/7:10/7to10/8:10/8to10/9:10/9to10/10:10/10to10/11:10/11to10/12:10/12to10/13:10/13to10/14:10/14to10/15:10/15to11/15:11/15to12/15:12/15to13/15:13/15to14/15:14/15to15/15:15/15totop15:,32,False,True
2169,344,464,120,4/7to4/6,1/11to2/11,4/7to4/6:4/6to3/6:3/6to2/6:2/6to1/6:1/6to1/7:1/7to1/8:1/8to1/9:1/9to1/10:1/10to1/11:1/11to2/11:,10,True,True
984,345,448,103,8/8to7/8,2/9to2/10,8/8to7/8:7/8to6/8:6/8to5/8:5/8to4/8:4/8to3/8:3/8to2/8:2/8to2/9:2/9to2/10:,8,False,True
2768,345,616,271,4/3to4/2,14/12to14/11,4/3to4/2:4/2to5/2:5/2to6/2:6/2to7/2:7/2to8/2:8/2to9/2:9/2to10/2:10/2to10/3:10/3to10/4:10/4to10/5:10/5to10/6:10/6to10/7:10/7to10/8:10/8to10/9:10/9to10/10:10/10to10/11:10/11to10/12:10/12to11/12:11/12to12/12:12/12to13/12:13/12to14/12:14/12to14/11:,22,False,True
1718,345,524,179,11/13to10/13,12/3to12/4,11/13to10/13:10/13to10/12:10/12to10/11:10/11to10/10:10/10to10/9:10/9to10/8:10/8to10/7:10/7to10/6:10/6to10/5:10/5to10/4:10/4to10/3:10/3to11/3:11/3to12/3:12/3to12/4:,14,False,True
313,346,726,380,right0to15/0,0/15totop0,right0to15/0:15/0to14/0:14/0to13/0:13/0to12/0:12/0to11/0:11/0to10/0:10/0to9/0:9/0to8/0:8/0to7/0:7/0to6/0:6/0to5/0:5/0to4/0:4/0to3/0:3/0to2/0:2/0to1/0:1/0to0/0:0/0to0/1:0/1to0/2:0/2to0/3:0/3to0/4:0/4to0/5:0/5to0/6:0/6to0/7:0/7to0/8:0/8to0/9:0/9to0/10:0/10to0/11:0/11to0/12:0/12to0/13:0/13to0/14:0/14to0/15:0/15totop0:,32,False,True
3392,347,590,243,11/1to11/2,6/13to7/13,11/1to11/2:11/2to10/2:10/2to9/2:9/2to8/2:8/2to7/2:7/2to6/2:6/2to6/3:6/3to6/4:6/4to6/5:6/5to6/6:6/6to6/7:6/7to6/8:6/8to6/9:6/9to6/10:6/10to6/11:6/11to6/12:6/12to6/13:6/13to7/13:,18,False,True
1887,347,409,62,8/3to8/4,10/3to9/3,8/3to8/4:8/4to8/3:8/3to9/3:9/3to10/3:10/3to9/3:,5,True,True
2873,347,488,141,15/13to14/13,11/6to10/6,15/13to14/13:14/13to13/13:13/13to12/13:12/13to11/13:11/13to11/12:11/12to11/11:11/11to11/10:11/10to11/9:11/9to11/8:11/8to11/7:11/7to11/6:11/6to10/6:,12,True,True
302,347,748,401,right0to15/0,0/15totop0,right0to15/0:15/0to14/0:14/0to13/0:13/0to12/0:12/0to11/0:11/0to10/0:10/0to9/0:9/0to8/0:8/0to7/0:7/0to6/0:6/0to5/0:5/0to4/0:4/0to3/0:3/0to2/0:2/0to1/0:1/0to0/0:0/0to0/1:0/1to0/2:0/2to0/3:0/3to0/4:0/4to0/5:0/5to0/6:0/6to0/7:0/7to0/8:0/8to0/9:0/9to0/10:0/10to0/11:0/11to0/12:0/12to0/13:0/13to0/14:0/14to0/15:0/15totop0:,32,False,True
1984,347,501,154,5/11to5/10,4/0to5/0,5/11to5/10:5/10to4/10:4/10to4/9:4/9to4/8:4/8to4/7:4/7to4/6:4/6to4/5:4/5to4/4:4/4to4/3:4/3to4/2:4/2to4/1:4/1to4/0:4/0to5/0:,13,True,True
2182,347,479,132,4/2to4/1,0/6to0/7,4/2to4/1:4/1to3/1:3/1to2/1:2/1to1/1:1/1to0/1:0/1to0/2:0/2to0/3:0/3to0/4:0/4to0/5:0/5to0/6:0/6to0/7:,11,True,True
3359,348,451,103,9/3to9/4,11/8to11/7,9/3to9/4:9/4to10/4:10/4to10/5:10/5to10/6:10/6to10/7:10/7to10/8:10/8to11/8:11/8to11/7:,8,False,True
296,348,770,422,right15to15/15,0/0tobottom0,right15to15/15:15/15to14/15:14/15to13/15:13/15to12/15:12/15to11/15:11/15to10/15:10/15to9/15:9/15to8/15:8/15to7/15:7/15to6/15:6/15to5/15:5/15to4/15:4/15to3/15:3/15to2/15:2/15to1/15:1/15to0/15:0/15to0/14:0/14to0/13:0/13to0/12:0/12to0/11:0/11to0/10:0/10to0/9:0/9to0/8:0/8to0/7:0/7to0/6:0/6to0/5:0/5to0/4:0/4to0/3:0/3to0/2:0/2to0/1:0/1to0/0:0/0tobottom0:,32,True,True
2640,348,478,130,1/2to1/1,8/0to9/0,1/2to1/1:1/1to1/0:1/0to2/0:2/0to3/0:3/0to4/0:4/0to5/0:5/0to6/0:6/0to7/0:7/0to8/0:8/0to9/0:,10,True,True
592,348,381,33,14/2to14/3,15/3to15/2,14/2to14/3:14/3to15/3:15/3to15/2:,3,False,True
3337,349,624,275,3/2to4/2,14/11to14/12,3/2to4/2:4/2to4/3:4/3to4/4:4/4to4/5:4/5to4/6:4/6to4/7:4/7to4/8:4/8to4/9:4/9to4/10:4/10to4/11:4/11to5/11:5/11to6/11:6/11to7/11:7/11to8/11:8/11to9/11:9/11to10/11:10/11to11/11:11/11to12/11:12/11to13/11:13/11to14/11:14/11to14/12:,21,True,True
2272,349,534,185,12/1to11/1,3/5to4/5,12/1to11/1:11/1to10/1:10/1to9/1:9/1to8/1:8/1to7/1:7/1to6/1:6/1to5/1:5/1to4/1:4/1to3/1:3/1to3/2:3/2to3/3:3/3to3/4:3/4to3/5:3/5to4/5:,14,False,True
696,350,529,179,5/3to5/4,1/13to1/14,5/3to5/4:5/4to4/4:4/4to3/4:3/4to2/4:2/4to1/4:1/4to1/5:1/5to1/6:1/6to1/7:1/7to1/8:1/8to1/9:1/9to1/10:1/10to1/11:1/11to1/12:1/12to1/13:1/13to1/14:,15,False,True
1298,350,422,72,6/7to5/7,4/4to4/3,6/7to5/7:5/7to4/7:4/7to4/6:4/6to4/5:4/5to4/4:4/4to4/3:,6,True,True
2021,350,451,101,11/0to10/0,5/0to5/1,11/0to10/0:10/0to9/0:9/0to8/0:8/0to7/0:7/0to6/0:6/0to5/0:5/0to5/1:,7,True,True
1561,350,615,265,7/3to7/4,0/11to1/11,7/3to7/4:7/4to6/4:6/4to5/4:5/4to4/4:4/4to3/4:3/4to2/4:2/4to1/4:1/4to0/4:0/4to0/5:0/5to0/6:0/6to0/7:0/7to0/8:0/8to0/9:0/9to0/10:0/10to0/11:0/11to1/11:,16,False,True
1342,351,535,184,top13to13/15,7/7to8/7,top13to13/15:13/15to12/15:12/15to11/15:11/15to10/15:10/15to9/15:9/15to8/15:8/15to7/15:7/15to7/14:7/14to7/13:7/13to7/12:7/12to7/11:7/11to7/10:7/10to7/9:7/9to7/8:7/8to7/7:7/7to8/7:,16,False,True
1722,351,616,265,12/14to11/14,0/9to0/8,12/14to11/14:11/14to10/14:10/14to9/14:9/14to8/14:8/14to7/14:7/14to6/14:6/14to5/14:5/14to4/14:4/14to3/14:3/14to2/14:2/14to1/14:1/14to0/14:0/14to0/13:0/13to0/12:0/12to0/11:0/11to0/10:0/10to0/9:0/9to0/8:,18,False,True
122,352,778,426,left0to0/0,15/15totop15,left0to0/0:0/0to0/1:0/1to0/2:0/2to0/3:0/3to0/4:0/4to0/5:0/5to0/6:0/6to0/7:0/7to0/8:0/8to0/9:0/9to0/10:0/10to0/11:0/11to0/12:0/12to0/13:0/13to1/13:1/13to2/13:2/13to3/13:3/13to4/13:4/13to5/13:5/13to6/13:6/13to7/13:7/13to8/13:8/13to9/13:9/13to10/13:10/13to10/14:10/14to11/14:11/14to11/15:11/15to12/15:12/15to13/15:13/15to14/15:14/15to15/15:15/15totop15:,32,True,True
2447,352,421,69,13/13to13/12,13/8to13/7,13/13to13/12:13/12to13/11:13/11to13/10:13/10to13/9:13/9to13/8:13/8to13/7:,6,False,True
239,352,791,439,right15to15/15,0/0tobottom0,right15to15/15:15/15to14/15:14/15to13/15:13/15to12/15:12/15to11/15:11/15to10/15:10/15to9/15:9/15to8/15:8/15to7/15:7/15to6/15:6/15to5/15:5/15to4/15:4/15to3/15:3/15to2/15:2/15to1/15:1/15to0/15:0/15to0/14:0/14to0/13:0/13to0/12:0/12to0/11:0/11to0/10:0/10to0/9:0/9to0/8:0/8to0/7:0/7to0/6:0/6to0/5:0/5to0/4:0/4to0/3:0/3to0/2:0/2to0/1:0/1to0/0:0/0tobottom0:,32,False,True
1144,352,553,201,14/4to14/5,6/2to5/2,14/4to14/5:14/5to13/5:13/5to12/5:12/5to11/5:11/5to10/5:10/5to9/5:9/5to8/5:8/5to7/5:7/5to6/5:6/5to6/4:6/4to6/3:6/3to6/2:6/2to5/2:,13,True,True
1769,353,588,235,left14to0/14,4/0to5/0,left14to0/14:0/14to0/13:0/13to0/12:0/12to0/11:0/11to0/10:0/10to0/9:0/9to0/8:0/8to0/7:0/7to0/6:0/6to0/5:0/5to0/4:0/4to0/3:0/3to0/2:0/2to0/1:0/1to0/0:0/0to1/0:1/0to2/0:2/0to3/0:3/0to4/0:4/0to5/0:,20,True,True
2111,354,560,206,11/8to10/8,2/14to2/15,11/8to10/8:10/8to9/8:9/8to8/8:8/8to7/8:7/8to6/8:6/8to5/8:5/8to4/8:4/8to3/8:3/8to2/8:2/8to2/9:2/9to2/10:2/10to2/11:2/11to2/12:2/12to2/13:2/13to2/14:2/14to2/15:,16,False,True
2871,354,518,164,12/6to12/5,5/7to5/8,12/6to12/5:12/5to11/5:11/5to10/5:10/5to9/5:9/5to8/5:8/5to7/5:7/5to6/5:6/5to5/5:5/5to5/6:5/6to5/7:5/7to5/8:,11,False,True
1168,355,514,159,1/12to2/12,5/4to5/5,1/12to2/12:2/12to2/11:2/11to2/10:2/10to2/9:2/9to2/8:2/8to2/7:2/7to2/6:2/6to2/5:2/5to2/4:2/4to3/4:3/4to4/4:4/4to5/4:5/4to5/5:,13,False,True
974,355,476,121,4/12to4/13,1/8to2/8,4/12to4/13:4/13to3/13:3/13to2/13:2/13to1/13:1/13to1/12:1/12to1/11:1/11to1/10:1/10to1/9:1/9to1/8:1/8to2/8:,10,False,True
3028,356,669,313,2/14to2/13,14/5to14/4,2/14to2/13:2/13to2/12:2/12to2/11:2/11to2/10:2/10to2/9:2/9to2/8:2/8to2/7:2/7to2/6:2/6to3/6:3/6to4/6:4/6to5/6:5/6to6/6:6/6to7/6:7/6to8/6:8/6to9/6:9/6to10/6:10/6to10/5:10/5to11/5:11/5to12/5:12/5to13/5:13/5to14/5:14/5to14/4:,22,True,True
1897,356,707,351,14/14to14/15,1/2to1/1,14/14to14/15:14/15to13/15:13/15to12/15:12/15to11/15:11/15to10/15:10/15to9/15:9/15to8/15:8/15to7/15:7/15to6/15:6/15to5/15:5/15to4/15:4/15to3/15:3/15to2/15:2/15to1/15:1/15to1/14:1/14to1/13:1/13to1/12:1/12to1/11:1/11to1/10:1/10to1/9:1/9to1/8:1/8to1/7:1/7to1/6:1/6to1/5:1/5to1/4:1/4to1/3:1/3to1/2:1/2to1/1:,28,False,True
959,356,416,60,3/6to3/7,4/9to5/9,3/6to3/7:3/7to3/8:3/8to3/9:3/9to4/9:4/9to5/9:,5,True,True
1343,356,581,225,12/7to11/7,3/12to4/12,12/7to11/7:11/7to10/7:10/7to9/7:9/7to8/7:8/7to7/7:7/7to6/7:6/7to5/7:5/7to4/7:4/7to3/7:3/7to3/8:3/8to3/9:3/9to3/10:3/10to3/11:3/11to3/12:3/12to4/12:,15,True,True
1555,356,627,271,15/11to15/10,0/11to0/12,15/11to15/10:15/10to14/10:14/10to13/10:13/10to12/10:12/10to11/10:11/10to10/10:10/10to9/10:9/10to8/10:8/10to7/10:7/10to6/10:6/10to5/10:5/10to4/10:4/10to3/10:3/10to2/10:2/10to1/10:1/10to0/10:0/10to0/11:0/11to0/12:,18,True,True
2456,356,499,143,left4to0/4,1/14to2/14,left4to0/4:0/4to0/5:0/5to0/6:0/6to0/7:0/7to0/8:0/8to0/9:0/9to0/10:0/10to0/11:0/11to0/12:0/12to0/13:0/13to0/14:0/14to1/14:1/14to2/14:,13,True,True
846,356,521,165,2/13to2/12,10/15totop10,2/13to2/12:2/12to3/12:3/12to4/12:4/12to5/12:5/12to6/12:6/12to7/12:7/12to8/12:8/12to9/12:9/12to10/12:10/12to10/13:10/13to10/14:10/14to10/15:10/15totop10:,13,False,True
2407,356,560,204,2/4to2/3,10/5to11/5,2/4to2/3:2/3to3/3:3/3to4/3:4/3to5/3:5/3to6/3:6/3to7/3:7/3to8/3:8/3to9/3:9/3to10/3:10/3to10/4:10/4to10/5:10/5to11/5:,12,False,True
159,357,763,406,left0to0/0,15/15totop15,left0to0/0:0/0to1/0:1/0to2/0:2/0to3/0:3/0to4/0:4/0to5/0:5/0to6/0:6/0to7/0:7/0to8/0:8/0to9/0:9/0to10/0:10/0to10/1:10/1to10/2:10/2to10/3:10/3to10/4:10/4to10/5:10/5to10/6:10/6to10/7:10/7to10/8:10/8to10/9:10/9to10/10:10/10to10/11:10/11to10/12:10/12to10/13:10/13to10/14:10/14to10/15:10/15to11/15:11/15to12/15:12/15to13/15:13/15to14/15:14/15to15/15:15/15totop15:,32,False,True
438,357,542,185,left14to0/14,2/2to2/3,left14to0/14:0/14to0/13:0/13to0/12:0/12to0/11:0/11to0/10:0/10to0/9:0/9to0/8:0/8to0/7:0/7to0/6:0/6to0/5:0/5to0/4:0/4to0/3:0/3to0/2:0/2to1/2:1/2to2/2:2/2to2/3:,16,False,True
1068,358,431,73,9/14to10/14,10/10to10/9,9/14to10/14:10/14to10/13:10/13to10/12:10/12to10/11:10/11to10/10:10/10to10/9:,6,False,True
2105,358,578,220,5/14to5/15,2/2to2/1,5/14to5/15:5/15to4/15:4/15to3/15:3/15to2/15:2/15to2/14:2/14to2/13:2/13to2/12:2/12to2/11:2/11to2/10:2/10to2/9:2/9to2/8:2/8to2/7:2/7to2/6:2/6to2/5:2/5to2/4:2/4to2/3:2/3to2/2:2/2to2/1:,18,True,True
3139,358,451,93,7/1to8/1,13/0tobottom13,7/1to8/1:8/1to9/1:9/1to10/1:10/1to11/1:11/1to11/0:11/0to12/0:12/0to13/0:13/0tobottom13:,8,True,True
3339,358,637,279,1/2to1/3,11/11to12/11,1/2to1/3:1/3to1/4:1/4to1/5:1/5to1/6:1/6to1/7:1/7to1/8:1/8to1/9:1/9to1/10:1/10to1/11:1/11to2/11:2/11to3/11:3/11to4/11:4/11to5/11:5/11to6/11:6/11to7/11:7/11to8/11:8/11to9/11:9/11to10/11:10/11to11/11:11/11to12/11:,20,True,True
1812,359,474,115,9/1to8/1,3/3to4/3,9/1to8/1:8/1to7/1:7/1to6/1:6/1to5/1:5/1to4/1:4/1to3/1:3/1to3/2:3/2to3/3:3/3to4/3:,9,False,True
778,359,422,63,13/5to12/5,12/2to12/1,13/5to12/5:12/5to12/4:12/4to12/3:12/3to12/2:12/2to12/1:,5,True,True
2330,360,536,176,11/13to10/13,6/6to6/5,11/13to10/13:10/13to9/13:9/13to8/13:8/13to7/13:7/13to6/13:6/13to6/12:6/12to6/11:6/11to6/10:6/10to6/9:6/9to6/8:6/8to6/7:6/7to6/6:6/6to6/5:,13,False,True
3253,360,496,136,10/6to9/6,5/3to4/3,10/6to9/6:9/6to8/6:8/6to7/6:7/6to6/6:6/6to5/6:5/6to5/5:5/5to5/4:5/4to5/3:5/3to4/3:,9,False,True
3112,360,583,223,5/1to5/2,12/11to13/11,5/1to5/2:5/2to5/3:5/3to5/4:5/4to5/5:5/5to5/6:5/6to5/7:5/7to5/8:5/8to5/9:5/9to5/10:5/10to5/11:5/11to6/11:6/11to7/11:7/11to8/11:8/11to9/11:9/11to10/11:10/11to11/11:11/11to12/11:12/11to13/11:,18,True,True
472,361,486,125,9/5to8/5,4/9to5/9,9/5to8/5:8/5to7/5:7/5to6/5:6/5to5/5:5/5to4/5:4/5to4/6:4/6to4/7:4/7to4/8:4/8to4/9:4/9to5/9:,10,False,True
2513,361,551,190,13/10to12/10,10/4to9/4,13/10to12/10:12/10to11/10:11/10to11/9:11/9to11/8:11/8to11/7:11/7to11/6:11/6to11/5:11/5to10/5:10/5to10/4:10/4to9/4:,10,True,True
803,361,566,205,8/12to8/13,4/2to4/1,8/12to8/13:8/13to7/13:7/13to6/13:6/13to5/13:5/13to4/13:4/13to4/12:4/12to4/11:4/11to4/10:4/10to4/9:4/9to4/8:4/8to4/7:4/7to4/6:4/6to4/5:4/5to4/4:4/4to4/3:4/3to4/2:4/2to4/1:,17,False,True
577,361,730,369,right5to15/5,0/11toleft11,right5to15/5:15/5to14/5:14/5to13/5:13/5to12/5:12/5to11/5:11/5to10/5:10/5to9/5:9/5to8/5:8/5to7/5:7/5to6/5:6/5to5/5:5/5to4/5:4/5to3/5:3/5to2/5:2/5to1/5:1/5to0/5:0/5to0/6:0/6to0/7:0/7to0/8:0/8to0/9:0/9to0/10:0/10to0/11:0/11toleft11:,23,True,True
2834,361,430,69,top3to3/15,5/13to6/13,top3to3/15:3/15to3/14:3/14to3/13:3/13to4/13:4/13to5/13:5/13to6/13:,6,False,True
1237,361,671,310,1/15to2/15,11/1to12/1,1/15to2/15:2/15to3/15:3/15to4/15:4/15to5/15:5/15to6/15:6/15to7/15:7/15to8/15:8/15to9/15:9/15to10/15:10/15to10/14:10/14to10/13:10/13to10/12:10/12to10/11:10/11to10/10:10/10to10/9:10/9to10/8:10/8to10/7:10/7to10/6:10/6to10/5:10/5to10/4:10/4to10/3:10/3to10/2:10/2to10/1:10/1to11/1:11/1to12/1:,25,False,True
2572,362,565,203,4/3to4/4,9/14to10/14,4/3to4/4:4/4to4/5:4/5to4/6:4/6to4/7:4/7to4/8:4/8to4/9:4/9to4/10:4/10to4/11:4/11to4/12:4/12to4/13:4/13to4/14:4/14to5/14:5/14to6/14:6/14to7/14:7/14to8/14:8/14to9/14:9/14to10/14:,17,False,True
2678,362,543,181,6/13to5/13,8/3to9/3,6/13to5/13:5/13to5/12:5/12to5/11:5/11to5/10:5/10to5/9:5/9to5/8:5/8to5/7:5/7to5/6:5/6to5/5:5/5to5/4:5/4to5/3:5/3to6/3:6/3to7/3:7/3to8/3:8/3to9/3:,15,True,True
939,362,443,81,12/9to12/10,13/14to14/14,12/9to12/10:12/10to12/11:12/11to12/12:12/12to12/13:12/13to12/14:12/14to13/14:13/14to14/14:,7,True,True
268,363,793,430,right15to15/15,0/0tobottom0,right15to15/15:15/15to14/15:14/15to13/15:13/15to12/15:12/15to11/15:11/15to10/15:10/15to9/15:9/15to8/15:8/15to7/15:7/15to6/15:6/15to5/15:5/15to4/15:4/15to3/15:3/15to2/15:2/15to1/15:1/15to0/15:0/15to0/14:0/14to0/13:0/13to0/12:0/12to0/11:0/11to0/10:0/10to0/9:0/9to0/8:0/8to0/7:0/7to0/6:0/6to0/5:0/5to0/4:0/4to0/3:0/3to0/2:0/2to0/1:0/1to0/0:0/0tobottom0:,32,True,True
52,363,741,378,left15to0/15,15/0tobottom15,left15to0/15:0/15to0/14:0/14to0/13:0/13to0/12:0/12to0/11:0/11to0/10:0/10to0/9:0/9to0/8:0/8to0/7:0/7to0/6:0/6to0/5:0/5to0/4:0/4to0/3:0/3to0/2:0/2to0/1:0/1to0/0:0/0to1/0:1/0to2/0:2/0to3/0:3/0to4/0:4/0to5/0:5/0to6/0:6/0to7/0:7/0to8/0:8/0to9/0:9/0to10/0:10/0to11/0:11/0to12/0:12/0to13/0:13/0to14/0:14/0to15/0:15/0tobottom15:,32,True,True
1083,363,574,211,10/13to10/12,10/4to11/4,10/13to10/12:10/12to10/11:10/11to10/10:10/10to11/10:11/10to11/9:11/9to11/8:11/8to11/7:11/7to11/6:11/6to11/5:11/5to10/5:10/5to10/4:10/4to11/4:,12,True,True
2489,363,542,179,8/4to8/5,11/9to12/9,8/4to8/5:8/5to9/5:9/5to10/5:10/5to10/6:10/6to10/7:10/7to10/8:10/8to10/9:10/9to11/9:11/9to12/9:,9,False,True
1372,365,516,151,top1to1/15,1/3to1/2,top1to1/15:1/15to1/14:1/14to1/13:1/13to1/12:1/12to1/11:1/11to1/10:1/10to1/9:1/9to1/8:1/8to1/7:1/7to1/6:1/6to1/5:1/5to1/4:1/4to1/3:1/3to1/2:,14,False,True
2815,365,602,237,bottom11to11/0,6/13to6/14,bottom11to11/0:11/0to10/0:10/0to9/0:9/0to8/0:8/0to7/0:7/0to6/0:6/0to6/1:6/1to6/2:6/2to6/3:6/3to6/4:6/4to6/5:6/5to6/6:6/6to6/7:6/7to6/8:6/8to6/9:6/9to6/10:6/10to6/11:6/11to6/12:6/12to6/13:6/13to6/14:,20,False,True
2305,366,580,214,11/15to10/15,0/14toleft14,11/15to10/15:10/15to9/15:9/15to8/15:8/15to7/15:7/15to6/15:6/15to5/15:5/15to4/15:4/15to3/15:3/15to2/15:2/15to1/15:1/15to0/15:0/15to0/14:0/14toleft14:,13,False,True
2179,366,533,167,15/9to14/9,5/10to5/11,15/9to14/9:14/9to13/9:13/9to12/9:12/9to11/9:11/9to10/9:10/9to9/9:9/9to8/9:8/9to7/9:7/9to6/9:6/9to5/9:5/9to5/10:5/10to5/11:,12,False,True
1816,367,698,331,right0to15/0,1/11to2/11,right0to15/0:15/0to14/0:14/0to13/0:13/0to12/0:12/0to11/0:11/0to10/0:10/0to9/0:9/0to8/0:8/0to7/0:7/0to6/0:6/0to5/0:5/0to4/0:4/0to3/0:3/0to2/0:2/0to1/0:1/0to1/1:1/1to1/2:1/2to1/3:1/3to1/4:1/4to1/5:1/5to1/6:1/6to1/7:1/7to1/8:1/8to1/9:1/9to1/10:1/10to1/11:1/11to2/11:,27,False,True
525,367,540,173,3/15to4/15,8/7to9/7,3/15to4/15:4/15to4/14:4/14to4/13:4/13to4/12:4/12to4/11:4/11to4/10:4/10to4/9:4/9to4/8:4/8to4/7:4/7to5/7:5/7to6/7:6/7to7/7:7/7to8/7:8/7to9/7:,14,True,True
682,367,500,133,7/15to7/14,12/10to12/9,7/15to7/14:7/14to8/14:8/14to9/14:9/14to10/14:10/14to10/13:10/13to10/12:10/12to10/11:10/11to10/10:10/10to11/10:11/10to12/10:12/10to12/9:,11,False,True
1190,368,575,207,left13to0/13,8/10to9/10,left13to0/13:0/13to0/12:0/12to0/11:0/11to0/10:0/10to1/10:1/10to2/10:2/10to3/10:3/10to4/10:4/10to5/10:5/10to6/10:6/10to7/10:7/10to8/10:8/10to9/10:,13,False,True
776,368,554,186,0/5to1/5,8/11to9/11,0/5to1/5:1/5to1/6:1/6to1/7:1/7to1/8:1/8to1/9:1/9to1/10:1/10to1/11:1/11to2/11:2/11to3/11:3/11to4/11:4/11to5/11:5/11to6/11:6/11to7/11:7/11to8/11:8/11to9/11:,15,False,True
3296,368,530,162,4/5to4/6,1/14to1/15,4/5to4/6:4/6to3/6:3/6to2/6:2/6to1/6:1/6to1/7:1/7to1/8:1/8to1/9:1/9to1/10:1/10to1/11:1/11to1/12:1/12to1/13:1/13to1/14:1/14to1/15:,13,True,True
1036,368,457,89,right6to15/6,12/3to12/2,right6to15/6:15/6to14/6:14/6to13/6:13/6to12/6:12/6to12/5:12/5to12/4:12/4to12/3:12/3to12/2:,8,False,True
1825,368,522,154,9/11to9/10,13/3to13/2,9/11to9/10:9/10to10/10:10/10to11/10:11/10to11/9:11/9to11/8:11/8to11/7:11/7to11/6:11/6to11/5:11/5to11/4:11/4to11/3:11/3to12/3:12/3to13/3:13/3to13/2:,13,True,True
1334,368,385,17,top4to4/15,3/15totop3,top4to4/15:4/15to3/15:3/15totop3:,3,False,True
1379,369,543,174,7/11to7/12,1/8to0/8,7/11to7/12:7/12to6/12:6/12to5/12:5/12to4/12:4/12to3/12:3/12to2/12:2/12to1/12:1/12to1/11:1/11to1/10:1/10to1/9:1/9to1/8:1/8to0/8:,12,False,True
2383,370,645,275,7/14to6/14,0/5to0/4,7/14to6/14:6/14to5/14:5/14to4/14:4/14to3/14:3/14to2/14:2/14to1/14:1/14to0/14:0/14to0/13:0/13to0/12:0/12to0/11:0/11to0/10:0/10to0/9:0/9to0/8:0/8to0/7:0/7to0/6:0/6to0/5:0/5to0/4:,17,False,True
808,370,630,260,left12to0/12,10/2to10/1,left12to0/12:0/12to0/11:0/11to0/10:0/10to0/9:0/9to0/8:0/8to0/7:0/7to0/6:0/6to0/5:0/5to0/4:0/4to0/3:0/3to1/3:1/3to2/3:2/3to3/3:3/3to4/3:4/3to5/3:5/3to6/3:6/3to7/3:7/3to8/3:8/3to9/3:9/3to10/3:10/3to10/2:10/2to10/1:,22,True,True
2553,371,542,171,8/2to9/2,10/13to11/13,8/2to9/2:9/2to10/2:10/2to10/3:10/3to10/4:10/4to10/5:10/5to10/6:10/6to10/7:10/7to10/8:10/8to10/9:10/9to10/10:10/10to10/11:10/11to10/12:10/12to10/13:10/13to11/13:,14,False,True
2543,371,545,174,0/7to0/6,8/4to8/3,0/7to0/6:0/6to0/5:0/5to0/4:0/4to1/4:1/4to2/4:2/4to3/4:3/4to4/4:4/4to5/4:5/4to6/4:6/4to7/4:7/4to8/4:8/4to8/3:,12,False,True
2311,371,410,39,5/6to4/6,3/6to3/5,5/6to4/6:4/6to3/6:3/6to3/5:,3,False,True
2959,371,476,105,3/0to3/1,0/5toleft5,3/0to3/1:3/1to2/1:2/1to1/1:1/1to0/1:0/1to0/2:0/2to0/3:0/3to0/4:0/4to0/5:0/5toleft5:,9,True,True
1224,371,516,145,5/2to5/3,7/10to8/10,5/2to5/3:5/3to5/4:5/4to5/5:5/5to5/6:5/6to5/7:5/7to5/8:5/8to5/9:5/9to5/10:5/10to6/10:6/10to7/10:7/10to8/10:,11,False,True
2145,371,525,154,6/13to6/14,15/13toright13,6/13to6/14:6/14to7/14:7/14to8/14:8/14to9/14:9/14to10/14:10/14to10/13:10/13to11/13:11/13to12/13:12/13to13/13:13/13to14/13:14/13to15/13:15/13toright13:,12,False,True
3065,372,506,134,right2to15/2,11/8to11/9,right2to15/2:15/2to14/2:14/2to13/2:13/2to12/2:12/2to11/2:11/2to11/3:11/3to11/4:11/4to11/5:11/5to11/6:11/6to11/7:11/7to11/8:11/8to11/9:,12,True,True
311,372,765,393,right0to15/0,0/15totop0,right0to15/0:15/0to14/0:14/0to13/0:13/0to12/0:12/0to11/0:11/0to10/0:10/0to9/0:9/0to8/0:8/0to7/0:7/0to6/0:6/0to5/0:5/0to4/0:4/0to3/0:3/0to2/0:2/0to1/0:1/0to0/0:0/0to0/1:0/1to0/2:0/2to0/3:0/3to0/4:0/4to0/5:0/5to0/6:0/6to0/7:0/7to0/8:0/8to0/9:0/9to0/10:0/10to0/11:0/11to0/12:0/12to0/13:0/13to0/14:0/14to0/15:0/15totop0:,32,False,True
1345,373,481,108,8/9to8/8,5/4to6/4,8/9to8/8:8/8to7/8:7/8to6/8:6/8to5/8:5/8to5/7:5/7to5/6:5/6to5/5:5/5to5/4:5/4to6/4:,9,False,True
2026,373,687,314,14/13to13/13,6/0tobottom6,14/13to13/13:13/13to12/13:12/13to12/12:12/12to11/12:11/12to10/12:10/12to9/12:9/12to8/12:8/12to7/12:7/12to6/12:6/12to6/11:6/11to6/10:6/10to6/9:6/9to6/8:6/8to6/7:6/7to6/6:6/6to6/5:6/5to6/4:6/4to6/3:6/3to6/2:6/2to6/1:6/1to6/0:6/0tobottom6:,22,True,True
2060,373,687,314,1/13to2/13,15/3to15/4,1/13to2/13:2/13to2/12:2/12to2/11:2/11to2/10:2/10to2/9:2/9to2/8:2/8to2/7:2/7to2/6:2/6to2/5:2/5to3/5:3/5to4/5:4/5to5/5:5/5to6/5:6/5to7/5:7/5to8/5:8/5to9/5:9/5to10/5:10/5to10/4:10/4to11/4:11/4to11/3:11/3to12/3:12/3to13/3:13/3to14/3:14/3to15/3:15/3to15/4:,25,True,True
2719,373,509,136,15/7to15/6,12/13to13/13,15/7to15/6:15/6to14/6:14/6to13/6:13/6to12/6:12/6to12/7:12/7to12/8:12/8to12/9:12/9to12/10:12/10to12/11:12/11to12/12:12/12to12/13:12/13to13/13:,12,True,True
2869,373,626,253,12/11to12/12,6/4to7/4,12/11to12/12:12/12to11/12:11/12to10/12:10/12to9/12:9/12to8/12:8/12to7/12:7/12to6/12:6/12to6/11:6/11to6/10:6/10to6/9:6/9to6/8:6/8to6/7:6/7to6/6:6/6to6/5:6/5to6/4:6/4to7/4:,16,False,True
2521,374,570,196,14/12to13/12,5/11to5/10,14/12to13/12:13/12to12/12:12/12to11/12:11/12to10/12:10/12to9/12:9/12to8/12:8/12to7/12:7/12to6/12:6/12to5/12:5/12to5/11:5/11to5/10:,11,False,True
3229,374,515,141,3/7to2/7,7/11to7/10,3/7to2/7:2/7to2/8:2/8to2/9:2/9to2/10:2/10to2/11:2/11to3/11:3/11to4/11:4/11to5/11:5/11to6/11:6/11to7/11:7/11to7/10:,11,False,True
98,374,764,390,left15to0/15,15/0tobottom15,left15to0/15:0/15to0/14:0/14to0/13:0/13to0/12:0/12to0/11:0/11to0/10:0/10to0/9:0/9to0/8:0/8to0/7:0/7to0/6:0/6to0/5:0/5to0/4:0/4to0/3:0/3to0/2:0/2to0/1:0/1to0/0:0/0to1/0:1/0to2/0:2/0to3/0:3/0to4/0:4/0to5/0:5/0to6/0:6/0to7/0:7/0to8/0:8/0to9/0:9/0to10/0:10/0to11/0:11/0to12/0:12/0to13/0:13/0to14/0:14/0to15/0:15/0tobottom15:,32,True,True
976,374,549,175,10/11to10/10,0/8toleft8,10/11to10/10:10/10to9/10:9/10to8/10:8/10to7/10:7/10to6/10:6/10to5/10:5/10to4/10:4/10to3/10:3/10to2/10:2/10to1/10:1/10to0/10:0/10to0/9:0/9to0/8:0/8toleft8:,14,False,True
3152,375,660,285,2/15to3/15,15/7toright7,2/15to3/15:3/15to4/15:4/15to5/15:5/15to6/15:6/15to7/15:7/15to8/15:8/15to9/15:9/15to10/15:10/15to10/14:10/14to10/13:10/13to10/12:10/12to10/11:10/11to10/10:10/10to10/9:10/9to10/8:10/8to10/7:10/7to11/7:11/7to12/7:12/7to13/7:13/7to14/7:14/7to15/7:15/7toright7:,22,False,True
1202,375,682,307,0/3to1/3,11/15totop11,0/3to1/3:1/3to2/3:2/3to3/3:3/3to4/3:4/3to5/3:5/3to6/3:6/3to7/3:7/3to8/3:8/3to9/3:9/3to10/3:10/3to10/4:10/4to10/5:10/5to10/6:10/6to10/7:10/7to10/8:10/8to10/9:10/9to10/10:10/10to10/11:10/11to10/12:10/12to10/13:10/13to10/14:10/14to10/15:10/15to11/15:11/15totop11:,24,False,True
926,376,604,228,4/15to4/14,9/3to10/3,4/15to4/14:4/14to4/13:4/13to4/12:4/12to4/11:4/11to4/10:4/10to4/9:4/9to4/8:4/8to4/7:4/7to4/6:4/6to4/5:4/5to4/4:4/4to4/3:4/3to5/3:5/3to6/3:6/3to7/3:7/3to8/3:8/3to9/3:9/3to10/3:,18,True,True
1747,376,554,178,2/13to3/13,10/10to10/9,2/13to3/13:3/13to3/12:3/12to3/11:3/11to4/11:4/11to5/11:5/11to6/11:6/11to7/11:7/11to8/11:8/11to9/11:9/11to10/11:10/11to10/10:10/10to10/9:,12,True,True
1358,376,505,129,15/4to15/5,15/15totop15,15/4to15/5:15/5to15/6:15/6to15/7:15/7to15/8:15/8to15/9:15/9to15/10:15/10to15/11:15/11to15/12:15/12to15/13:15/13to15/14:15/14to15/15:15/15totop15:,12,True,True
1571,377,576,199,14/14to14/15,1/15to0/15,14/14to14/15:14/15to13/15:13/15to12/15:12/15to11/15:11/15to10/15:10/15to9/15:9/15to8/15:8/15to7/15:7/15to6/15:6/15to5/15:5/15to4/15:4/15to3/15:3/15to2/15:2/15to1/15:1/15to0/15:,15,True,True
3321,377,438,61,15/7to14/7,13/9to12/9,15/7to14/7:14/7to13/7:13/7to13/8:13/8to13/9:13/9to12/9:,5,False,True
116,377,823,446,left0to0/0,15/15totop15,left0to0/0:0/0to0/1:0/1to0/2:0/2to0/3:0/3to0/4:0/4to0/5:0/5to0/6:0/6to0/7:0/7to0/8:0/8to0/9:0/9to0/10:0/10to0/11:0/11to0/12:0/12to0/13:0/13to0/14:0/14to1/14:1/14to2/14:2/14to3/14:3/14to4/14:4/14to5/14:5/14to6/14:6/14to7/14:7/14to8/14:8/14to9/14:9/14to10/14:10/14to10/15:10/15to11/15:11/15to12/15:12/15to13/15:13/15to14/15:14/15to15/15:15/15totop15:,32,True,True
583,378,503,125,0/12to1/12,1/3to1/2,0/12to1/12:1/12to1/11:1/11to1/10:1/10to1/9:1/9to1/8:1/8to1/7:1/7to1/6:1/6to1/5:1/5to1/4:1/4to1/3:1/3to1/2:,11,True,True
3215,378,471,93,8/1to7/1,7/7to7/8,8/1to7/1:7/1to7/2:7/2to7/3:7/3to7/4:7/4to7/5:7/5to7/6:7/6to7/7:7/7to7/8:,8,False,True
599,379,464,85,2/7to3/7,5/4to6/4,2/7to3/7:3/7to3/6:3/6to3/5:3/5to3/4:3/4to4/4:4/4to5/4:5/4to6/4:,7,True,True
497,379,585,206,0/12to0/11,4/0to5/0,0/12to0/11:0/11to0/10:0/10to0/9:0/9to0/8:0/8to0/7:0/7to0/6:0/6to0/5:0/5to0/4:0/4to0/3:0/3to0/2:0/2to0/1:0/1to0/0:0/0to1/0:1/0to2/0:2/0to3/0:3/0to4/0:4/0to5/0:,17,True,True
1308,379,567,188,14/6to13/6,6/3to6/2,14/6to13/6:13/6to12/6:12/6to11/6:11/6to10/6:10/6to9/6:9/6to8/6:8/6to7/6:7/6to6/6:6/6to6/5:6/5to6/4:6/4to6/3:6/3to6/2:,12,False,True
742,379,590,211,top6to6/15,0/6to0/5,top6to6/15:6/15to5/15:5/15to4/15:4/15to3/15:3/15to2/15:2/15to1/15:1/15to0/15:0/15to0/14:0/14to0/13:0/13to0/12:0/12to0/11:0/11to0/10:0/10to0/9:0/9to0/8:0/8to0/7:0/7to0/6:0/6to0/5:,17,True,True
3115,380,549,169,7/0to6/0,1/7to1/8,7/0to6/0:6/0to5/0:5/0to4/0:4/0to3/0:3/0to2/0:2/0to1/0:1/0to1/1:1/1to1/2:1/2to1/3:1/3to1/4:1/4to1/5:1/5to1/6:1/6to1/7:1/7to1/8:,14,True,True
2846,380,552,172,2/7to3/7,11/7to11/8,2/7to3/7:3/7to4/7:4/7to5/7:5/7to6/7:6/7to7/7:7/7to8/7:8/7to9/7:9/7to10/7:10/7to11/7:11/7to11/8:,10,False,True
1328,380,485,105,0/11to0/10,2/6to3/6,0/11to0/10:0/10to0/9:0/9to0/8:0/8to0/7:0/7to0/6:0/6to1/6:1/6to2/6:2/6to3/6:,8,True,True
1716,380,486,106,8/9to8/8,8/0tobottom8,8/9to8/8:8/8to8/7:8/7to8/6:8/6to8/5:8/5to8/4:8/4to8/3:8/3to8/2:8/2to8/1:8/1to8/0:8/0tobottom8:,10,False,True
2991,381,605,224,4/4to3/4,9/14to9/15,4/4to3/4:3/4to3/5:3/5to3/6:3/6to3/7:3/7to3/8:3/8to3/9:3/9to3/10:3/10to3/11:3/11to3/12:3/12to3/13:3/13to3/14:3/14to4/14:4/14to5/14:5/14to6/14:6/14to7/14:7/14to8/14:8/14to9/14:9/14to9/15:,18,False,True
421,381,528,147,3/8to3/9,9/11to10/11,3/8to3/9:3/9to3/10:3/10to3/11:3/11to4/11:4/11to5/11:5/11to6/11:6/11to7/11:7/11to8/11:8/11to9/11:9/11to10/11:,10,False,True
835,381,592,211,4/2to3/2,9/10to9/9,4/2to3/2:3/2to3/3:3/3to3/4:3/4to3/5:3/5to3/6:3/6to3/7:3/7to3/8:3/8to3/9:3/9to3/10:3/10to4/10:4/10to5/10:5/10to6/10:6/10to7/10:7/10to8/10:8/10to9/10:9/10to9/9:,16,True,True
1794,381,454,73,top8to8/15,12/15totop12,top8to8/15:8/15to9/15:9/15to10/15:10/15to11/15:11/15to12/15:12/15totop12:,6,False,True
2422,381,557,176,11/13to11/14,3/15to2/15,11/13to11/14:11/14to10/14:10/14to9/14:9/14to8/14:8/14to7/14:7/14to6/14:6/14to5/14:5/14to4/14:4/14to3/14:3/14to3/15:3/15to2/15:,11,False,True
8,381,767,386,left15to0/15,15/0tobottom15,left15to0/15:0/15to0/14:0/14to0/13:0/13to0/12:0/12to0/11:0/11to0/10:0/10to0/9:0/9to0/8:0/8to0/7:0/7to0/6:0/6to0/5:0/5to0/4:0/4to0/3:0/3to0/2:0/2to0/1:0/1to0/0:0/0to1/0:1/0to2/0:2/0to3/0:3/0to4/0:4/0to5/0:5/0to6/0:6/0to7/0:7/0to8/0:8/0to9/0:9/0to10/0:10/0to11/0:11/0to12/0:12/0to13/0:13/0to14/0:14/0to15/0:15/0tobottom15:,32,True,True
96,382,760,378,left15to0/15,15/0tobottom15,left15to0/15:0/15to1/15:1/15to2/15:2/15to3/15:3/15to4/15:4/15to5/15:5/15to6/15:6/15to7/15:7/15to8/15:8/15to9/15:9/15to10/15:10/15to10/14:10/14to10/13:10/13to10/12:10/12to10/11:10/11to10/10:10/10to10/9:10/9to10/8:10/8to10/7:10/7to10/6:10/6to10/5:10/5to10/4:10/4to10/3:10/3to10/2:10/2to10/1:10/1to10/0:10/0to11/0:11/0to12/0:12/0to13/0:13/0to14/0:14/0to15/0:15/0tobottom15:,32,False,True
2632,382,613,231,11/5to11/4,3/12to4/12,11/5to11/4:11/4to11/5:11/5to10/5:10/5to9/5:9/5to8/5:8/5to7/5:7/5to6/5:6/5to5/5:5/5to4/5:4/5to3/5:3/5to3/6:3/6to3/7:3/7to3/8:3/8to3/9:3/9to3/10:3/10to3/11:3/11to3/12:3/12to4/12:,18,True,True
3066,383,567,184,2/13to2/12,5/2to6/2,2/13to2/12:2/12to2/11:2/11to2/10:2/10to2/9:2/9to2/8:2/8to2/7:2/7to2/6:2/6to2/5:2/5to2/4:2/4to2/3:2/3to2/2:2/2to3/2:3/2to4/2:4/2to5/2:5/2to6/2:,15,False,True
1201,383,520,137,5/11to6/11,10/7to10/6,5/11to6/11:6/11to7/11:7/11to8/11:8/11to9/11:9/11to10/11:10/11to10/10:10/10to10/9:10/9to10/8:10/8to10/7:10/7to10/6:,10,False,True
2747,383,517,134,12/11to11/11,10/5to11/5,12/11to11/11:11/11to10/11:10/11to10/10:10/10to10/9:10/9to10/8:10/8to10/7:10/7to10/6:10/6to10/5:10/5to11/5:,9,False,True
2907,383,562,179,6/7to6/6,10/14to10/15,6/7to6/6:6/6to7/6:7/6to8/6:8/6to9/6:9/6to10/6:10/6to10/7:10/7to10/8:10/8to10/9:10/9to10/10:10/10to10/11:10/11to10/12:10/12to10/13:10/13to10/14:10/14to10/15:,14,False,True
3121,384,523,139,left4to0/4,0/15toleft15,left4to0/4:0/4to0/5:0/5to0/6:0/6to0/7:0/7to0/8:0/8to0/9:0/9to0/10:0/10to0/11:0/11to0/12:0/12to0/13:0/13to0/14:0/14to0/15:0/15toleft15:,13,True,True
3240,384,562,178,5/12to5/11,11/5to11/6,5/12to5/11:5/11to6/11:6/11to7/11:7/11to8/11:8/11to9/11:9/11to10/11:10/11to10/10:10/10to10/9:10/9to10/8:10/8to10/7:10/7to10/6:10/6to10/5:10/5to11/5:11/5to11/6:,14,False,True
1299,384,449,65,top1to1/15,4/14to4/13,top1to1/15:1/15to1/14:1/14to2/14:2/14to3/14:3/14to4/14:4/14to4/13:,6,False,True
3290,384,446,62,8/5to8/6,7/8to6/8,8/5to8/6:8/6to7/6:7/6to7/7:7/7to7/8:7/8to6/8:,5,True,True
2583,385,521,136,bottom5to5/0,0/5to0/6,bottom5to5/0:5/0to4/0:4/0to3/0:3/0to2/0:2/0to1/0:1/0to0/0:0/0to0/1:0/1to0/2:0/2to0/3:0/3to0/4:0/4to0/5:0/5to0/6:,12,False,True
2096,385,621,236,0/7to0/8,11/6to11/5,0/7to0/8:0/8to1/8:1/8to2/8:2/8to3/8:3/8to4/8:4/8to5/8:5/8to6/8:6/8to7/8:7/8to8/8:8/8to9/8:9/8to10/8:10/8to10/7:10/7to10/6:10/6to11/6:11/6to11/5:,15,False,True
67,386,769,383,left15to0/15,15/0tobottom15,left15to0/15:0/15to1/15:1/15to2/15:2/15to3/15:3/15to4/15:4/15to5/15:5/15to6/15:6/15to7/15:7/15to8/15:8/15to9/15:9/15to10/15:10/15to10/14:10/14to10/13:10/13to10/12:10/12to10/11:10/11to10/10:10/10to10/9:10/9to10/8:10/8to10/7:10/7to10/6:10/6to10/5:10/5to10/4:10/4to10/3:10/3to10/2:10/2to10/1:10/1to10/0:10/0to11/0:11/0to12/0:12/0to13/0:13/0to14/0:14/0to15/0:15/0tobottom15:,32,False,True
2110,386,499,113,15/14to14/14,10/11to9/11,15/14to14/14:14/14to13/14:13/14to12/14:12/14to12/13:12/13to12/12:12/12to11/12:11/12to10/12:10/12to10/11:10/11to9/11:,9,True,True
1444,386,513,127,5/1to5/2,6/10to6/11,5/1to5/2:5/2to5/3:5/3to5/4:5/4to5/5:5/5to5/6:5/6to5/7:5/7to5/8:5/8to5/9:5/9to5/10:5/10to6/10:6/10to6/11:,11,True,True
867,386,508,122,7/2to6/2,8/8to9/8,7/2to6/2:6/2to6/3:6/3to6/4:6/4to6/5:6/5to6/6:6/6to6/7:6/7to6/8:6/8to7/8:7/8to8/8:8/8to9/8:,10,False,True
3368,386,547,161,15/7to14/7,6/10to6/11,15/7to14/7:14/7to13/7:13/7to12/7:12/7to11/7:11/7to10/7:10/7to9/7:9/7to8/7:8/7to7/7:7/7to6/7:6/7to6/8:6/8to6/9:6/9to6/10:6/10to6/11:,13,False,True
2526,386,499,113,14/6to13/6,13/14to14/14,14/6to13/6:13/6to13/7:13/7to13/8:13/8to13/9:13/9to13/10:13/10to13/11:13/11to13/12:13/12to13/13:13/13to13/14:13/14to14/14:,10,False,True
2436,387,619,232,2/13to1/13,7/2to8/2,2/13to1/13:1/13to1/12:1/12to1/11:1/11to1/10:1/10to1/9:1/9to1/8:1/8to1/7:1/7to1/6:1/6to1/5:1/5to1/4:1/4to1/3:1/3to1/2:1/2to2/2:2/2to3/2:3/2to4/2:4/2to5/2:5/2to6/2:6/2to7/2:7/2to8/2:,19,False,True
761,388,449,61,6/14to6/13,7/11to8/11,6/14to6/13:6/13to6/12:6/12to6/11:6/11to7/11:7/11to8/11:,5,False,True
476,388,596,208,12/11to12/10,3/13to4/13,12/11to12/10:12/10to11/10:11/10to10/10:10/10to9/10:9/10to8/10:8/10to7/10:7/10to6/10:6/10to5/10:5/10to4/10:4/10to3/10:3/10to3/11:3/11to3/12:3/12to3/13:3/13to4/13:,14,False,True
339,388,789,401,right0to15/0,0/15totop0,right0to15/0:15/0to14/0:14/0to13/0:13/0to12/0:12/0to11/0:11/0to10/0:10/0to9/0:9/0to8/0:8/0to7/0:7/0to6/0:6/0to5/0:5/0to4/0:4/0to3/0:3/0to2/0:2/0to1/0:1/0to0/0:0/0to0/1:0/1to0/2:0/2to0/3:0/3to0/4:0/4to0/5:0/5to0/6:0/6to0/7:0/7to0/8:0/8to0/9:0/9to0/10:0/10to0/11:0/11to0/12:0/12to0/13:0/13to0/14:0/14to0/15:0/15totop0:,32,False,True
1245,388,650,262,7/5to8/5,12/14to13/14,7/5to8/5:8/5to8/6:8/6to8/7:8/7to8/8:8/8to8/9:8/9to8/10:8/10to8/11:8/11to8/12:8/12to8/13:8/13to9/13:9/13to10/13:10/13to10/14:10/14to11/14:11/14to12/14:12/14to13/14:,15,True,True
3343,389,572,183,2/9to1/9,8/4to8/3,2/9to1/9:1/9to1/8:1/8to1/7:1/7to1/6:1/6to1/5:1/5to1/4:1/4to2/4:2/4to3/4:3/4to4/4:4/4to5/4:5/4to6/4:6/4to7/4:7/4to8/4:8/4to8/3:,14,False,True
1296,389,559,170,1/3to1/4,6/11to7/11,1/3to1/4:1/4to1/5:1/5to1/6:1/6to1/7:1/7to1/8:1/8to1/9:1/9to1/10:1/10to1/11:1/11to2/11:2/11to3/11:3/11to4/11:4/11to5/11:5/11to6/11:6/11to7/11:,14,True,True
1952,389,470,81,13/8to12/8,12/13to12/14,13/8to12/8:12/8to12/9:12/9to12/10:12/10to12/11:12/11to12/12:12/12to12/13:12/13to12/14:,7,True,True
607,389,525,136,8/12to8/13,7/5to7/4,8/12to8/13:8/13to7/13:7/13to7/12:7/12to7/11:7/11to7/10:7/10to7/9:7/9to7/8:7/8to7/7:7/7to7/6:7/6to7/5:7/5to7/4:,11,True,True
299,389,806,417,right15to15/15,0/0tobottom0,right15to15/15:15/15to14/15:14/15to13/15:13/15to12/15:12/15to11/15:11/15to10/15:10/15to9/15:9/15to8/15:8/15to7/15:7/15to6/15:6/15to5/15:5/15to4/15:4/15to3/15:3/15to2/15:2/15to1/15:1/15to0/15:0/15to0/14:0/14to0/13:0/13to0/12:0/12to0/11:0/11to0/10:0/10to0/9:0/9to0/8:0/8to0/7:0/7to0/6:0/6to0/5:0/5to0/4:0/4to0/3:0/3to0/2:0/2to0/1:0/1to0/0:0/0tobottom0:,32,True,True
2413,390,568,178,8/9to8/10,13/2to14/2,8/9to8/10:8/10to9/10:9/10to10/10:10/10to10/9:10/9to10/8:10/8to10/7:10/7to10/6:10/6to10/5:10/5to10/4:10/4to10/3:10/3to10/2:10/2to11/2:11/2to12/2:12/2to13/2:13/2to14/2:,15,False,True
2850,390,608,218,4/8to4/9,15/13toright13,4/8to4/9:4/9to5/9:5/9to6/9:6/9to7/9:7/9to8/9:8/9to9/9:9/9to10/9:10/9to10/10:10/10to10/11:10/11to10/12:10/12to10/13:10/13to11/13:11/13to12/13:12/13to13/13:13/13to14/13:14/13to15/13:15/13toright13:,17,False,True
3385,390,566,176,7/11to8/11,15/6to15/7,7/11to8/11:8/11to9/11:9/11to10/11:10/11to10/10:10/10to10/9:10/9to10/8:10/8to10/7:10/7to10/6:10/6to11/6:11/6to12/6:12/6to13/6:13/6to14/6:14/6to15/6:15/6to15/7:,14,False,True
0,390,779,389,left15to0/15,15/0tobottom15,left15to0/15:0/15to0/14:0/14to0/13:0/13to0/12:0/12to0/11:0/11to0/10:0/10to0/9:0/9to0/8:0/8to0/7:0/7to0/6:0/6to0/5:0/5to0/4:0/4to0/3:0/3to0/2:0/2to0/1:0/1to0/0:0/0to1/0:1/0to2/0:2/0to3/0:3/0to4/0:4/0to5/0:5/0to6/0:6/0to7/0:7/0to8/0:8/0to9/0:9/0to10/0:10/0to11/0:11/0to12/0:12/0to13/0:13/0to14/0:14/0to15/0:15/0tobottom15:,32,True,True
1995,391,523,132,11/2to11/3,7/7to8/7,11/2to11/3:11/3to10/3:10/3to9/3:9/3to8/3:8/3to7/3:7/3to7/4:7/4to7/5:7/5to7/6:7/6to7/7:7/7to8/7:,10,False,True
1099,391,634,243,0/15to0/14,6/3to7/3,0/15to0/14:0/14to0/13:0/13to0/12:0/12to0/11:0/11to0/10:0/10to0/9:0/9to0/8:0/8to0/7:0/7to0/6:0/6to0/5:0/5to0/4:0/4to0/3:0/3to1/3:1/3to2/3:2/3to3/3:3/3to4/3:4/3to5/3:5/3to6/3:6/3to7/3:,19,False,True
3080,391,489,98,15/1to15/2,11/4to11/5,15/1to15/2:15/2to14/2:14/2to13/2:13/2to12/2:12/2to11/2:11/2to11/3:11/3to11/4:11/4to11/5:,8,False,True
3397,391,607,216,0/6to0/7,15/8toright8,0/6to0/7:0/7to1/7:1/7to2/7:2/7to3/7:3/7to4/7:4/7to5/7:5/7to6/7:6/7to7/7:7/7to8/7:8/7to9/7:9/7to10/7:10/7to10/8:10/8to11/8:11/8to12/8:12/8to13/8:13/8to14/8:14/8to15/8:15/8toright8:,18,False,True
881,392,700,308,2/13to2/14,11/0to11/1,2/13to2/14:2/14to3/14:3/14to4/14:4/14to5/14:5/14to6/14:6/14to7/14:7/14to8/14:8/14to9/14:9/14to10/14:10/14to10/13:10/13to10/12:10/12to10/11:10/11to10/10:10/10to10/9:10/9to10/8:10/8to10/7:10/7to10/6:10/6to10/5:10/5to10/4:10/4to10/3:10/3to10/2:10/2to10/1:10/1to10/0:10/0to11/0:11/0to11/1:,25,False,True
1395,392,625,233,top0to0/15,5/2to5/1,top0to0/15:0/15to0/14:0/14to0/13:0/13to0/12:0/12to0/11:0/11to0/10:0/10to0/9:0/9to0/8:0/8to0/7:0/7to0/6:0/6to0/5:0/5to0/4:0/4to0/3:0/3to0/2:0/2to1/2:1/2to2/2:2/2to3/2:3/2to4/2:4/2to5/2:5/2to5/1:,20,False,True
2531,392,528,136,3/5to4/5,9/1to10/1,3/5to4/5:4/5to4/4:4/4to4/3:4/3to4/2:4/2to4/1:4/1to5/1:5/1to6/1:6/1to7/1:7/1to8/1:8/1to9/1:9/1to10/1:,11,False,True
1232,393,557,164,left15to0/15,2/6to2/7,left15to0/15:0/15to0/14:0/14to0/13:0/13to0/12:0/12to0/11:0/11to0/10:0/10to0/9:0/9to0/8:0/8to0/7:0/7to0/6:0/6to1/6:1/6to2/6:2/6to2/7:,13,False,True
1206,393,549,156,11/14to10/14,10/7to10/6,11/14to10/14:10/14to10/13:10/13to11/13:11/13to11/12:11/12to11/11:11/11to11/10:11/10to11/9:11/9to11/8:11/8to10/8:10/8to10/7:10/7to10/6:,11,True,True
417,393,428,35,8/3to9/3,9/2to8/2,8/3to9/3:9/3to9/2:9/2to8/2:,3,False,True
2505,393,702,309,7/3to7/2,10/10to10/11,7/3to7/2:7/2to7/3:7/3to7/4:7/4to7/5:7/5to7/6:7/6to7/7:7/7to7/8:7/8to7/9:7/9to7/10:7/10to8/10:8/10to9/10:9/10to10/10:10/10to10/11:,13,True,True
3395,393,459,66,bottom3to3/0,4/3to5/3,bottom3to3/0:3/0to3/1:3/1to3/2:3/2to3/3:3/3to4/3:4/3to5/3:,6,True,True
107,394,828,434,left0to0/0,15/15totop15,left0to0/0:0/0to1/0:1/0to2/0:2/0to3/0:3/0to4/0:4/0to5/0:5/0to6/0:6/0to7/0:7/0to8/0:8/0to9/0:9/0to10/0:10/0to10/1:10/1to10/2:10/2to10/3:10/3to10/4:10/4to10/5:10/5to10/6:10/6to10/7:10/7to10/8:10/8to10/9:10/9to10/10:10/10to10/11:10/11to10/12:10/12to10/13:10/13to10/14:10/14to10/15:10/15to11/15:11/15to12/15:12/15to13/15:13/15to14/15:14/15to15/15:15/15totop15:,32,False,True
1012,394,628,234,12/6to11/6,1/8to1/9,12/6to11/6:11/6to10/6:10/6to9/6:9/6to8/6:8/6to7/6:7/6to6/6:6/6to5/6:5/6to4/6:4/6to3/6:3/6to2/6:2/6to1/6:1/6to1/7:1/7to1/8:1/8to1/9:,14,True,True
973,394,477,83,2/1to2/2,2/7to2/8,2/1to2/2:2/2to2/3:2/3to2/4:2/4to2/5:2/5to2/6:2/6to2/7:2/7to2/8:,7,False,True
970,395,454,59,6/7to6/8,6/11to5/11,6/7to6/8:6/8to6/9:6/9to6/10:6/10to6/11:6/11to5/11:,5,True,True
717,395,570,175,9/4to9/3,7/15totop7,9/4to9/3:9/3to8/3:8/3to7/3:7/3to7/4:7/4to7/5:7/5to7/6:7/6to7/7:7/7to7/8:7/8to7/9:7/9to7/10:7/10to7/11:7/11to7/12:7/12to7/13:7/13to7/14:7/14to7/15:7/15totop7:,16,True,True
1049,395,670,275,right11to15/11,0/10toleft10,right11to15/11:15/11to14/11:14/11to13/11:13/11to12/11:12/11to11/11:11/11to10/11:10/11to9/11:9/11to8/11:8/11to7/11:7/11to6/11:6/11to5/11:5/11to4/11:4/11to3/11:3/11to2/11:2/11to1/11:1/11to0/11:0/11to0/10:0/10toleft10:,18,False,True
1815,395,693,298,13/11to13/12,7/3to6/3,13/11to13/12:13/12to12/12:12/12to11/12:11/12to10/12:10/12to9/12:9/12to8/12:8/12to7/12:7/12to7/11:7/11to7/10:7/10to7/9:7/9to7/8:7/8to7/7:7/7to7/6:7/6to7/5:7/5to7/4:7/4to7/3:7/3to6/3:,17,True,True
1258,396,572,176,11/14to11/15,8/5to7/5,11/14to11/15:11/15to10/15:10/15to9/15:9/15to8/15:8/15to8/14:8/14to8/13:8/13to8/12:8/12to8/11:8/11to8/10:8/10to8/9:8/9to8/8:8/8to8/7:8/7to8/6:8/6to8/5:8/5to7/5:,15,True,True
605,396,443,47,0/15to0/14,2/14to2/13,0/15to0/14:0/14to1/14:1/14to2/14:2/14to2/13:,4,True,True
272,397,812,415,right15to15/15,0/0tobottom0,right15to15/15:15/15to14/15:14/15to13/15:13/15to12/15:12/15to11/15:11/15to10/15:10/15to9/15:9/15to8/15:8/15to7/15:7/15to6/15:6/15to5/15:5/15to4/15:4/15to3/15:3/15to2/15:2/15to1/15:1/15to0/15:0/15to0/14:0/14to0/13:0/13to0/12:0/12to0/11:0/11to0/10:0/10to0/9:0/9to0/8:0/8to0/7:0/7to0/6:0/6to0/5:0/5to0/4:0/4to0/3:0/3to0/2:0/2to0/1:0/1to0/0:0/0tobottom0:,32,True,True
746,397,562,165,4/3to4/2,1/11to0/11,4/3to4/2:4/2to3/2:3/2to2/2:2/2to1/2:1/2to1/3:1/3to1/4:1/4to1/5:1/5to1/6:1/6to1/7:1/7to1/8:1/8to1/9:1/9to1/10:1/10to1/11:1/11to0/11:,14,False,True
2059,397,636,239,left12to0/12,8/4to8/5,left12to0/12:0/12to0/11:0/11to0/10:0/10to0/9:0/9to0/8:0/8to0/7:0/7to0/6:0/6to0/5:0/5to0/4:0/4to1/4:1/4to2/4:2/4to3/4:3/4to4/4:4/4to5/4:5/4to6/4:6/4to7/4:7/4to8/4:8/4to8/5:,18,True,True
1433,397,517,120,0/10to1/10,7/10to7/9,0/10to1/10:1/10to2/10:2/10to3/10:3/10to4/10:4/10to5/10:5/10to6/10:6/10to7/10:7/10to7/9:,8,False,True
2541,398,717,319,0/13to0/14,11/2to12/2,0/13to0/14:0/14to1/14:1/14to2/14:2/14to3/14:3/14to4/14:4/14to5/14:5/14to6/14:6/14to7/14:7/14to8/14:8/14to9/14:9/14to10/14:10/14to10/13:10/13to10/12:10/12to10/11:10/11to10/10:10/10to10/9:10/9to10/8:10/8to10/7:10/7to10/6:10/6to10/5:10/5to10/4:10/4to10/3:10/3to10/2:10/2to11/2:11/2to12/2:,25,False,True
2619,398,606,208,13/15to13/14,2/12to1/12,13/15to13/14:13/14to12/14:12/14to11/14:11/14to10/14:10/14to9/14:9/14to8/14:8/14to7/14:7/14to6/14:6/14to5/14:5/14to4/14:4/14to3/14:3/14to2/14:2/14to2/13:2/13to2/12:2/12to1/12:,15,True,True
162,398,830,432,left0to0/0,15/15totop15,left0to0/0:0/0to1/0:1/0to2/0:2/0to3/0:3/0to4/0:4/0to5/0:5/0to6/0:6/0to7/0:7/0to8/0:8/0to9/0:9/0to10/0:10/0to10/1:10/1to10/2:10/2to10/3:10/3to10/4:10/4to10/5:10/5to10/6:10/6to10/7:10/7to10/8:10/8to10/9:10/9to10/10:10/10to10/11:10/11to10/12:10/12to10/13:10/13to10/14:10/14to10/15:10/15to11/15:11/15to12/15:12/15to13/15:13/15to14/15:14/15to15/15:15/15totop15:,32,False,True
2985,398,577,179,7/6to8/6,14/5to14/6,7/6to8/6:8/6to8/5:8/5to9/5:9/5to10/5:10/5to11/5:11/5to12/5:12/5to13/5:13/5to14/5:14/5to14/6:,9,True,True
618,399,576,177,1/15to1/14,7/8to8/8,1/15to1/14:1/14to1/13:1/13to1/12:1/12to1/11:1/11to1/10:1/10to1/9:1/9to1/8:1/8to2/8:2/8to3/8:3/8to4/8:4/8to5/8:5/8to6/8:6/8to7/8:7/8to8/8:,14,False,True
106,399,848,449,left0to0/0,15/15totop15,left0to0/0:0/0to1/0:1/0to2/0:2/0to3/0:3/0to4/0:4/0to5/0:5/0to6/0:6/0to7/0:7/0to8/0:8/0to9/0:9/0to10/0:10/0to10/1:10/1to10/2:10/2to10/3:10/3to10/4:10/4to10/5:10/5to10/6:10/6to10/7:10/7to10/8:10/8to10/9:10/9to10/10:10/10to10/11:10/11to10/12:10/12to10/13:10/13to10/14:10/14to10/15:10/15to11/15:11/15to12/15:12/15to13/15:13/15to14/15:14/15to15/15:15/15totop15:,32,False,True
45,399,771,372,left15to0/15,15/0tobottom15,left15to0/15:0/15to1/15:1/15to2/15:2/15to3/15:3/15to4/15:4/15to5/15:5/15to6/15:6/15to7/15:7/15to8/15:8/15to9/15:9/15to10/15:10/15to10/14:10/14to10/13:10/13to10/12:10/12to10/11:10/11to10/10:10/10to10/9:10/9to10/8:10/8to10/7:10/7to10/6:10/6to10/5:10/5to10/4:10/4to10/3:10/3to10/2:10/2to10/1:10/1to10/0:10/0to11/0:11/0to12/0:12/0to13/0:13/0to14/0:14/0to15/0:15/0tobottom15:,32,False,True
439,399,662,263,1/12to2/12,10/1to10/0,1/12to2/12:2/12to2/11:2/11to2/10:2/10to2/9:2/9to2/8:2/8to2/7:2/7to2/6:2/6to2/5:2/5to2/4:2/4to2/3:2/3to3/3:3/3to4/3:4/3to5/3:5/3to6/3:6/3to7/3:7/3to8/3:8/3to9/3:9/3to10/3:10/3to10/2:10/2to10/1:10/1to10/0:,21,True,True
1961,399,485,86,6/10to5/10,3/7to4/7,6/10to5/10:5/10to4/10:4/10to3/10:3/10to3/9:3/9to3/8:3/8to3/7:3/7to4/7:,7,True,True
1449,400,568,168,9/14to10/14,13/6to13/7,9/14to10/14:10/14to10/13:10/13to10/12:10/12to10/11:10/11to10/10:10/10to10/9:10/9to10/8:10/8to10/7:10/7to10/6:10/6to11/6:11/6to12/6:12/6to13/6:13/6to13/7:,13,False,True
3234,400,572,172,12/15to12/14,7/7to6/7,12/15to12/14:12/14to11/14:11/14to10/14:10/14to9/14:9/14to8/14:8/14to7/14:7/14to7/13:7/13to7/12:7/12to7/11:7/11to7/10:7/10to7/9:7/9to7/8:7/8to7/7:7/7to6/7:,14,True,True
1878,400,566,166,5/1to6/1,13/3to14/3,5/1to6/1:6/1to7/1:7/1to8/1:8/1to9/1:9/1to10/1:10/1to10/2:10/2to10/3:10/3to11/3:11/3to12/3:12/3to13/3:13/3to14/3:,11,False,True
775,401,500,99,7/3to7/2,2/0tobottom2,7/3to7/2:7/2to6/2:6/2to5/2:5/2to4/2:4/2to3/2:3/2to2/2:2/2to2/1:2/1to2/0:2/0tobottom2:,9,False,True
1989,401,535,134,2/4to3/4,9/3to9/2,2/4to3/4:3/4to3/3:3/3to4/3:4/3to5/3:5/3to6/3:6/3to7/3:7/3to8/3:8/3to9/3:9/3to9/2:,9,True,True
3370,402,574,172,3/1to2/1,1/13to2/13,3/1to2/1:2/1to1/1:1/1to1/2:1/2to1/3:1/3to1/4:1/4to1/5:1/5to1/6:1/6to1/7:1/7to1/8:1/8to1/9:1/9to1/10:1/10to1/11:1/11to1/12:1/12to1/13:1/13to2/13:,15,True,True
483,402,487,85,3/5to4/5,5/0tobottom5,3/5to4/5:4/5to4/4:4/4to4/3:4/3to4/2:4/2to4/1:4/1to4/0:4/0to5/0:5/0tobottom5:,8,True,True
3278,403,678,275,13/9to13/10,4/7to4/6,13/9to13/10:13/10to12/10:12/10to11/10:11/10to10/10:10/10to9/10:9/10to8/10:8/10to7/10:7/10to6/10:6/10to5/10:5/10to4/10:4/10to4/9:4/9to4/8:4/8to4/7:4/7to4/6:,14,False,True
2074,403,706,303,13/10to13/11,9/6to9/7,13/10to13/11:13/11to12/11:12/11to12/10:12/10to12/9:12/9to12/8:12/8to12/7:12/7to12/6:12/6to11/6:11/6to10/6:10/6to9/6:9/6to9/7:,11,True,True
1909,403,534,131,12/7to11/7,14/13to15/13,12/7to11/7:11/7to11/8:11/8to11/9:11/9to11/10:11/10to11/11:11/11to11/12:11/12to11/13:11/13to12/13:12/13to13/13:13/13to14/13:14/13to15/13:,11,False,True
2696,404,684,280,left3to0/3,11/6to12/6,left3to0/3:0/3to1/3:1/3to2/3:2/3to3/3:3/3to4/3:4/3to5/3:5/3to6/3:6/3to7/3:7/3to8/3:8/3to9/3:9/3to10/3:10/3to10/4:10/4to10/5:10/5to10/6:10/6to11/6:11/6to12/6:,16,False,True
3174,404,444,40,12/11to13/11,13/12to13/13,12/11to13/11:13/11to13/12:13/12to13/13:,3,False,True
549,404,644,240,8/11to7/11,0/0tobottom0,8/11to7/11:7/11to6/11:6/11to5/11:5/11to4/11:4/11to3/11:3/11to2/11:2/11to1/11:1/11to0/11:0/11to0/10:0/10to0/9:0/9to0/8:0/8to0/7:0/7to0/6:0/6to0/5:0/5to0/4:0/4to0/3:0/3to0/2:0/2to0/1:0/1to0/0:0/0tobottom0:,20,True,True
1936,404,517,113,9/9to10/9,15/10toright10,9/9to10/9:10/9to11/9:11/9to12/9:12/9to12/10:12/10to13/10:13/10to14/10:14/10to15/10:15/10toright10:,8,True,True
1187,404,521,117,3/12to4/12,5/5to5/6,3/12to4/12:4/12to4/11:4/11to4/10:4/10to4/9:4/9to4/8:4/8to4/7:4/7to4/6:4/6to4/5:4/5to5/5:5/5to5/6:,10,False,True
1461,405,482,77,0/1to1/1,4/2to4/3,0/1to1/1:1/1to1/2:1/2to2/2:2/2to3/2:3/2to4/2:4/2to4/3:,6,False,True
2739,405,608,203,7/14to8/14,12/3to13/3,7/14to8/14:8/14to9/14:9/14to10/14:10/14to10/13:10/13to10/12:10/12to10/11:10/11to10/10:10/10to10/9:10/9to10/8:10/8to10/7:10/7to10/6:10/6to10/5:10/5to10/4:10/4to10/3:10/3to11/3:11/3to12/3:12/3to13/3:,17,False,True
2071,405,594,189,5/0to6/0,6/13to5/13,5/0to6/0:6/0to6/1:6/1to6/2:6/2to6/3:6/3to6/4:6/4to6/5:6/5to6/6:6/6to6/7:6/7to6/8:6/8to6/9:6/9to6/10:6/10to6/11:6/11to6/12:6/12to6/13:6/13to5/13:,15,True,True
2050,405,577,172,6/7to6/8,11/11to12/11,6/7to6/8:6/8to7/8:7/8to8/8:8/8to9/8:9/8to10/8:10/8to10/9:10/9to10/10:10/10to10/11:10/11to11/11:11/11to12/11:,10,False,True
206,406,778,372,right15to15/15,0/0tobottom0,right15to15/15:15/15to14/15:14/15to13/15:13/15to12/15:12/15to11/15:11/15to11/14:11/14to10/14:10/14to9/14:9/14to8/14:8/14to7/14:7/14to6/14:6/14to5/14:5/14to4/14:4/14to3/14:3/14to2/14:2/14to1/14:1/14to0/14:0/14to0/13:0/13to0/12:0/12to0/11:0/11to0/10:0/10to0/9:0/9to0/8:0/8to0/7:0/7to0/6:0/6to0/5:0/5to0/4:0/4to0/3:0/3to0/2:0/2to0/1:0/1to0/0:0/0tobottom0:,32,True,True
1085,406,655,249,11/11to11/10,4/4to5/4,11/11to11/10:11/10to10/10:10/10to9/10:9/10to8/10:8/10to7/10:7/10to6/10:6/10to5/10:5/10to4/10:4/10to4/9:4/9to4/8:4/8to4/7:4/7to4/6:4/6to4/5:4/5to4/4:4/4to5/4:,15,True,True
1336,406,577,171,8/6to9/6,13/14to13/13,8/6to9/6:9/6to10/6:10/6to10/7:10/7to10/8:10/8to10/9:10/9to10/10:10/10to10/11:10/11to10/12:10/12to10/13:10/13to10/14:10/14to11/14:11/14to12/14:12/14to13/14:13/14to13/13:,14,False,True
2681,406,485,79,11/6to12/6,13/9to14/9,11/6to12/6:12/6to12/7:12/7to12/8:12/8to12/9:12/9to13/9:13/9to14/9:,6,True,True
2082,406,669,263,1/1to1/0,10/10to9/10,1/1to1/0:1/0to2/0:2/0to3/0:3/0to4/0:4/0to5/0:5/0to6/0:6/0to7/0:7/0to8/0:8/0to9/0:9/0to10/0:10/0to10/1:10/1to10/2:10/2to10/3:10/3to10/4:10/4to10/5:10/5to10/6:10/6to10/7:10/7to10/8:10/8to10/9:10/9to10/10:10/10to9/10:,21,False,True
83,407,787,380,left15to0/15,15/0tobottom15,left15to0/15:0/15to0/14:0/14to0/13:0/13to0/12:0/12to0/11:0/11to0/10:0/10to0/9:0/9to0/8:0/8to0/7:0/7to0/6:0/6to0/5:0/5to0/4:0/4to0/3:0/3to0/2:0/2to0/1:0/1to0/0:0/0to1/0:1/0to2/0:2/0to3/0:3/0to4/0:4/0to5/0:5/0to6/0:6/0to7/0:7/0to8/0:8/0to9/0:9/0to10/0:10/0to11/0:11/0to12/0:12/0to13/0:13/0to14/0:14/0to15/0:15/0tobottom15:,32,True,True
1883,407,562,155,7/7to7/8,11/2to11/1,7/7to7/8:7/8to7/7:7/7to7/6:7/6to7/5:7/5to7/4:7/4to7/3:7/3to8/3:8/3to9/3:9/3to10/3:10/3to10/2:10/2to11/2:11/2to11/1:,12,True,True
1161,407,653,246,11/4to11/5,5/4to6/4,11/4to11/5:11/5to10/5:10/5to9/5:9/5to8/5:8/5to7/5:7/5to6/5:6/5to5/5:5/5to5/4:5/4to6/4:,9,False,True
2851,408,590,182,12/1to12/0,2/0tobottom2,12/1to12/0:12/0to11/0:11/0to10/0:10/0to9/0:9/0to8/0:8/0to7/0:7/0to6/0:6/0to5/0:5/0to4/0:4/0to3/0:3/0to2/0:2/0tobottom2:,12,False,True
998,408,433,25,12/2to12/1,12/1to12/2,12/2to12/1:12/1to12/2:,2,True,True
975,409,714,305,2/3to2/2,10/14to9/14,2/3to2/2:2/2to3/2:3/2to4/2:4/2to5/2:5/2to6/2:6/2to7/2:7/2to8/2:8/2to9/2:9/2to10/2:10/2to10/3:10/3to10/4:10/4to10/5:10/5to10/6:10/6to10/7:10/7to10/8:10/8to10/9:10/9to10/10:10/10to10/11:10/11to10/12:10/12to10/13:10/13to10/14:10/14to9/14:,22,False,True
2281,409,817,408,13/5to13/6,0/1to1/1,13/5to13/6:13/6to12/6:12/6to11/6:11/6to10/6:10/6to9/6:9/6to8/6:8/6to7/6:7/6to6/6:6/6to5/6:5/6to4/6:4/6to3/6:3/6to2/6:2/6to1/6:1/6to0/6:0/6to0/5:0/5to0/4:0/4to0/3:0/3to0/2:0/2to0/1:0/1to1/1:,20,True,True
3259,410,591,181,11/1to10/1,8/12to7/12,11/1to10/1:10/1to9/1:9/1to8/1:8/1to8/2:8/2to8/3:8/3to8/4:8/4to8/5:8/5to8/6:8/6to8/7:8/7to8/8:8/8to8/9:8/9to8/10:8/10to8/11:8/11to8/12:8/12to7/12:,15,True,True
1702,410,600,190,10/9to9/9,2/4to3/4,10/9to9/9:9/9to8/9:8/9to7/9:7/9to6/9:6/9to5/9:5/9to4/9:4/9to3/9:3/9to2/9:2/9to2/8:2/8to2/7:2/7to2/6:2/6to2/5:2/5to2/4:2/4to3/4:,14,True,True
3279,410,672,262,3/11to4/11,13/2to14/2,3/11to4/11:4/11to5/11:5/11to6/11:6/11to7/11:7/11to8/11:8/11to9/11:9/11to10/11:10/11to10/10:10/10to10/9:10/9to10/8:10/8to10/7:10/7to10/6:10/6to10/5:10/5to10/4:10/4to10/3:10/3to10/2:10/2to11/2:11/2to12/2:12/2to13/2:13/2to14/2:,20,False,True
1283,411,616,205,left0to0/0,12/3to12/2,left0to0/0:0/0to0/1:0/1to1/1:1/1to2/1:2/1to3/1:3/1to4/1:4/1to5/1:5/1to6/1:6/1to7/1:7/1to8/1:8/1to9/1:9/1to10/1:10/1to10/2:10/2to11/2:11/2to11/3:11/3to12/3:12/3to12/2:,17,True,True
3389,411,584,173,6/10to7/10,12/4to13/4,6/10to7/10:7/10to8/10:8/10to9/10:9/10to10/10:10/10to10/9:10/9to10/8:10/8to10/7:10/7to10/6:10/6to10/5:10/5to10/4:10/4to11/4:11/4to12/4:12/4to13/4:,13,False,True
818,411,603,192,10/11to10/10,14/0to15/0,10/11to10/10:10/10to10/9:10/9to10/8:10/8to11/8:11/8to12/8:12/8to12/7:12/7to12/6:12/6to12/5:12/5to12/4:12/4to12/3:12/3to12/2:12/2to12/1:12/1to12/0:12/0to13/0:13/0to14/0:14/0to15/0:,16,True,True
2414,411,512,101,9/0to8/0,4/2to3/2,9/0to8/0:8/0to7/0:7/0to6/0:6/0to5/0:5/0to4/0:4/0to4/1:4/1to4/2:4/2to3/2:,8,False,True
3263,412,499,87,5/10to5/11,2/11to2/10,5/10to5/11:5/11to4/11:4/11to3/11:3/11to2/11:2/11to2/10:,5,True,True
2469,412,543,131,6/7to6/6,11/6to11/7,6/7to6/6:6/6to7/6:7/6to8/6:8/6to9/6:9/6to10/6:10/6to11/6:11/6to11/7:,7,True,True
1170,414,515,101,9/13to9/12,13/11to14/11,9/13to9/12:9/12to9/11:9/11to10/11:10/11to11/11:11/11to12/11:12/11to13/11:13/11to14/11:,7,True,True
1966,414,611,197,15/1to15/0,4/1to5/1,15/1to15/0:15/0to14/0:14/0to13/0:13/0to12/0:12/0to11/0:11/0to10/0:10/0to9/0:9/0to8/0:8/0to7/0:7/0to6/0:6/0to5/0:5/0to4/0:4/0to4/1:4/1to5/1:,14,False,True
3144,414,632,218,0/8to0/7,9/2to10/2,0/8to0/7:0/7to0/6:0/6to0/5:0/5to0/4:0/4to0/3:0/3to0/2:0/2to1/2:1/2to2/2:2/2to3/2:3/2to4/2:4/2to5/2:5/2to6/2:6/2to7/2:7/2to8/2:8/2to9/2:9/2to10/2:,16,False,True
1731,416,643,227,left15to0/15,14/15to15/15,left15to0/15:0/15to0/14:0/14to1/14:1/14to2/14:2/14to3/14:3/14to4/14:4/14to5/14:5/14to6/14:6/14to7/14:7/14to8/14:8/14to9/14:9/14to10/14:10/14to11/14:11/14to11/15:11/15to12/15:12/15to13/15:13/15to14/15:14/15to15/15:,18,True,True
148,416,864,448,left0to0/0,15/15totop15,left0to0/0:0/0to0/1:0/1to0/2:0/2to0/3:0/3to0/4:0/4to0/5:0/5to0/6:0/6to0/7:0/7to0/8:0/8to0/9:0/9to0/10:0/10to0/11:0/11to0/12:0/12to0/13:0/13to1/13:1/13to2/13:2/13to3/13:3/13to4/13:4/13to5/13:5/13to6/13:6/13to7/13:7/13to8/13:8/13to9/13:9/13to10/13:10/13to10/14:10/14to11/14:11/14to11/15:11/15to12/15:12/15to13/15:13/15to14/15:14/15to15/15:15/15totop15:,32,True,True
2123,416,589,173,7/5to7/6,1/0tobottom1,7/5to7/6:7/6to6/6:6/6to5/6:5/6to4/6:4/6to3/6:3/6to2/6:2/6to1/6:1/6to1/5:1/5to1/4:1/4to1/3:1/3to1/2:1/2to1/1:1/1to1/0:1/0tobottom1:,14,True,True
541,416,712,296,15/14to14/14,10/3to11/3,15/14to14/14:14/14to13/14:13/14to12/14:12/14to11/14:11/14to10/14:10/14to10/13:10/13to10/12:10/12to10/11:10/11to10/10:10/10to10/9:10/9to10/8:10/8to10/7:10/7to10/6:10/6to10/5:10/5to10/4:10/4to10/3:10/3to11/3:,17,False,True
3192,416,657,241,0/3to0/4,12/2to13/2,0/3to0/4:0/4to1/4:1/4to2/4:2/4to3/4:3/4to4/4:4/4to5/4:5/4to6/4:6/4to7/4:7/4to8/4:8/4to9/4:9/4to10/4:10/4to10/3:10/3to10/2:10/2to11/2:11/2to12/2:12/2to13/2:,16,False,True
3214,416,521,105,3/14to3/13,6/11to6/12,3/14to3/13:3/13to3/12:3/12to3/11:3/11to4/11:4/11to5/11:5/11to6/11:6/11to6/12:,7,False,True
131,416,806,390,left0to0/0,15/15totop15,left0to0/0:0/0to0/1:0/1to0/2:0/2to0/3:0/3to0/4:0/4to0/5:0/5to0/6:0/6to0/7:0/7to0/8:0/8to0/9:0/9to0/10:0/10to0/11:0/11to0/12:0/12to0/13:0/13to1/13:1/13to2/13:2/13to3/13:3/13to4/13:4/13to5/13:5/13to6/13:6/13to7/13:7/13to8/13:8/13to9/13:9/13to10/13:10/13to10/14:10/14to11/14:11/14to11/15:11/15to12/15:12/15to13/15:13/15to14/15:14/15to15/15:15/15totop15:,32,True,True
1365,416,476,60,9/4to10/4,9/5to8/5,9/4to10/4:10/4to10/5:10/5to9/5:9/5to8/5:,4,False,True
2010,417,476,59,10/7to10/8,10/11to11/11,10/7to10/8:10/8to10/9:10/9to10/10:10/10to10/11:10/11to11/11:,5,False,True
447,417,503,86,0/8to1/8,2/4to3/4,0/8to1/8:1/8to1/7:1/7to1/6:1/6to1/5:1/5to1/4:1/4to2/4:2/4to3/4:,7,True,True
77,417,790,373,left15to0/15,15/0tobottom15,left15to0/15:0/15to1/15:1/15to2/15:2/15to3/15:3/15to4/15:4/15to5/15:5/15to6/15:6/15to7/15:7/15to8/15:8/15to9/15:9/15to10/15:10/15to10/14:10/14to10/13:10/13to10/12:10/12to10/11:10/11to10/10:10/10to10/9:10/9to10/8:10/8to10/7:10/7to10/6:10/6to10/5:10/5to10/4:10/4to10/3:10/3to10/2:10/2to10/1:10/1to10/0:10/0to11/0:11/0to12/0:12/0to13/0:13/0to14/0:14/0to15/0:15/0tobottom15:,32,False,True
1287,417,605,188,4/14to5/14,11/8to12/8,4/14to5/14:5/14to5/13:5/13to5/12:5/12to5/11:5/11to5/10:5/10to5/9:5/9to5/8:5/8to6/8:6/8to7/8:7/8to8/8:8/8to9/8:9/8to10/8:10/8to11/8:11/8to12/8:,14,True,True
2035,417,599,182,14/11to13/11,9/4to9/3,14/11to13/11:13/11to12/11:12/11to11/11:11/11to11/10:11/10to11/9:11/9to11/8:11/8to11/7:11/7to11/6:11/6to11/5:11/5to10/5:10/5to10/4:10/4to9/4:9/4to9/3:,13,True,True
2098,418,705,287,13/11to13/12,7/4to7/3,13/11to13/12:13/12to12/12:12/12to11/12:11/12to10/12:10/12to9/12:9/12to8/12:8/12to7/12:7/12to7/11:7/11to7/10:7/10to7/9:7/9to7/8:7/8to7/7:7/7to7/6:7/6to7/5:7/5to7/4:7/4to7/3:,16,False,True
903,418,578,160,13/8to13/7,7/12to7/13,13/8to13/7:13/7to12/7:12/7to11/7:11/7to10/7:10/7to9/7:9/7to8/7:8/7to7/7:7/7to7/8:7/8to7/9:7/9to7/10:7/10to7/11:7/11to7/12:7/12to7/13:,13,True,True
2261,419,682,263,7/10to7/9,0/0tobottom0,7/10to7/9:7/9to6/9:6/9to5/9:5/9to4/9:4/9to3/9:3/9to2/9:2/9to1/9:1/9to0/9:0/9to0/8:0/8to0/7:0/7to0/6:0/6to0/5:0/5to0/4:0/4to0/3:0/3to0/2:0/2to0/1:0/1to0/0:0/0tobottom0:,18,False,True
1876,419,513,94,7/12to7/11,5/8to5/7,7/12to7/11:7/11to6/11:6/11to5/11:5/11to5/10:5/10to5/9:5/9to5/8:5/8to5/7:,7,True,True
388,420,813,393,right0to15/0,0/15totop0,right0to15/0:15/0to14/0:14/0to13/0:13/0to12/0:12/0to11/0:11/0to10/0:10/0to9/0:9/0to8/0:8/0to7/0:7/0to6/0:6/0to5/0:5/0to4/0:4/0to3/0:3/0to2/0:2/0to1/0:1/0to0/0:0/0to0/1:0/1to0/2:0/2to0/3:0/3to0/4:0/4to0/5:0/5to0/6:0/6to0/7:0/7to0/8:0/8to0/9:0/9to0/10:0/10to0/11:0/11to0/12:0/12to0/13:0/13to0/14:0/14to0/15:0/15totop0:,32,True,True
1851,420,492,72,7/10to7/11,10/10to9/10,7/10to7/11:7/11to8/11:8/11to9/11:9/11to10/11:10/11to10/10:10/10to9/10:,6,False,True
2295,420,509,89,9/5to9/6,8/2to9/2,9/5to9/6:9/6to8/6:8/6to8/5:8/5to8/4:8/4to8/3:8/3to8/2:8/2to9/2:,7,False,True
1630,420,711,291,9/14to8/14,0/0tobottom0,9/14to8/14:8/14to7/14:7/14to6/14:6/14to5/14:5/14to4/14:4/14to3/14:3/14to2/14:2/14to1/14:1/14to0/14:0/14to0/13:0/13to0/12:0/12to0/11:0/11to0/10:0/10to0/9:0/9to0/8:0/8to0/7:0/7to0/6:0/6to0/5:0/5to0/4:0/4to0/3:0/3to0/2:0/2to0/1:0/1to0/0:0/0tobottom0:,24,True,True
1904,420,464,44,left0to0/0,1/1to1/0,left0to0/0:0/0to0/1:0/1to1/1:1/1to1/0:,4,False,True
1959,420,697,277,right6to15/6,8/11to8/12,right6to15/6:15/6to14/6:14/6to13/6:13/6to12/6:12/6to11/6:11/6to10/6:10/6to9/6:9/6to8/6:8/6to8/7:8/7to8/8:8/8to8/9:8/9to8/10:8/10to8/11:8/11to8/12:,14,True,True
994,420,648,228,12/13to11/13,7/2to6/2,12/13to11/13:11/13to10/13:10/13to9/13:9/13to8/13:8/13to7/13:7/13to7/12:7/12to7/11:7/11to7/10:7/10to7/9:7/9to7/8:7/8to7/7:7/7to7/6:7/6to7/5:7/5to7/4:7/4to7/3:7/3to7/2:7/2to6/2:,17,False,True
139,421,862,441,left0to0/0,15/15totop15,left0to0/0:0/0to1/0:1/0to2/0:2/0to3/0:3/0to4/0:4/0to5/0:5/0to6/0:6/0to7/0:7/0to8/0:8/0to9/0:9/0to10/0:10/0to10/1:10/1to10/2:10/2to10/3:10/3to10/4:10/4to10/5:10/5to10/6:10/6to10/7:10/7to10/8:10/8to10/9:10/9to10/10:10/10to10/11:10/11to10/12:10/12to10/13:10/13to10/14:10/14to10/15:10/15to11/15:11/15to12/15:12/15to13/15:13/15to14/15:14/15to15/15:15/15totop15:,32,False,True
2359,421,757,336,6/6to6/5,15/8toright8,6/6to6/5:6/5to7/5:7/5to8/5:8/5to9/5:9/5to10/5:10/5to10/6:10/6to10/7:10/7to10/8:10/8to11/8:11/8to12/8:12/8to13/8:13/8to14/8:14/8to15/8:15/8toright8:,14,False,True
531,421,608,187,4/8to4/7,14/6to14/5,4/8to4/7:4/7to5/7:5/7to6/7:6/7to7/7:7/7to8/7:8/7to9/7:9/7to10/7:10/7to11/7:11/7to11/6:11/6to12/6:12/6to13/6:13/6to14/6:14/6to14/5:,13,True,True
668,421,568,147,12/2to11/2,5/0to4/0,12/2to11/2:11/2to10/2:10/2to9/2:9/2to8/2:8/2to7/2:7/2to6/2:6/2to5/2:5/2to5/1:5/1to5/0:5/0to4/0:,10,True,True
2171,421,575,154,13/10to12/10,9/15to9/14,13/10to12/10:12/10to11/10:11/10to10/10:10/10to10/11:10/11to10/12:10/12to10/13:10/13to10/14:10/14to10/15:10/15to9/15:9/15to9/14:,10,False,True
1420,421,597,176,9/5to9/4,15/8toright8,9/5to9/4:9/4to10/4:10/4to10/5:10/5to10/6:10/6to10/7:10/7to10/8:10/8to11/8:11/8to12/8:12/8to13/8:13/8to14/8:14/8to15/8:15/8toright8:,12,False,True
2410,422,625,203,7/0to7/1,12/9to13/9,7/0to7/1:7/1to7/2:7/2to7/3:7/3to7/4:7/4to7/5:7/5to7/6:7/6to7/7:7/7to7/8:7/8to8/8:8/8to9/8:9/8to10/8:10/8to10/9:10/9to11/9:11/9to12/9:12/9to13/9:,15,True,True
1888,422,661,239,bottom3to3/0,8/13to8/14,bottom3to3/0:3/0to3/1:3/1to3/2:3/2to3/3:3/3to3/4:3/4to3/5:3/5to3/6:3/6to3/7:3/7to3/8:3/8to3/9:3/9to3/10:3/10to3/11:3/11to3/12:3/12to3/13:3/13to4/13:4/13to5/13:5/13to6/13:6/13to7/13:7/13to8/13:8/13to8/14:,20,True,True
2282,422,609,187,11/8to11/9,3/7to3/6,11/8to11/9:11/9to10/9:10/9to9/9:9/9to8/9:8/9to7/9:7/9to6/9:6/9to5/9:5/9to4/9:4/9to3/9:3/9to3/8:3/8to3/7:3/7to3/6:,12,True,True
2317,422,584,162,11/15to10/15,10/9to9/9,11/15to10/15:10/15to10/14:10/14to10/13:10/13to11/13:11/13to11/12:11/12to11/11:11/11to10/11:10/11to10/10:10/10to10/9:10/9to9/9:,10,True,True
2497,423,737,314,15/5to15/6,2/6to2/7,15/5to15/6:15/6to14/6:14/6to13/6:13/6to12/6:12/6to11/6:11/6to10/6:10/6to9/6:9/6to8/6:8/6to7/6:7/6to6/6:6/6to5/6:5/6to4/6:4/6to3/6:3/6to2/6:2/6to2/7:,15,False,True
909,423,565,142,14/14to13/14,10/7to9/7,14/14to13/14:13/14to12/14:12/14to11/14:11/14to10/14:10/14to10/13:10/13to10/12:10/12to10/11:10/11to10/10:10/10to10/9:10/9to10/8:10/8to10/7:10/7to9/7:,12,False,True
382,424,825,401,right0to15/0,0/15totop0,right0to15/0:15/0to14/0:14/0to13/0:13/0to12/0:12/0to11/0:11/0to11/1:11/1to10/1:10/1to9/1:9/1to8/1:8/1to7/1:7/1to6/1:6/1to5/1:5/1to4/1:4/1to3/1:3/1to2/1:2/1to1/1:1/1to0/1:0/1to0/2:0/2to0/3:0/3to0/4:0/4to0/5:0/5to0/6:0/6to0/7:0/7to0/8:0/8to0/9:0/9to0/10:0/10to0/11:0/11to0/12:0/12to0/13:0/13to0/14:0/14to0/15:0/15totop0:,32,True,True
3104,424,666,242,15/3to15/2,6/10to5/10,15/3to15/2:15/2to14/2:14/2to13/2:13/2to12/2:12/2to11/2:11/2to10/2:10/2to9/2:9/2to8/2:8/2to7/2:7/2to6/2:6/2to6/3:6/3to6/4:6/4to6/5:6/5to6/6:6/6to6/7:6/7to6/8:6/8to6/9:6/9to6/10:6/10to5/10:,19,False,True
135,424,841,417,left0to0/0,15/15totop15,left0to0/0:0/0to0/1:0/1to0/2:0/2to0/3:0/3to0/4:0/4to0/5:0/5to0/6:0/6to0/7:0/7to0/8:0/8to0/9:0/9to0/10:0/10to0/11:0/11to0/12:0/12to0/13:0/13to0/14:0/14to1/14:1/14to2/14:2/14to3/14:3/14to4/14:4/14to5/14:5/14to6/14:6/14to7/14:7/14to8/14:8/14to9/14:9/14to10/14:10/14to10/15:10/15to11/15:11/15to12/15:12/15to13/15:13/15to14/15:14/15to15/15:15/15totop15:,32,True,True
1579,425,562,137,7/6to7/5,4/0tobottom4,7/6to7/5:7/5to6/5:6/5to5/5:5/5to4/5:4/5to4/4:4/4to4/3:4/3to4/2:4/2to4/1:4/1to4/0:4/0tobottom4:,10,True,True
1898,425,478,53,10/1to10/0,12/0to13/0,10/1to10/0:10/0to11/0:11/0to12/0:12/0to13/0:,4,False,True
451,425,706,281,2/9to2/8,12/1to13/1,2/9to2/8:2/8to3/8:3/8to4/8:4/8to5/8:5/8to6/8:6/8to7/8:7/8to8/8:8/8to9/8:9/8to10/8:10/8to10/7:10/7to10/6:10/6to10/5:10/5to10/4:10/4to10/3:10/3to10/2:10/2to10/1:10/1to11/1:11/1to12/1:12/1to13/1:,19,False,True
1357,425,619,194,9/9to9/8,11/15to12/15,9/9to9/8:9/8to10/8:10/8to11/8:11/8to11/9:11/9to11/10:11/10to11/11:11/11to11/12:11/12to11/13:11/13to11/14:11/14to11/15:11/15to12/15:,11,True,True
2555,425,663,238,1/15to1/14,12/9to12/10,1/15to1/14:1/14to2/14:2/14to3/14:3/14to4/14:4/14to5/14:5/14to6/14:6/14to7/14:7/14to8/14:8/14to9/14:9/14to10/14:10/14to10/13:10/13to10/12:10/12to10/11:10/11to10/10:10/10to10/9:10/9to11/9:11/9to12/9:12/9to12/10:,18,False,True
1456,425,557,132,5/13to5/12,10/10to11/10,5/13to5/12:5/12to6/12:6/12to7/12:7/12to8/12:8/12to9/12:9/12to10/12:10/12to10/11:10/11to10/10:10/10to11/10:,9,False,True
555,425,612,187,4/4to3/4,0/11toleft11,4/4to3/4:3/4to2/4:2/4to1/4:1/4to0/4:0/4to0/5:0/5to0/6:0/6to0/7:0/7to0/8:0/8to0/9:0/9to0/10:0/10to0/11:0/11toleft11:,12,False,True
2832,426,488,62,4/5to3/5,1/5to1/6,4/5to3/5:3/5to2/5:2/5to1/5:1/5to1/6:,4,True,True
723,426,495,69,8/13to9/13,10/10to9/10,8/13to9/13:9/13to10/13:10/13to10/12:10/12to10/11:10/11to10/10:10/10to9/10:,6,False,True
494,426,553,127,12/2to12/1,7/2to6/2,12/2to12/1:12/1to11/1:11/1to10/1:10/1to9/1:9/1to8/1:8/1to7/1:7/1to7/2:7/2to6/2:,8,True,True
1678,426,694,268,0/12to0/11,8/0to9/0,0/12to0/11:0/11to0/10:0/10to0/9:0/9to0/8:0/8to0/7:0/7to0/6:0/6to0/5:0/5to0/4:0/4to0/3:0/3to0/2:0/2to0/1:0/1to0/0:0/0to1/0:1/0to2/0:2/0to3/0:3/0to4/0:4/0to5/0:5/0to6/0:6/0to7/0:7/0to8/0:8/0to9/0:,21,False,True
3130,426,552,126,10/5to10/6,6/2to7/2,10/5to10/6:10/6to9/6:9/6to8/6:8/6to7/6:7/6to6/6:6/6to6/5:6/5to6/4:6/4to6/3:6/3to6/2:6/2to7/2:,10,False,True
1194,427,585,158,5/8to4/8,9/2to9/1,5/8to4/8:4/8to4/7:4/7to4/6:4/6to4/5:4/5to4/4:4/4to4/3:4/3to4/2:4/2to5/2:5/2to6/2:6/2to7/2:7/2to8/2:8/2to9/2:9/2to9/1:,13,True,True
2777,427,493,66,1/8to1/9,4/9to4/10,1/8to1/9:1/9to2/9:2/9to3/9:3/9to4/9:4/9to4/10:,5,True,True
127,427,867,440,left0to0/0,15/15totop15,left0to0/0:0/0to1/0:1/0to2/0:2/0to3/0:3/0to4/0:4/0to5/0:5/0to6/0:6/0to7/0:7/0to8/0:8/0to9/0:9/0to10/0:10/0to10/1:10/1to10/2:10/2to10/3:10/3to10/4:10/4to10/5:10/5to10/6:10/6to10/7:10/7to10/8:10/8to10/9:10/9to10/10:10/10to10/11:10/11to10/12:10/12to10/13:10/13to10/14:10/14to10/15:10/15to11/15:11/15to12/15:12/15to13/15:13/15to14/15:14/15to15/15:15/15totop15:,32,False,True
446,427,660,233,12/5to12/6,5/7to5/8,12/5to12/6:12/6to11/6:11/6to10/6:10/6to9/6:9/6to8/6:8/6to7/6:7/6to6/6:6/6to5/6:5/6to5/7:5/7to5/8:,10,False,True
3160,427,767,340,right5to15/5,2/3to2/2,right5to15/5:15/5to14/5:14/5to13/5:13/5to12/5:12/5to11/5:11/5to10/5:10/5to9/5:9/5to8/5:8/5to7/5:7/5to6/5:6/5to5/5:5/5to4/5:4/5to3/5:3/5to2/5:2/5to2/4:2/4to2/3:2/3to2/2:,17,True,True
1636,428,582,154,11/1to10/1,7/9to7/10,11/1to10/1:10/1to9/1:9/1to8/1:8/1to7/1:7/1to7/2:7/2to7/3:7/3to7/4:7/4to7/5:7/5to7/6:7/6to7/7:7/7to7/8:7/8to7/9:7/9to7/10:,13,False,True
2222,428,529,101,15/4to15/5,13/0tobottom13,15/4to15/5:15/5to14/5:14/5to13/5:13/5to13/4:13/4to13/3:13/3to13/2:13/2to13/1:13/1to13/0:13/0tobottom13:,9,False,True
1511,429,870,441,0/0to1/0,15/11to15/12,0/0to1/0:1/0to1/1:1/1to1/2:1/2to1/3:1/3to1/4:1/4to1/5:1/5to1/6:1/6to1/7:1/7to1/8:1/8to1/9:1/9to1/10:1/10to1/11:1/11to2/11:2/11to3/11:3/11to4/11:4/11to5/11:5/11to6/11:6/11to7/11:7/11to8/11:8/11to9/11:9/11to10/11:10/11to11/11:11/11to12/11:12/11to13/11:13/11to14/11:14/11to15/11:15/11to15/12:,27,True,True
887,429,611,182,10/0to9/0,3/7to3/8,10/0to9/0:9/0to8/0:8/0to7/0:7/0to6/0:6/0to5/0:5/0to4/0:4/0to3/0:3/0to3/1:3/1to3/2:3/2to3/3:3/3to3/4:3/4to3/5:3/5to3/6:3/6to3/7:3/7to3/8:,15,True,True
662,429,588,159,7/2to7/1,2/7to2/8,7/2to7/1:7/1to6/1:6/1to5/1:5/1to4/1:4/1to3/1:3/1to2/1:2/1to2/2:2/2to2/3:2/3to2/4:2/4to2/5:2/5to2/6:2/6to2/7:2/7to2/8:,13,False,True
1564,429,556,127,2/9to2/10,5/14to5/15,2/9to2/10:2/10to2/11:2/11to2/12:2/12to2/13:2/13to2/14:2/14to3/14:3/14to4/14:4/14to5/14:5/14to5/15:,9,True,True
1173,429,613,184,11/1to10/1,10/15to9/15,11/1to10/1:10/1to10/2:10/2to10/3:10/3to10/4:10/4to10/5:10/5to10/6:10/6to10/7:10/7to10/8:10/8to10/9:10/9to10/10:10/10to10/11:10/11to10/12:10/12to10/13:10/13to10/14:10/14to10/15:10/15to9/15:,16,False,True
2848,430,549,119,3/14to3/15,2/8to3/8,3/14to3/15:3/15to2/15:2/15to2/14:2/14to2/13:2/13to2/12:2/12to2/11:2/11to2/10:2/10to2/9:2/9to2/8:2/8to3/8:,10,False,True
1450,430,637,207,4/15to4/14,12/9to12/8,4/15to4/14:4/14to4/13:4/13to4/12:4/12to4/11:4/11to5/11:5/11to6/11:6/11to7/11:7/11to8/11:8/11to9/11:9/11to10/11:10/11to10/10:10/10to11/10:11/10to11/9:11/9to12/9:12/9to12/8:,15,True,True
2810,430,664,234,1/2to0/2,4/13to5/13,1/2to0/2:0/2to0/3:0/3to0/4:0/4to0/5:0/5to0/6:0/6to0/7:0/7to0/8:0/8to0/9:0/9to0/10:0/10to0/11:0/11to0/12:0/12to0/13:0/13to1/13:1/13to2/13:2/13to3/13:3/13to4/13:4/13to5/13:,17,True,True
2690,430,800,370,left14to0/14,11/0tobottom11,left14to0/14:0/14to1/14:1/14to2/14:2/14to3/14:3/14to4/14:4/14to5/14:5/14to6/14:6/14to7/14:7/14to8/14:8/14to9/14:9/14to10/14:10/14to10/13:10/13to10/12:10/12to10/11:10/11to10/10:10/10to10/9:10/9to10/8:10/8to10/7:10/7to10/6:10/6to10/5:10/5to10/4:10/4to10/3:10/3to10/2:10/2to10/1:10/1to10/0:10/0to11/0:11/0tobottom11:,27,False,True
805,430,478,48,6/15to6/14,7/13to7/12,6/15to6/14:6/14to6/13:6/13to7/13:7/13to7/12:,4,True,True
1008,430,676,246,14/6to13/6,4/7to4/8,14/6to13/6:13/6to12/6:12/6to11/6:11/6to10/6:10/6to9/6:9/6to8/6:8/6to7/6:7/6to6/6:6/6to5/6:5/6to4/6:4/6to4/7:4/7to4/8:,12,False,True
2819,431,608,177,9/12to8/12,6/0tobottom6,9/12to8/12:8/12to7/12:7/12to6/12:6/12to6/11:6/11to6/10:6/10to6/9:6/9to6/8:6/8to6/7:6/7to6/6:6/6to6/5:6/5to6/4:6/4to6/3:6/3to6/2:6/2to6/1:6/1to6/0:6/0tobottom6:,16,False,True
2244,431,627,196,4/12to5/12,15/13to15/12,4/12to5/12:5/12to6/12:6/12to7/12:7/12to8/12:8/12to9/12:9/12to10/12:10/12to11/12:11/12to12/12:12/12to12/13:12/13to13/13:13/13to14/13:14/13to15/13:15/13to15/12:,13,True,True
121,431,891,460,left0to0/0,15/15totop15,left0to0/0:0/0to0/1:0/1to0/2:0/2to0/3:0/3to0/4:0/4to0/5:0/5to0/6:0/6to0/7:0/7to0/8:0/8to0/9:0/9to0/10:0/10to0/11:0/11to0/12:0/12to0/13:0/13to0/14:0/14to1/14:1/14to2/14:2/14to3/14:3/14to4/14:4/14to5/14:5/14to6/14:6/14to7/14:7/14to8/14:8/14to9/14:9/14to10/14:10/14to10/15:10/15to11/15:11/15to12/15:12/15to13/15:13/15to14/15:14/15to15/15:15/15totop15:,32,True,True
1575,431,760,329,12/6to12/5,2/10to3/10,12/6to12/5:12/5to11/5:11/5to10/5:10/5to9/5:9/5to8/5:8/5to7/5:7/5to6/5:6/5to5/5:5/5to4/5:4/5to3/5:3/5to2/5:2/5to2/6:2/6to2/7:2/7to2/8:2/8to2/9:2/9to2/10:2/10to3/10:,17,False,True
686,432,603,171,right1to15/1,13/12to12/12,right1to15/1:15/1to14/1:14/1to13/1:13/1to13/2:13/2to13/3:13/3to13/4:13/4to13/5:13/5to13/6:13/6to13/7:13/7to13/8:13/8to13/9:13/9to13/10:13/10to13/11:13/11to13/12:13/12to12/12:,15,True,True
3282,432,737,305,top2to2/15,15/7toright7,top2to2/15:2/15to2/14:2/14to2/13:2/13to2/12:2/12to2/11:2/11to2/10:2/10to2/9:2/9to3/9:3/9to4/9:4/9to5/9:5/9to6/9:6/9to7/9:7/9to8/9:8/9to9/9:9/9to10/9:10/9to10/8:10/8to11/8:11/8to12/8:12/8to12/7:12/7to13/7:13/7to14/7:14/7to15/7:15/7toright7:,23,True,True
1285,432,768,336,10/13to10/12,0/2to0/1,10/13to10/12:10/12to10/11:10/11to9/11:9/11to8/11:8/11to7/11:7/11to6/11:6/11to5/11:5/11to4/11:4/11to3/11:3/11to2/11:2/11to1/11:1/11to0/11:0/11to0/10:0/10to0/9:0/9to0/8:0/8to0/7:0/7to0/6:0/6to0/5:0/5to0/4:0/4to0/3:0/3to0/2:0/2to0/1:,22,True,True
1919,432,561,129,11/3to10/3,8/10to8/11,11/3to10/3:10/3to9/3:9/3to8/3:8/3to8/4:8/4to8/5:8/5to8/6:8/6to8/7:8/7to8/8:8/8to8/9:8/9to8/10:8/10to8/11:,11,True,True
2805,432,495,63,bottom15to15/0,15/5toright5,bottom15to15/0:15/0to15/1:15/1to15/2:15/2to15/3:15/3to15/4:15/4to15/5:15/5toright5:,7,False,True
3162,433,722,289,1/15to1/14,8/0to9/0,1/15to1/14:1/14to1/13:1/13to1/12:1/12to1/11:1/11to1/10:1/10to1/9:1/9to1/8:1/8to1/7:1/7to1/6:1/6to1/5:1/5to1/4:1/4to1/3:1/3to1/2:1/2to1/1:1/1to1/0:1/0to2/0:2/0to3/0:3/0to4/0:4/0to5/0:5/0to6/0:6/0to7/0:7/0to8/0:8/0to9/0:,23,False,True
1503,433,852,419,13/12to13/13,3/2to4/2,13/12to13/13:13/13to12/13:12/13to12/12:12/12to11/12:11/12to10/12:10/12to9/12:9/12to8/12:8/12to7/12:7/12to6/12:6/12to5/12:5/12to4/12:4/12to3/12:3/12to3/11:3/11to3/10:3/10to3/9:3/9to3/8:3/8to3/7:3/7to3/6:3/6to3/5:3/5to3/4:3/4to3/3:3/3to3/2:3/2to4/2:,23,True,True
997,433,602,169,13/11to12/11,15/2to15/3,13/11to12/11:12/11to12/10:12/10to12/9:12/9to12/8:12/8to12/7:12/7to12/6:12/6to12/5:12/5to12/4:12/4to12/3:12/3to12/2:12/2to13/2:13/2to14/2:14/2to15/2:15/2to15/3:,14,False,True
1034,433,554,121,6/7to5/7,8/12to9/12,6/7to5/7:5/7to5/8:5/8to5/9:5/9to5/10:5/10to5/11:5/11to5/12:5/12to6/12:6/12to7/12:7/12to8/12:8/12to9/12:,10,True,True
69,433,807,374,left15to0/15,15/0tobottom15,left15to0/15:0/15to1/15:1/15to2/15:2/15to3/15:3/15to4/15:4/15to5/15:5/15to6/15:6/15to7/15:7/15to8/15:8/15to9/15:9/15to10/15:10/15to10/14:10/14to10/13:10/13to10/12:10/12to10/11:10/11to10/10:10/10to10/9:10/9to10/8:10/8to10/7:10/7to10/6:10/6to10/5:10/5to10/4:10/4to10/3:10/3to10/2:10/2to10/1:10/1to10/0:10/0to11/0:11/0to12/0:12/0to13/0:13/0to14/0:14/0to15/0:15/0tobottom15:,32,False,True
32,433,811,378,left15to0/15,15/0tobottom15,left15to0/15:0/15to1/15:1/15to2/15:2/15to3/15:3/15to4/15:4/15to5/15:5/15to6/15:6/15to7/15:7/15to8/15:8/15to9/15:9/15to10/15:10/15to10/14:10/14to10/13:10/13to10/12:10/12to10/11:10/11to10/10:10/10to10/9:10/9to10/8:10/8to10/7:10/7to10/6:10/6to10/5:10/5to10/4:10/4to10/3:10/3to10/2:10/2to10/1:10/1to10/0:10/0to11/0:11/0to12/0:12/0to13/0:13/0to14/0:14/0to15/0:15/0tobottom15:,32,False,True
2294,434,650,216,12/10to11/10,4/15totop4,12/10to11/10:11/10to10/10:10/10to9/10:9/10to8/10:8/10to7/10:7/10to6/10:6/10to5/10:5/10to4/10:4/10to4/11:4/11to4/12:4/12to4/13:4/13to4/14:4/14to4/15:4/15totop4:,14,False,True
653,434,512,78,5/3to5/4,8/5to9/5,5/3to5/4:5/4to5/5:5/5to6/5:6/5to7/5:7/5to8/5:8/5to9/5:,6,True,True
1514,435,719,284,0/8to0/9,13/14to13/15,0/8to0/9:0/9to0/10:0/10to0/11:0/11to0/12:0/12to0/13:0/13to0/14:0/14to1/14:1/14to2/14:2/14to3/14:3/14to4/14:4/14to5/14:5/14to6/14:6/14to7/14:7/14to8/14:8/14to9/14:9/14to10/14:10/14to11/14:11/14to12/14:12/14to13/14:13/14to13/15:,20,True,True
3185,435,611,176,8/0to7/0,2/7to2/8,8/0to7/0:7/0to6/0:6/0to5/0:5/0to4/0:4/0to3/0:3/0to2/0:2/0to2/1:2/1to2/2:2/2to2/3:2/3to2/4:2/4to2/5:2/5to2/6:2/6to2/7:2/7to2/8:,14,True,True
1835,435,491,56,13/12to13/11,13/8to12/8,13/12to13/11:13/11to13/10:13/10to13/9:13/9to13/8:13/8to12/8:,5,False,True
1519,435,544,109,11/4to11/5,15/8to15/9,11/4to11/5:11/5to11/6:11/6to11/7:11/7to11/8:11/8to12/8:12/8to13/8:13/8to14/8:14/8to15/8:15/8to15/9:,9,False,True
192,435,870,435,left0to0/0,15/15totop15,left0to0/0:0/0to0/1:0/1to0/2:0/2to0/3:0/3to0/4:0/4to0/5:0/5to0/6:0/6to0/7:0/7to0/8:0/8to0/9:0/9to0/10:0/10to0/11:0/11to0/12:0/12to0/13:0/13to0/14:0/14to1/14:1/14to2/14:2/14to3/14:3/14to4/14:4/14to5/14:5/14to6/14:6/14to7/14:7/14to8/14:8/14to9/14:9/14to10/14:10/14to10/15:10/15to11/15:11/15to12/15:12/15to13/15:13/15to14/15:14/15to15/15:15/15totop15:,32,True,True
1765,436,567,131,12/10to12/9,12/0to13/0,12/10to12/9:12/9to12/8:12/8to12/7:12/7to12/6:12/6to12/5:12/5to12/4:12/4to12/3:12/3to12/2:12/2to12/1:12/1to12/0:12/0to13/0:,11,True,True
28,436,813,377,left15to0/15,15/0tobottom15,left15to0/15:0/15to0/14:0/14to0/13:0/13to0/12:0/12to0/11:0/11to0/10:0/10to0/9:0/9to0/8:0/8to0/7:0/7to0/6:0/6to0/5:0/5to0/4:0/4to0/3:0/3to0/2:0/2to0/1:0/1to0/0:0/0to1/0:1/0to2/0:2/0to3/0:3/0to4/0:4/0to5/0:5/0to6/0:6/0to7/0:7/0to8/0:8/0to9/0:9/0to10/0:10/0to11/0:11/0to12/0:12/0to13/0:13/0to14/0:14/0to15/0:15/0tobottom15:,32,True,True
2391,436,528,92,1/9to2/9,3/14to3/13,1/9to2/9:2/9to2/10:2/10to2/11:2/11to2/12:2/12to2/13:2/13to2/14:2/14to3/14:3/14to3/13:,8,True,True
1817,436,620,184,3/2to4/2,5/15to5/14,3/2to4/2:4/2to4/3:4/3to4/4:4/4to4/5:4/5to4/6:4/6to4/7:4/7to4/8:4/8to4/9:4/9to4/10:4/10to4/11:4/11to4/12:4/12to4/13:4/13to4/14:4/14to4/15:4/15to5/15:5/15to5/14:,16,False,True
1978,437,755,318,2/6to3/6,15/8toright8,2/6to3/6:3/6to4/6:4/6to5/6:5/6to6/6:6/6to7/6:7/6to8/6:8/6to9/6:9/6to10/6:10/6to10/7:10/7to10/8:10/8to11/8:11/8to12/8:12/8to13/8:13/8to14/8:14/8to15/8:15/8toright8:,16,False,True
844,437,613,176,7/3to7/2,13/8to13/9,7/3to7/2:7/2to8/2:8/2to9/2:9/2to10/2:10/2to10/3:10/3to10/4:10/4to10/5:10/5to10/6:10/6to10/7:10/7to10/8:10/8to11/8:11/8to12/8:12/8to13/8:13/8to13/9:,14,False,True
3393,438,639,201,1/5to2/5,11/1to12/1,1/5to2/5:2/5to2/4:2/4to2/3:2/3to3/3:3/3to4/3:4/3to5/3:5/3to6/3:6/3to7/3:7/3to8/3:8/3to9/3:9/3to10/3:10/3to10/2:10/2to11/2:11/2to11/1:11/1to12/1:,15,True,True
90,438,818,380,left15to0/15,15/0tobottom15,left15to0/15:0/15to0/14:0/14to0/13:0/13to0/12:0/12to0/11:0/11to0/10:0/10to0/9:0/9to0/8:0/8to0/7:0/7to0/6:0/6to0/5:0/5to0/4:0/4to0/3:0/3to0/2:0/2to0/1:0/1to0/0:0/0to1/0:1/0to2/0:2/0to3/0:3/0to4/0:4/0to5/0:5/0to6/0:6/0to7/0:7/0to8/0:8/0to9/0:9/0to10/0:10/0to11/0:11/0to12/0:12/0to13/0:13/0to14/0:14/0to15/0:15/0tobottom15:,32,True,True
2449,438,789,351,15/5to14/5,2/8to1/8,15/5to14/5:14/5to13/5:13/5to12/5:12/5to11/5:11/5to10/5:10/5to9/5:9/5to8/5:8/5to7/5:7/5to6/5:6/5to5/5:5/5to4/5:4/5to3/5:3/5to2/5:2/5to2/6:2/6to2/7:2/7to2/8:2/8to1/8:,17,True,True
1748,438,492,54,10/5to10/4,11/3to12/3,10/5to10/4:10/4to10/3:10/3to11/3:11/3to12/3:,4,False,True
2306,438,619,181,bottom6to6/0,1/8to0/8,bottom6to6/0:6/0to5/0:5/0to4/0:4/0to3/0:3/0to2/0:2/0to1/0:1/0to1/1:1/1to1/2:1/2to1/3:1/3to1/4:1/4to1/5:1/5to1/6:1/6to1/7:1/7to1/8:1/8to0/8:,15,False,True
2348,438,659,221,10/13to10/12,5/0tobottom5,10/13to10/12:10/12to9/12:9/12to8/12:8/12to7/12:7/12to6/12:6/12to5/12:5/12to5/11:5/11to5/10:5/10to5/9:5/9to5/8:5/8to5/7:5/7to5/6:5/6to5/5:5/5to5/4:5/4to5/3:5/3to5/2:5/2to5/1:5/1to5/0:5/0tobottom5:,19,False,True
3069,439,559,120,12/3to11/3,13/9to13/10,12/3to11/3:11/3to11/4:11/4to11/5:11/5to11/6:11/6to11/7:11/7to11/8:11/8to11/9:11/9to12/9:12/9to13/9:13/9to13/10:,10,True,True
3248,440,582,142,3/15to3/14,5/6to5/7,3/15to3/14:3/14to3/13:3/13to3/12:3/12to3/11:3/11to3/10:3/10to3/9:3/9to3/8:3/8to3/7:3/7to3/6:3/6to4/6:4/6to5/6:5/6to5/7:,12,False,True
2587,441,614,173,5/2to5/3,3/14to4/14,5/2to5/3:5/3to4/3:4/3to3/3:3/3to3/4:3/4to3/5:3/5to3/6:3/6to3/7:3/7to3/8:3/8to3/9:3/9to3/10:3/10to3/11:3/11to3/12:3/12to3/13:3/13to3/14:3/14to4/14:,15,True,True
3291,441,633,192,15/1to15/2,12/13to12/14,15/1to15/2:15/2to14/2:14/2to13/2:13/2to12/2:12/2to12/3:12/3to12/4:12/4to12/5:12/5to12/6:12/6to12/7:12/7to12/8:12/8to12/9:12/9to12/10:12/10to12/11:12/11to12/12:12/12to12/13:12/13to12/14:,16,False,True
2076,441,696,255,2/14to3/14,15/9to15/8,2/14to3/14:3/14to4/14:4/14to5/14:5/14to6/14:6/14to7/14:7/14to8/14:8/14to9/14:9/14to10/14:10/14to10/13:10/13to10/12:10/12to10/11:10/11to10/10:10/10to10/9:10/9to11/9:11/9to12/9:12/9to13/9:13/9to14/9:14/9to15/9:15/9to15/8:,19,False,True
893,441,568,127,0/2to1/2,7/3to8/3,0/2to1/2:1/2to1/3:1/3to2/3:2/3to3/3:3/3to4/3:4/3to5/3:5/3to6/3:6/3to7/3:7/3to8/3:,9,False,True
2662,441,523,82,15/10to14/10,15/14to15/15,15/10to14/10:14/10to14/11:14/11to14/12:14/12to14/13:14/13to14/14:14/14to15/14:15/14to15/15:,7,True,True
2357,442,537,95,5/12to5/11,8/9to9/9,5/12to5/11:5/11to5/10:5/10to5/9:5/9to6/9:6/9to7/9:7/9to8/9:8/9to9/9:,7,True,True
1546,442,646,204,3/10to3/11,14/9to14/8,3/10to3/11:3/11to4/11:4/11to5/11:5/11to6/11:6/11to7/11:7/11to8/11:8/11to9/11:9/11to10/11:10/11to10/10:10/10to11/10:11/10to11/9:11/9to12/9:12/9to13/9:13/9to14/9:14/9to14/8:,15,True,True
2263,442,652,210,11/2to11/1,2/4to1/4,11/2to11/1:11/1to10/1:10/1to9/1:9/1to8/1:8/1to7/1:7/1to6/1:6/1to5/1:5/1to4/1:4/1to3/1:3/1to2/1:2/1to2/2:2/2to2/3:2/3to2/4:2/4to1/4:,14,False,True
2063,443,701,258,10/11to10/10,3/0tobottom3,10/11to10/10:10/10to9/10:9/10to8/10:8/10to7/10:7/10to6/10:6/10to5/10:5/10to4/10:4/10to3/10:3/10to3/9:3/9to3/8:3/8to3/7:3/7to3/6:3/6to3/5:3/5to3/4:3/4to3/3:3/3to3/2:3/2to3/1:3/1to3/0:3/0tobottom3:,19,False,True
1177,443,739,296,15/10to15/11,7/8to6/8,15/10to15/11:15/11to14/11:14/11to13/11:13/11to12/11:12/11to11/11:11/11to10/11:10/11to9/11:9/11to8/11:8/11to7/11:7/11to7/10:7/10to7/9:7/9to7/8:7/8to6/8:,13,False,True
2250,443,604,161,10/6to10/7,2/7to2/8,10/6to10/7:10/7to9/7:9/7to8/7:8/7to7/7:7/7to6/7:6/7to5/7:5/7to4/7:4/7to3/7:3/7to2/7:2/7to2/8:,10,False,True
1771,444,768,324,12/5to11/5,7/15totop7,12/5to11/5:11/5to10/5:10/5to9/5:9/5to8/5:8/5to7/5:7/5to7/6:7/6to7/7:7/7to7/8:7/8to7/9:7/9to7/10:7/10to7/11:7/11to7/12:7/12to7/13:7/13to7/14:7/14to7/15:7/15totop7:,16,False,True
1011,444,565,121,1/14to1/13,8/12to8/13,1/14to1/13:1/13to1/12:1/12to2/12:2/12to3/12:3/12to4/12:4/12to5/12:5/12to6/12:6/12to7/12:7/12to8/12:8/12to8/13:,10,True,True
1349,444,655,211,5/8to4/8,0/6to0/5,5/8to4/8:4/8to3/8:3/8to2/8:2/8to1/8:1/8to0/8:0/8to0/7:0/7to0/6:0/6to0/5:,8,True,True
312,444,829,385,right0to15/0,0/15totop0,right0to15/0:15/0to14/0:14/0to13/0:13/0to12/0:12/0to11/0:11/0to10/0:10/0to9/0:9/0to8/0:8/0to7/0:7/0to6/0:6/0to5/0:5/0to4/0:4/0to3/0:3/0to2/0:2/0to1/0:1/0to0/0:0/0to0/1:0/1to0/2:0/2to0/3:0/3to0/4:0/4to0/5:0/5to0/6:0/6to0/7:0/7to0/8:0/8to0/9:0/9to0/10:0/10to0/11:0/11to0/12:0/12to0/13:0/13to0/14:0/14to0/15:0/15totop0:,32,False,True
2701,444,597,153,0/10to0/11,8/12to9/12,0/10to0/11:0/11to0/12:0/12to1/12:1/12to2/12:2/12to3/12:3/12to4/12:4/12to5/12:5/12to6/12:6/12to7/12:7/12to8/12:8/12to9/12:,11,True,True
2839,444,471,27,left15to0/15,0/13toleft13,left15to0/15:0/15to0/14:0/14to0/13:0/13toleft13:,4,True,True
383,445,834,389,right0to15/0,0/15totop0,right0to15/0:15/0to14/0:14/0to13/0:13/0to12/0:12/0to11/0:11/0to10/0:10/0to9/0:9/0to8/0:8/0to7/0:7/0to6/0:6/0to5/0:5/0to4/0:4/0to3/0:3/0to2/0:2/0to1/0:1/0to0/0:0/0to0/1:0/1to0/2:0/2to0/3:0/3to0/4:0/4to0/5:0/5to0/6:0/6to0/7:0/7to0/8:0/8to0/9:0/9to0/10:0/10to0/11:0/11to0/12:0/12to0/13:0/13to0/14:0/14to0/15:0/15totop0:,32,False,True
1726,445,564,119,13/12to13/11,10/15to9/15,13/12to13/11:13/11to12/11:12/11to11/11:11/11to10/11:10/11to10/12:10/12to10/13:10/13to10/14:10/14to10/15:10/15to9/15:,9,False,True
3167,445,760,315,15/11to14/11,6/4to7/4,15/11to14/11:14/11to13/11:13/11to12/11:12/11to11/11:11/11to10/11:10/11to9/11:9/11to8/11:8/11to7/11:7/11to6/11:6/11to6/10:6/10to6/9:6/9to6/8:6/8to6/7:6/7to6/6:6/6to6/5:6/5to6/4:6/4to7/4:,17,True,True
1136,445,634,189,6/7to7/7,13/12to13/13,6/7to7/7:7/7to7/8:7/8to7/9:7/9to7/10:7/10to7/11:7/11to8/11:8/11to9/11:9/11to10/11:10/11to10/12:10/12to11/12:11/12to12/12:12/12to13/12:13/12to13/13:,13,True,True
3231,446,613,167,12/6to11/6,8/6to7/6,12/6to11/6:11/6to10/6:10/6to9/6:9/6to8/6:8/6to7/6:,5,False,True
257,446,867,421,right15to15/15,0/0tobottom0,right15to15/15:15/15to14/15:14/15to13/15:13/15to12/15:12/15to11/15:11/15to11/14:11/14to10/14:10/14to9/14:9/14to8/14:8/14to7/14:7/14to6/14:6/14to5/14:5/14to4/14:4/14to3/14:3/14to2/14:2/14to1/14:1/14to0/14:0/14to0/13:0/13to0/12:0/12to0/11:0/11to0/10:0/10to0/9:0/9to0/8:0/8to0/7:0/7to0/6:0/6to0/5:0/5to0/4:0/4to0/3:0/3to0/2:0/2to0/1:0/1to0/0:0/0tobottom0:,32,True,True
1406,446,626,180,3/2to4/2,6/13to7/13,3/2to4/2:4/2to4/3:4/3to4/4:4/4to4/5:4/5to4/6:4/6to4/7:4/7to4/8:4/8to4/9:4/9to4/10:4/10to4/11:4/11to4/12:4/12to4/13:4/13to5/13:5/13to6/13:6/13to7/13:,15,False,True
1705,446,497,51,10/14to9/14,7/14to7/15,10/14to9/14:9/14to8/14:8/14to7/14:7/14to7/15:,4,False,True
2557,446,472,26,10/5to10/4,10/4to11/4,10/5to10/4:10/4to11/4:,2,True,True
172,446,900,454,left0to0/0,15/15totop15,left0to0/0:0/0to1/0:1/0to2/0:2/0to3/0:3/0to4/0:4/0to5/0:5/0to6/0:6/0to7/0:7/0to8/0:8/0to9/0:9/0to10/0:10/0to10/1:10/1to10/2:10/2to10/3:10/3to10/4:10/4to10/5:10/5to10/6:10/6to10/7:10/7to10/8:10/8to10/9:10/9to10/10:10/10to10/11:10/11to10/12:10/12to10/13:10/13to10/14:10/14to10/15:10/15to11/15:11/15to12/15:12/15to13/15:13/15to14/15:14/15to15/15:15/15totop15:,32,False,True
1854,446,574,128,9/9to10/9,14/5to15/5,9/9to10/9:10/9to10/8:10/8to10/7:10/7to10/6:10/6to10/5:10/5to11/5:11/5to12/5:12/5to13/5:13/5to14/5:14/5to15/5:,10,False,True
3178,446,671,225,12/0to12/1,8/13to8/14,12/0to12/1:12/1to12/2:12/2to11/2:11/2to10/2:10/2to9/2:9/2to8/2:8/2to8/3:8/3to8/4:8/4to8/5:8/5to8/6:8/6to8/7:8/7to8/8:8/8to8/9:8/9to8/10:8/10to8/11:8/11to8/12:8/12to8/13:8/13to8/14:,18,True,True
478,447,564,117,6/1to6/2,4/8to4/9,6/1to6/2:6/2to5/2:5/2to4/2:4/2to4/3:4/3to4/4:4/4to4/5:4/5to4/6:4/6to4/7:4/7to4/8:4/8to4/9:,10,False,True
2928,447,720,273,right9to15/9,2/6to3/6,right9to15/9:15/9to14/9:14/9to13/9:13/9to12/9:12/9to11/9:11/9to10/9:10/9to9/9:9/9to8/9:8/9to7/9:7/9to6/9:6/9to5/9:5/9to4/9:4/9to3/9:3/9to2/9:2/9to2/8:2/8to2/7:2/7to2/6:2/6to3/6:,18,False,True
2287,447,482,35,8/3to9/3,9/2to8/2,8/3to9/3:9/3to9/2:9/2to8/2:,3,False,True
683,447,684,237,left10to0/10,10/13to10/14,left10to0/10:0/10to0/11:0/11to1/11:1/11to2/11:2/11to3/11:3/11to4/11:4/11to5/11:5/11to6/11:6/11to7/11:7/11to8/11:8/11to9/11:9/11to10/11:10/11to10/12:10/12to10/13:10/13to10/14:,15,True,True
1905,448,612,164,12/6to11/6,9/1to9/0,12/6to11/6:11/6to10/6:10/6to10/5:10/5to10/4:10/4to10/3:10/3to10/2:10/2to10/1:10/1to9/1:9/1to9/0:,9,False,True
1857,448,643,195,11/15to11/14,4/8to5/8,11/15to11/14:11/14to10/14:10/14to9/14:9/14to8/14:8/14to7/14:7/14to6/14:6/14to5/14:5/14to4/14:4/14to4/13:4/13to4/12:4/12to4/11:4/11to4/10:4/10to4/9:4/9to4/8:4/8to5/8:,15,True,True
84,448,827,379,left15to0/15,15/0tobottom15,left15to0/15:0/15to0/14:0/14to0/13:0/13to0/12:0/12to0/11:0/11to0/10:0/10to0/9:0/9to0/8:0/8to0/7:0/7to0/6:0/6to0/5:0/5to0/4:0/4to0/3:0/3to0/2:0/2to0/1:0/1to0/0:0/0to1/0:1/0to2/0:2/0to3/0:3/0to4/0:4/0to5/0:5/0to6/0:6/0to7/0:7/0to8/0:8/0to9/0:9/0to10/0:10/0to11/0:11/0to12/0:12/0to13/0:13/0to14/0:14/0to15/0:15/0tobottom15:,32,True,True
2095,448,544,96,bottom10to10/0,12/5to13/5,bottom10to10/0:10/0to11/0:11/0to12/0:12/0to12/1:12/1to12/2:12/2to12/3:12/3to12/4:12/4to12/5:12/5to13/5:,9,True,True
528,448,664,216,6/7to7/7,15/12to15/13,6/7to7/7:7/7to7/8:7/8to7/9:7/9to7/10:7/10to7/11:7/11to8/11:8/11to9/11:9/11to10/11:10/11to10/12:10/12to11/12:11/12to12/12:12/12to13/12:13/12to14/12:14/12to15/12:15/12to15/13:,15,True,True
2276,448,682,234,13/0to12/0,7/12to7/13,13/0to12/0:12/0to11/0:11/0to10/0:10/0to9/0:9/0to8/0:8/0to7/0:7/0to7/1:7/1to7/2:7/2to7/3:7/3to7/4:7/4to7/5:7/5to7/6:7/6to7/7:7/7to7/8:7/8to7/9:7/9to7/10:7/10to7/11:7/11to7/12:7/12to7/13:,19,False,True
3341,449,605,156,8/10to8/9,1/6to2/6,8/10to8/9:8/9to7/9:7/9to6/9:6/9to5/9:5/9to4/9:4/9to3/9:3/9to2/9:2/9to1/9:1/9to1/8:1/8to1/7:1/7to1/6:1/6to2/6:,12,True,True
590,449,577,128,9/2to8/2,4/6to3/6,9/2to8/2:8/2to7/2:7/2to6/2:6/2to5/2:5/2to4/2:4/2to4/3:4/3to4/4:4/4to4/5:4/5to4/6:4/6to3/6:,10,True,True
2303,449,744,295,11/15to10/15,2/1to1/1,11/15to10/15:10/15to9/15:9/15to8/15:8/15to7/15:7/15to6/15:6/15to5/15:5/15to4/15:4/15to3/15:3/15to2/15:2/15to2/14:2/14to2/13:2/13to2/12:2/12to2/11:2/11to2/10:2/10to2/9:2/9to2/8:2/8to2/7:2/7to2/6:2/6to2/5:2/5to2/4:2/4to2/3:2/3to2/2:2/2to2/1:2/1to1/1:,24,True,True
1095,450,634,184,top0to0/15,8/10to8/9,top0to0/15:0/15to0/14:0/14to0/13:0/13to0/12:0/12to0/11:0/11to0/10:0/10to1/10:1/10to2/10:2/10to3/10:3/10to4/10:4/10to5/10:5/10to6/10:6/10to7/10:7/10to8/10:8/10to8/9:,15,True,True
2020,450,712,262,2/4to3/4,14/4to15/4,2/4to3/4:3/4to4/4:4/4to5/4:5/4to6/4:6/4to7/4:7/4to8/4:8/4to9/4:9/4to10/4:10/4to11/4:11/4to12/4:12/4to13/4:13/4to14/4:14/4to15/4:,13,True,True
2788,450,578,128,12/14to11/14,8/9to8/8,12/14to11/14:11/14to10/14:10/14to9/14:9/14to8/14:8/14to8/13:8/13to8/12:8/12to8/11:8/11to8/10:8/10to8/9:8/9to8/8:,10,False,True
406,450,511,61,11/11to11/10,13/9to14/9,11/11to11/10:11/10to11/9:11/9to12/9:12/9to13/9:13/9to14/9:,5,True,True
655,450,703,253,15/10to15/9,4/13to5/13,15/10to15/9:15/9to14/9:14/9to13/9:13/9to12/9:12/9to11/9:11/9to10/9:10/9to9/9:9/9to8/9:8/9to7/9:7/9to6/9:6/9to5/9:5/9to4/9:4/9to4/10:4/10to4/11:4/11to4/12:4/12to4/13:4/13to5/13:,17,False,True
734,451,680,229,6/14to6/15,14/7to15/7,6/14to6/15:6/15to7/15:7/15to8/15:8/15to9/15:9/15to10/15:10/15to10/14:10/14to10/13:10/13to10/12:10/12to10/11:10/11to10/10:10/10to10/9:10/9to10/8:10/8to10/7:10/7to11/7:11/7to12/7:12/7to13/7:13/7to14/7:14/7to15/7:,18,False,True
539,451,569,118,6/14to6/13,7/6to8/6,6/14to6/13:6/13to6/12:6/12to6/11:6/11to6/10:6/10to6/9:6/9to6/8:6/8to6/7:6/7to6/6:6/6to7/6:7/6to8/6:,10,True,True
1393,451,669,218,13/13to12/13,7/4to6/4,13/13to12/13:12/13to11/13:11/13to10/13:10/13to9/13:9/13to8/13:8/13to7/13:7/13to7/12:7/12to7/11:7/11to7/10:7/10to7/9:7/9to7/8:7/8to7/7:7/7to7/6:7/6to7/5:7/5to7/4:7/4to6/4:,16,False,True
1842,451,733,282,4/2to5/2,13/8to14/8,4/2to5/2:5/2to5/3:5/3to5/4:5/4to5/5:5/5to5/6:5/6to5/7:5/7to6/7:6/7to7/7:7/7to8/7:8/7to9/7:9/7to10/7:10/7to10/8:10/8to11/8:11/8to12/8:12/8to13/8:13/8to14/8:,16,True,True
2548,452,643,191,13/3to12/3,8/11to8/12,13/3to12/3:12/3to11/3:11/3to10/3:10/3to9/3:9/3to8/3:8/3to8/4:8/4to8/5:8/5to8/6:8/6to8/7:8/7to8/8:8/8to8/9:8/9to8/10:8/10to8/11:8/11to8/12:,14,True,True
748,452,713,261,4/5to4/4,14/11to14/10,4/5to4/4:4/4to5/4:5/4to6/4:6/4to7/4:7/4to8/4:8/4to9/4:9/4to10/4:10/4to10/5:10/5to10/6:10/6to10/7:10/7to10/8:10/8to10/9:10/9to10/10:10/10to10/11:10/11to11/11:11/11to12/11:12/11to13/11:13/11to14/11:14/11to14/10:,19,False,True
1757,452,531,79,6/12to6/11,8/10to9/10,6/12to6/11:6/11to6/10:6/10to7/10:7/10to8/10:8/10to9/10:,5,False,True
440,452,489,37,1/3to2/3,2/4to2/5,1/3to2/3:2/3to2/4:2/4to2/5:,3,True,True
3336,452,659,207,9/4to9/5,1/11to0/11,9/4to9/5:9/5to8/5:8/5to7/5:7/5to6/5:6/5to5/5:5/5to4/5:4/5to3/5:3/5to2/5:2/5to1/5:1/5to1/6:1/6to1/7:1/7to1/8:1/8to1/9:1/9to1/10:1/10to1/11:1/11to0/11:,16,True,True
473,452,754,302,15/1to15/2,6/15to7/15,15/1to15/2:15/2to14/2:14/2to13/2:13/2to12/2:12/2to11/2:11/2to10/2:10/2to9/2:9/2to8/2:8/2to7/2:7/2to6/2:6/2to6/3:6/3to6/4:6/4to6/5:6/5to6/6:6/6to6/7:6/7to6/8:6/8to6/9:6/9to6/10:6/10to6/11:6/11to6/12:6/12to6/13:6/13to6/14:6/14to6/15:6/15to7/15:,24,True,True
1475,453,676,223,0/11to1/11,14/13to14/12,0/11to1/11:1/11to2/11:2/11to3/11:3/11to4/11:4/11to5/11:5/11to6/11:6/11to7/11:7/11to8/11:8/11to9/11:9/11to10/11:10/11to10/12:10/12to10/13:10/13to11/13:11/13to12/13:12/13to13/13:13/13to14/13:14/13to14/12:,17,False,True
2706,453,489,36,4/13to3/13,3/12to4/12,4/13to3/13:3/13to3/12:3/12to4/12:,3,False,True
3320,453,619,166,6/2to6/1,13/4to14/4,6/2to6/1:6/1to7/1:7/1to8/1:8/1to9/1:9/1to10/1:10/1to10/2:10/2to10/3:10/3to10/4:10/4to11/4:11/4to12/4:12/4to13/4:13/4to14/4:,12,False,True
923,454,607,153,4/10to3/10,8/6to8/7,4/10to3/10:3/10to3/9:3/9to3/8:3/8to3/7:3/7to3/6:3/6to4/6:4/6to5/6:5/6to6/6:6/6to7/6:7/6to8/6:8/6to8/7:,11,True,True
1432,454,583,129,7/2to6/2,6/11to6/12,7/2to6/2:6/2to6/3:6/3to6/4:6/4to6/5:6/5to6/6:6/6to6/7:6/7to6/8:6/8to6/9:6/9to6/10:6/10to6/11:6/11to6/12:,11,False,True
2477,455,529,74,left13to0/13,2/11to2/10,left13to0/13:0/13to0/12:0/12to0/11:0/11to1/11:1/11to2/11:2/11to2/10:,6,True,True
2170,455,493,38,13/9to14/9,14/8to15/8,13/9to14/9:14/9to14/8:14/8to15/8:,3,False,True
2540,455,502,47,2/2to1/2,1/0tobottom1,2/2to1/2:1/2to1/1:1/1to1/0:1/0tobottom1:,4,False,True
594,455,681,226,8/3to9/3,14/13to15/13,8/3to9/3:9/3to10/3:10/3to10/4:10/4to10/5:10/5to10/6:10/6to10/7:10/7to10/8:10/8to10/9:10/9to10/10:10/10to10/11:10/11to10/12:10/12to10/13:10/13to11/13:11/13to12/13:12/13to13/13:13/13to14/13:14/13to15/13:,17,False,True
1355,456,482,26,10/8to9/8,9/8to9/7,10/8to9/8:9/8to9/7:,2,True,True
1243,456,882,426,1/1to1/2,15/12to15/11,1/1to1/2:1/2to2/2:2/2to3/2:3/2to4/2:4/2to5/2:5/2to6/2:6/2to7/2:7/2to8/2:8/2to9/2:9/2to10/2:10/2to10/3:10/3to10/4:10/4to10/5:10/5to10/6:10/6to10/7:10/7to10/8:10/8to10/9:10/9to10/10:10/10to10/11:10/11to10/12:10/12to11/12:11/12to12/12:12/12to13/12:13/12to14/12:14/12to15/12:15/12to15/11:,26,False,True
2995,457,559,102,12/8to11/8,10/5to11/5,12/8to11/8:11/8to12/8:12/8to12/7:12/7to12/6:12/6to11/6:11/6to10/6:10/6to10/5:10/5to11/5:,8,True,True
2722,458,668,210,11/0to11/1,0/3toleft3,11/0to11/1:11/1to10/1:10/1to9/1:9/1to8/1:8/1to7/1:7/1to6/1:6/1to5/1:5/1to4/1:4/1to3/1:3/1to2/1:2/1to1/1:1/1to0/1:0/1to0/2:0/2to0/3:0/3toleft3:,15,False,True
2735,458,633,175,6/3to6/2,15/3toright3,6/3to6/2:6/2to7/2:7/2to8/2:8/2to9/2:9/2to10/2:10/2to10/3:10/3to11/3:11/3to12/3:12/3to13/3:13/3to14/3:14/3to15/3:15/3toright3:,12,False,True
1171,458,730,272,12/12to11/12,4/13to3/13,12/12to11/12:11/12to10/12:10/12to9/12:9/12to8/12:8/12to7/12:7/12to6/12:6/12to5/12:5/12to4/12:4/12to4/13:4/13to3/13:,10,False,True
1443,458,642,184,7/4to7/3,12/9to12/8,7/4to7/3:7/3to8/3:8/3to9/3:9/3to10/3:10/3to10/4:10/4to10/5:10/5to10/6:10/6to10/7:10/7to10/8:10/8to10/9:10/9to11/9:11/9to12/9:12/9to12/8:,13,False,True
453,458,542,84,4/3to3/3,1/0to2/0,4/3to3/3:3/3to2/3:2/3to1/3:1/3to1/2:1/2to1/1:1/1to1/0:1/0to2/0:,7,True,True
3095,458,746,288,13/14to13/15,4/2to3/2,13/14to13/15:13/15to12/15:12/15to11/15:11/15to10/15:10/15to9/15:9/15to8/15:8/15to7/15:7/15to6/15:6/15to5/15:5/15to4/15:4/15to4/14:4/14to4/13:4/13to4/12:4/12to4/11:4/11to4/10:4/10to4/9:4/9to4/8:4/8to4/7:4/7to4/6:4/6to4/5:4/5to4/4:4/4to4/3:4/3to4/2:4/2to3/2:,24,False,True
2409,458,576,118,1/13to2/13,9/13to10/13,1/13to2/13:2/13to3/13:3/13to4/13:4/13to5/13:5/13to6/13:6/13to7/13:7/13to8/13:8/13to9/13:9/13to10/13:,9,False,True
2390,458,517,59,15/10to14/10,14/7to14/6,15/10to14/10:14/10to14/9:14/9to14/8:14/8to14/7:14/7to14/6:,5,False,True
1286,459,678,219,2/4to2/5,8/13to9/13,2/4to2/5:2/5to2/6:2/6to2/7:2/7to2/8:2/8to2/9:2/9to2/10:2/10to2/11:2/11to2/12:2/12to2/13:2/13to3/13:3/13to4/13:4/13to5/13:5/13to6/13:6/13to7/13:7/13to8/13:8/13to9/13:,16,False,True
1060,459,619,160,11/2to11/3,6/9to6/10,11/2to11/3:11/3to10/3:10/3to9/3:9/3to8/3:8/3to7/3:7/3to6/3:6/3to6/4:6/4to6/5:6/5to6/6:6/6to6/7:6/7to6/8:6/8to6/9:6/9to6/10:,13,True,True
1643,460,505,45,4/8to4/7,3/6to3/5,4/8to4/7:4/7to3/7:3/7to3/6:3/6to3/5:,4,True,True
2316,460,525,65,1/4to2/4,3/2to4/2,1/4to2/4:2/4to2/3:2/3to2/2:2/2to3/2:3/2to4/2:,5,False,True
2611,460,498,38,13/12to12/12,11/12to11/13,13/12to12/12:12/12to11/12:11/12to11/13:,3,True,True
2538,461,556,95,14/1to14/0,10/2to11/2,14/1to14/0:14/0to13/0:13/0to12/0:12/0to11/0:11/0to11/1:11/1to10/1:10/1to10/2:10/2to11/2:,8,True,True
2018,461,696,235,11/13to11/14,7/6to7/5,11/13to11/14:11/14to10/14:10/14to9/14:9/14to8/14:8/14to7/14:7/14to7/13:7/13to7/12:7/12to7/11:7/11to7/10:7/10to7/9:7/9to7/8:7/8to7/7:7/7to7/6:7/6to7/5:,14,False,True
2828,461,729,268,8/9to9/9,14/15to15/15,8/9to9/9:9/9to9/10:9/10to9/11:9/11to9/12:9/12to9/13:9/13to9/14:9/14to10/14:10/14to10/15:10/15to11/15:11/15to12/15:12/15to13/15:13/15to14/15:14/15to15/15:,13,True,True
1078,461,653,192,7/13to8/13,15/14toright14,7/13to8/13:8/13to9/13:9/13to10/13:10/13to10/14:10/14to11/14:11/14to12/14:12/14to13/14:13/14to14/14:14/14to15/14:15/14toright14:,10,False,True
1760,461,553,92,9/5to8/5,4/6to5/6,9/5to8/5:8/5to7/5:7/5to6/5:6/5to5/5:5/5to4/5:4/5to4/6:4/6to5/6:,7,False,True
2464,462,559,97,9/12to8/12,9/7to9/8,9/12to8/12:8/12to8/11:8/11to8/10:8/10to8/9:8/9to8/8:8/8to8/7:8/7to9/7:9/7to9/8:,8,True,True
365,462,839,377,right0to15/0,0/15totop0,right0to15/0:15/0to14/0:14/0to13/0:13/0to12/0:12/0to11/0:11/0to10/0:10/0to9/0:9/0to8/0:8/0to7/0:7/0to6/0:6/0to5/0:5/0to4/0:4/0to3/0:3/0to2/0:2/0to1/0:1/0to0/0:0/0to0/1:0/1to0/2:0/2to0/3:0/3to0/4:0/4to0/5:0/5to0/6:0/6to0/7:0/7to0/8:0/8to0/9:0/9to0/10:0/10to0/11:0/11to0/12:0/12to0/13:0/13to0/14:0/14to0/15:0/15totop0:,32,False,True
2864,463,612,149,10/0to10/1,12/10to13/10,10/0to10/1:10/1to10/2:10/2to11/2:11/2to11/3:11/3to11/4:11/4to11/5:11/5to11/6:11/6to11/7:11/7to11/8:11/8to11/9:11/9to11/10:11/10to12/10:12/10to13/10:,13,True,True
3169,463,721,258,left12to0/12,14/15totop14,left12to0/12:0/12to0/13:0/13to1/13:1/13to2/13:2/13to3/13:3/13to4/13:4/13to5/13:5/13to6/13:6/13to7/13:7/13to8/13:8/13to9/13:9/13to10/13:10/13to10/14:10/14to11/14:11/14to11/15:11/15to12/15:12/15to13/15:13/15to14/15:14/15totop14:,19,True,True
578,463,578,115,5/1to5/2,6/9to7/9,5/1to5/2:5/2to5/3:5/3to5/4:5/4to5/5:5/5to5/6:5/6to5/7:5/7to5/8:5/8to5/9:5/9to6/9:6/9to7/9:,10,False,True
1091,463,584,121,5/5to4/5,0/5toleft5,5/5to4/5:4/5to3/5:3/5to2/5:2/5to1/5:1/5to0/5:0/5toleft5:,6,True,True
2453,464,657,193,10/7to10/6,1/9to2/9,10/7to10/6:10/6to9/6:9/6to8/6:8/6to7/6:7/6to6/6:6/6to5/6:5/6to4/6:4/6to3/6:3/6to2/6:2/6to1/6:1/6to1/7:1/7to1/8:1/8to1/9:1/9to2/9:,14,False,True
1323,464,740,276,15/14to15/15,8/2to9/2,15/14to15/15:15/15to14/15:14/15to13/15:13/15to12/15:12/15to11/15:11/15to10/15:10/15to9/15:9/15to8/15:8/15to8/14:8/14to8/13:8/13to8/12:8/12to8/11:8/11to8/10:8/10to8/9:8/9to8/8:8/8to8/7:8/7to8/6:8/6to8/5:8/5to8/4:8/4to8/3:8/3to8/2:8/2to9/2:,22,False,True
2160,464,613,149,left13to0/13,4/13to4/14,left13to0/13:0/13to1/13:1/13to2/13:2/13to3/13:3/13to4/13:4/13to4/14:,6,True,True
1467,464,661,197,3/3to3/2,1/15to0/15,3/3to3/2:3/2to2/2:2/2to1/2:1/2to1/3:1/3to1/4:1/4to1/5:1/5to1/6:1/6to1/7:1/7to1/8:1/8to1/9:1/9to1/10:1/10to1/11:1/11to1/12:1/12to1/13:1/13to1/14:1/14to1/15:1/15to0/15:,17,True,True
1391,465,602,137,left15to0/15,7/13to7/14,left15to0/15:0/15to0/14:0/14to0/13:0/13to1/13:1/13to2/13:2/13to3/13:3/13to4/13:4/13to5/13:5/13to6/13:6/13to7/13:7/13to7/14:,11,True,True
2016,465,645,180,9/0to10/0,10/10to9/10,9/0to10/0:10/0to9/0:9/0to9/1:9/1to9/2:9/2to9/3:9/3to9/4:9/4to9/5:9/5to9/6:9/6to9/7:9/7to9/8:9/8to10/8:10/8to10/9:10/9to10/10:10/10to9/10:,14,True,True
1634,466,651,185,1/2to1/3,5/12to6/12,1/2to1/3:1/3to1/4:1/4to1/5:1/5to1/6:1/6to1/7:1/7to1/8:1/8to1/9:1/9to1/10:1/10to1/11:1/11to1/12:1/12to2/12:2/12to3/12:3/12to4/12:4/12to5/12:5/12to6/12:,15,True,True
1023,466,504,38,6/9to5/9,5/10to5/11,6/9to5/9:5/9to5/10:5/10to5/11:,3,False,True
1895,467,543,76,right7to15/7,12/9to12/10,right7to15/7:15/7to14/7:14/7to13/7:13/7to12/7:12/7to12/8:12/8to12/9:12/9to12/10:,7,False,True
2040,467,688,221,bottom3to3/0,9/9to10/9,bottom3to3/0:3/0to3/1:3/1to3/2:3/2to3/3:3/3to3/4:3/4to3/5:3/5to3/6:3/6to3/7:3/7to3/8:3/8to3/9:3/9to4/9:4/9to5/9:5/9to6/9:6/9to7/9:7/9to8/9:8/9to9/9:9/9to10/9:,17,True,True
1142,468,702,234,5/1to4/1,8/15to8/14,5/1to4/1:4/1to4/2:4/2to4/3:4/3to4/4:4/4to4/5:4/5to4/6:4/6to4/7:4/7to4/8:4/8to4/9:4/9to4/10:4/10to4/11:4/11to4/12:4/12to4/13:4/13to4/14:4/14to4/15:4/15to5/15:5/15to6/15:6/15to7/15:7/15to8/15:8/15to8/14:,20,False,True
2931,468,665,197,1/15to2/15,14/14to14/15,1/15to2/15:2/15to2/14:2/14to3/14:3/14to4/14:4/14to5/14:5/14to6/14:6/14to7/14:7/14to8/14:8/14to9/14:9/14to10/14:10/14to11/14:11/14to12/14:12/14to13/14:13/14to14/14:14/14to14/15:,15,True,True
2647,468,629,161,right15to15/15,8/10to8/9,right15to15/15:15/15to14/15:14/15to13/15:13/15to12/15:12/15to11/15:11/15to10/15:10/15to9/15:9/15to8/15:8/15to8/14:8/14to8/13:8/13to8/12:8/12to8/11:8/11to8/10:8/10to8/9:,14,True,True
1680,468,655,187,1/3to2/3,11/4to12/4,1/3to2/3:2/3to3/3:3/3to4/3:4/3to5/3:5/3to6/3:6/3to7/3:7/3to8/3:8/3to9/3:9/3to10/3:10/3to11/3:11/3to11/4:11/4to12/4:,12,True,True
1199,469,746,277,right0to15/0,1/5to1/6,right0to15/0:15/0to14/0:14/0to13/0:13/0to12/0:12/0to11/0:11/0to10/0:10/0to9/0:9/0to8/0:8/0to7/0:7/0to6/0:6/0to5/0:5/0to4/0:4/0to3/0:3/0to2/0:2/0to1/0:1/0to1/1:1/1to1/2:1/2to1/3:1/3to1/4:1/4to1/5:1/5to1/6:,21,True,True
1029,469,672,203,9/15to9/14,4/4to4/3,9/15to9/14:9/14to8/14:8/14to7/14:7/14to6/14:6/14to5/14:5/14to4/14:4/14to4/13:4/13to4/12:4/12to4/11:4/11to4/10:4/10to4/9:4/9to4/8:4/8to4/7:4/7to4/6:4/6to4/5:4/5to4/4:4/4to4/3:,17,True,True
1151,469,677,208,15/13to14/13,4/15totop4,15/13to14/13:14/13to13/13:13/13to12/13:12/13to12/14:12/14to11/14:11/14to10/14:10/14to9/14:9/14to8/14:8/14to7/14:7/14to6/14:6/14to5/14:5/14to4/14:4/14to4/15:4/15totop4:,14,True,True
779,470,583,113,13/10to12/10,9/15totop9,13/10to12/10:12/10to11/10:11/10to10/10:10/10to10/11:10/11to10/12:10/12to10/13:10/13to10/14:10/14to10/15:10/15to9/15:9/15totop9:,10,False,True
1592,470,599,129,7/5to7/6,4/10to3/10,7/5to7/6:7/6to6/6:6/6to5/6:5/6to4/6:4/6to4/7:4/7to4/8:4/8to4/9:4/9to4/10:4/10to3/10:,9,True,True
730,471,607,136,7/1to7/2,9/8to9/9,7/1to7/2:7/2to7/3:7/3to7/4:7/4to7/5:7/5to7/6:7/6to7/7:7/7to7/8:7/8to8/8:8/8to9/8:9/8to9/9:,10,True,True
2108,471,574,103,5/4to5/5,3/0tobottom3,5/4to5/5:5/5to4/5:4/5to3/5:3/5to3/4:3/4to3/3:3/3to3/2:3/2to3/1:3/1to3/0:3/0tobottom3:,9,False,True
971,472,610,138,12/14to11/14,6/14to6/13,12/14to11/14:11/14to10/14:10/14to9/14:9/14to8/14:8/14to7/14:7/14to6/14:6/14to6/13:,7,True,True
2065,472,608,136,4/6to5/6,13/6to14/6,4/6to5/6:5/6to6/6:6/6to7/6:7/6to8/6:8/6to9/6:9/6to10/6:10/6to11/6:11/6to12/6:12/6to13/6:13/6to14/6:,10,False,True
3384,473,693,220,15/4to15/3,6/6to5/6,15/4to15/3:15/3to14/3:14/3to13/3:13/3to12/3:12/3to11/3:11/3to10/3:10/3to9/3:9/3to8/3:8/3to7/3:7/3to6/3:6/3to6/4:6/4to6/5:6/5to6/6:6/6to5/6:,14,False,True
1829,473,756,283,6/7to6/6,11/15to12/15,6/7to6/6:6/6to6/7:6/7to6/8:6/8to6/9:6/9to6/10:6/10to6/11:6/11to6/12:6/12to6/13:6/13to6/14:6/14to7/14:7/14to8/14:8/14to9/14:9/14to10/14:10/14to10/15:10/15to11/15:11/15to12/15:,16,True,True
772,473,764,291,9/8to8/8,0/3to1/3,9/8to8/8:8/8to7/8:7/8to6/8:6/8to5/8:5/8to4/8:4/8to3/8:3/8to2/8:2/8to1/8:1/8to0/8:0/8to0/7:0/7to0/6:0/6to0/5:0/5to0/4:0/4to0/3:0/3to1/3:,15,True,True
585,474,966,492,0/7to1/7,12/13to12/12,0/7to1/7:1/7to2/7:2/7to3/7:3/7to4/7:4/7to5/7:5/7to6/7:6/7to7/7:7/7to8/7:8/7to9/7:9/7to10/7:10/7to10/8:10/8to10/9:10/9to10/10:10/10to10/11:10/11to10/12:10/12to10/13:10/13to11/13:11/13to12/13:12/13to12/12:,19,False,True
629,474,585,111,left3to0/3,6/1to6/0,left3to0/3:0/3to0/2:0/2to0/1:0/1to1/1:1/1to2/1:2/1to3/1:3/1to4/1:4/1to5/1:5/1to6/1:6/1to6/0:,10,True,True
2835,474,736,262,14/15to13/15,8/0to9/0,14/15to13/15:13/15to12/15:12/15to11/15:11/15to10/15:10/15to9/15:9/15to8/15:8/15to8/14:8/14to8/13:8/13to8/12:8/12to8/11:8/11to8/10:8/10to8/9:8/9to8/8:8/8to8/7:8/7to8/6:8/6to8/5:8/5to8/4:8/4to8/3:8/3to8/2:8/2to8/1:8/1to8/0:8/0to9/0:,22,True,True
3100,474,759,285,15/8to15/7,5/3to5/2,15/8to15/7:15/7to14/7:14/7to13/7:13/7to12/7:12/7to11/7:11/7to10/7:10/7to9/7:9/7to8/7:8/7to7/7:7/7to6/7:6/7to5/7:5/7to5/6:5/6to5/5:5/5to5/4:5/4to5/3:5/3to5/2:,16,False,True
2891,474,534,60,9/5to9/6,8/4to8/3,9/5to9/6:9/6to8/6:8/6to8/5:8/5to8/4:8/4to8/3:,5,True,True
3045,475,761,286,11/7to10/7,1/1to0/1,11/7to10/7:10/7to9/7:9/7to8/7:8/7to7/7:7/7to6/7:6/7to5/7:5/7to4/7:4/7to3/7:3/7to2/7:2/7to1/7:1/7to1/6:1/6to1/5:1/5to1/4:1/4to1/3:1/3to1/2:1/2to1/1:1/1to0/1:,17,True,True
1241,475,645,170,6/3to7/3,11/10to11/9,6/3to7/3:7/3to7/4:7/4to7/5:7/5to7/6:7/6to7/7:7/7to7/8:7/8to7/9:7/9to7/10:7/10to8/10:8/10to9/10:9/10to10/10:10/10to11/10:11/10to11/9:,13,True,True
915,475,796,321,2/1to2/2,11/8to11/9,2/1to2/2:2/2to3/2:3/2to4/2:4/2to5/2:5/2to6/2:6/2to7/2:7/2to8/2:8/2to9/2:9/2to10/2:10/2to10/3:10/3to10/4:10/4to10/5:10/5to10/6:10/6to10/7:10/7to10/8:10/8to11/8:11/8to11/9:,17,False,True
784,475,524,49,13/12to13/13,15/13to15/14,13/12to13/13:13/13to14/13:14/13to15/13:15/13to15/14:,4,False,True
2729,475,618,143,4/14to4/13,12/12to12/13,4/14to4/13:4/13to5/13:5/13to6/13:6/13to7/13:7/13to8/13:8/13to9/13:9/13to10/13:10/13to10/12:10/12to11/12:11/12to12/12:12/12to12/13:,11,False,True
156,475,909,434,left0to0/0,15/15totop15,left0to0/0:0/0to0/1:0/1to0/2:0/2to0/3:0/3to0/4:0/4to0/5:0/5to0/6:0/6to0/7:0/7to0/8:0/8to0/9:0/9to0/10:0/10to0/11:0/11to0/12:0/12to0/13:0/13to0/14:0/14to1/14:1/14to2/14:2/14to3/14:3/14to4/14:4/14to5/14:5/14to6/14:6/14to7/14:7/14to8/14:8/14to9/14:9/14to10/14:10/14to10/15:10/15to11/15:11/15to12/15:12/15to13/15:13/15to14/15:14/15to15/15:15/15totop15:,32,True,True
157,475,904,429,left0to0/0,15/15totop15,left0to0/0:0/0to0/1:0/1to0/2:0/2to0/3:0/3to0/4:0/4to0/5:0/5to0/6:0/6to0/7:0/7to0/8:0/8to0/9:0/9to0/10:0/10to0/11:0/11to0/12:0/12to0/13:0/13to1/13:1/13to2/13:2/13to3/13:3/13to4/13:4/13to5/13:5/13to6/13:6/13to7/13:7/13to8/13:8/13to9/13:9/13to10/13:10/13to10/14:10/14to11/14:11/14to11/15:11/15to12/15:12/15to13/15:13/15to14/15:14/15to15/15:15/15totop15:,32,True,True
1,476,860,384,left15to0/15,15/0tobottom15,left15to0/15:0/15to0/14:0/14to0/13:0/13to0/12:0/12to0/11:0/11to0/10:0/10to0/9:0/9to0/8:0/8to0/7:0/7to0/6:0/6to0/5:0/5to0/4:0/4to0/3:0/3to0/2:0/2to0/1:0/1to0/0:0/0to1/0:1/0to2/0:2/0to3/0:3/0to4/0:4/0to5/0:5/0to6/0:6/0to7/0:7/0to8/0:8/0to9/0:9/0to10/0:10/0to11/0:11/0to12/0:12/0to13/0:13/0to14/0:14/0to15/0:15/0tobottom15:,32,True,True
2458,477,623,146,14/12to13/12,6/13to5/13,14/12to13/12:13/12to12/12:12/12to11/12:11/12to11/13:11/13to10/13:10/13to9/13:9/13to8/13:8/13to7/13:7/13to6/13:6/13to5/13:,10,True,True
962,477,562,85,3/7to3/8,3/13to3/14,3/7to3/8:3/8to3/9:3/9to3/10:3/10to3/11:3/11to3/12:3/12to3/13:3/13to3/14:,7,True,True
920,477,626,149,9/0to9/1,1/1to0/1,9/0to9/1:9/1to8/1:8/1to7/1:7/1to6/1:6/1to5/1:5/1to4/1:4/1to3/1:3/1to2/1:2/1to1/1:1/1to0/1:,10,False,True
456,478,616,138,0/1to1/1,1/11to1/12,0/1to1/1:1/1to1/2:1/2to1/3:1/3to1/4:1/4to1/5:1/5to1/6:1/6to1/7:1/7to1/8:1/8to1/9:1/9to1/10:1/10to1/11:1/11to1/12:,12,False,True
1890,479,605,126,13/14to13/13,13/4to13/3,13/14to13/13:13/13to13/12:13/12to13/11:13/11to13/10:13/10to13/9:13/9to13/8:13/8to13/7:13/7to13/6:13/6to13/5:13/5to13/4:13/4to13/3:,11,True,True
1620,479,622,143,1/1to2/1,4/9to4/8,1/1to2/1:2/1to2/2:2/2to2/3:2/3to2/4:2/4to2/5:2/5to2/6:2/6to2/7:2/7to2/8:2/8to2/9:2/9to3/9:3/9to4/9:4/9to4/8:,12,False,True
623,479,591,112,top9to9/15,4/13to5/13,top9to9/15:9/15to8/15:8/15to7/15:7/15to6/15:6/15to5/15:5/15to4/15:4/15to4/14:4/14to4/13:4/13to5/13:,9,True,True
1311,479,804,325,12/10to11/10,4/0tobottom4,12/10to11/10:11/10to10/10:10/10to9/10:9/10to8/10:8/10to7/10:7/10to6/10:6/10to5/10:5/10to4/10:4/10to4/9:4/9to4/8:4/8to4/7:4/7to4/6:4/6to4/5:4/5to4/4:4/4to4/3:4/3to4/2:4/2to4/1:4/1to4/0:4/0tobottom4:,19,False,True
344,479,875,396,right0to15/0,0/15totop0,right0to15/0:15/0to14/0:14/0to13/0:13/0to12/0:12/0to11/0:11/0to10/0:10/0to9/0:9/0to8/0:8/0to7/0:7/0to6/0:6/0to5/0:5/0to4/0:4/0to3/0:3/0to2/0:2/0to1/0:1/0to0/0:0/0to0/1:0/1to0/2:0/2to0/3:0/3to0/4:0/4to0/5:0/5to0/6:0/6to0/7:0/7to0/8:0/8to0/9:0/9to0/10:0/10to0/11:0/11to0/12:0/12to0/13:0/13to0/14:0/14to0/15:0/15totop0:,32,True,True
787,480,700,220,bottom9to9/0,2/10to1/10,bottom9to9/0:9/0to8/0:8/0to7/0:7/0to6/0:6/0to5/0:5/0to4/0:4/0to3/0:3/0to2/0:2/0to2/1:2/1to2/2:2/2to2/3:2/3to2/4:2/4to2/5:2/5to2/6:2/6to2/7:2/7to2/8:2/8to2/9:2/9to2/10:2/10to1/10:,19,False,True
3191,480,623,143,11/5to11/6,14/13to14/12,11/5to11/6:11/6to11/7:11/7to11/8:11/8to11/9:11/9to11/10:11/10to11/11:11/11to11/12:11/12to11/13:11/13to12/13:12/13to13/13:13/13to14/13:14/13to14/12:,12,True,True
1094,480,676,196,11/10to11/11,4/13to3/13,11/10to11/11:11/11to10/11:10/11to9/11:9/11to8/11:8/11to7/11:7/11to6/11:6/11to5/11:5/11to4/11:4/11to4/12:4/12to4/13:4/13to3/13:,11,True,True
1583,480,527,47,7/14to7/13,8/12to8/11,7/14to7/13:7/13to7/12:7/12to8/12:8/12to8/11:,4,True,True
2989,480,728,248,left3to0/3,9/11to9/10,left3to0/3:0/3to0/4:0/4to0/5:0/5to0/6:0/6to0/7:0/7to0/8:0/8to0/9:0/9to0/10:0/10to0/11:0/11to1/11:1/11to2/11:2/11to3/11:3/11to4/11:4/11to5/11:5/11to6/11:6/11to7/11:7/11to8/11:8/11to9/11:9/11to9/10:,19,True,True
1017,480,578,98,9/3to8/3,6/7to5/7,9/3to8/3:8/3to7/3:7/3to6/3:6/3to6/4:6/4to6/5:6/5to6/6:6/6to6/7:6/7to5/7:,8,True,True
1792,480,622,142,0/6to0/5,4/0to5/0,0/6to0/5:0/5to0/4:0/4to0/3:0/3to0/2:0/2to0/1:0/1to0/0:0/0to1/0:1/0to2/0:2/0to3/0:3/0to4/0:4/0to5/0:,11,True,True
2054,481,756,275,14/7to14/6,7/6to6/6,14/7to14/6:14/6to13/6:13/6to12/6:12/6to11/6:11/6to10/6:10/6to9/6:9/6to8/6:8/6to7/6:7/6to6/6:,9,False,True
2216,481,680,199,10/2to10/3,13/15to14/15,10/2to10/3:10/3to10/4:10/4to10/5:10/5to10/6:10/6to10/7:10/7to10/8:10/8to10/9:10/9to10/10:10/10to10/11:10/11to10/12:10/12to10/13:10/13to10/14:10/14to10/15:10/15to11/15:11/15to12/15:12/15to13/15:13/15to14/15:,17,False,True
1047,482,664,182,8/1to8/2,9/15to10/15,8/1to8/2:8/2to8/3:8/3to8/4:8/4to8/5:8/5to8/6:8/6to8/7:8/7to8/8:8/8to8/9:8/9to8/10:8/10to8/11:8/11to8/12:8/12to8/13:8/13to8/14:8/14to8/15:8/15to9/15:9/15to10/15:,16,True,True
614,482,625,143,6/11to6/10,2/4to1/4,6/11to6/10:6/10to5/10:5/10to4/10:4/10to3/10:3/10to2/10:2/10to2/9:2/9to2/8:2/8to2/7:2/7to2/6:2/6to2/5:2/5to2/4:2/4to1/4:,12,False,True
1210,482,619,137,14/7to14/6,9/2to8/2,14/7to14/6:14/6to13/6:13/6to12/6:12/6to11/6:11/6to11/5:11/5to11/4:11/4to11/3:11/3to11/2:11/2to10/2:10/2to9/2:9/2to8/2:,11,True,True
455,482,765,283,top15to15/15,3/6to3/5,top15to15/15:15/15to14/15:14/15to13/15:13/15to12/15:12/15to11/15:11/15to10/15:10/15to9/15:9/15to8/15:8/15to7/15:7/15to6/15:6/15to5/15:5/15to4/15:4/15to3/15:3/15to3/14:3/14to3/13:3/13to3/12:3/12to3/11:3/11to3/10:3/10to3/9:3/9to3/8:3/8to3/7:3/7to3/6:3/6to3/5:,23,False,True
2806,482,525,43,9/3to8/3,8/2to8/1,9/3to8/3:8/3to8/2:8/2to8/1:,3,False,True
364,482,869,387,right0to15/0,0/15totop0,right0to15/0:15/0to14/0:14/0to13/0:13/0to12/0:12/0to11/0:11/0to10/0:10/0to9/0:9/0to8/0:8/0to7/0:7/0to6/0:6/0to5/0:5/0to4/0:4/0to3/0:3/0to2/0:2/0to1/0:1/0to0/0:0/0to0/1:0/1to0/2:0/2to0/3:0/3to0/4:0/4to0/5:0/5to0/6:0/6to0/7:0/7to0/8:0/8to0/9:0/9to0/10:0/10to0/11:0/11to0/12:0/12to0/13:0/13to0/14:0/14to0/15:0/15totop0:,32,False,True
559,482,498,16,right12to15/12,15/12to14/12,right12to15/12:15/12to14/12:,2,True,True
2139,483,778,295,14/12to14/11,6/6to5/6,14/12to14/11:14/11to13/11:13/11to12/11:12/11to11/11:11/11to10/11:10/11to9/11:9/11to8/11:8/11to7/11:7/11to6/11:6/11to6/10:6/10to6/9:6/9to6/8:6/8to6/7:6/7to6/6:6/6to5/6:,15,True,True
3367,483,638,155,7/8to6/8,1/13to1/14,7/8to6/8:6/8to5/8:5/8to4/8:4/8to3/8:3/8to2/8:2/8to1/8:1/8to1/9:1/9to1/10:1/10to1/11:1/11to1/12:1/12to1/13:1/13to1/14:,12,False,True
2195,484,731,247,1/15to2/15,10/5to10/4,1/15to2/15:2/15to3/15:3/15to4/15:4/15to5/15:5/15to6/15:6/15to7/15:7/15to8/15:8/15to9/15:9/15to10/15:10/15to10/14:10/14to10/13:10/13to10/12:10/12to10/11:10/11to10/10:10/10to10/9:10/9to10/8:10/8to10/7:10/7to10/6:10/6to10/5:10/5to10/4:,20,False,True
2559,484,609,125,11/10to10/10,14/15totop14,11/10to10/10:10/10to10/11:10/11to10/12:10/12to10/13:10/13to10/14:10/14to10/15:10/15to11/15:11/15to12/15:12/15to13/15:13/15to14/15:14/15totop14:,11,False,True
3072,484,564,80,5/3to4/3,7/4to8/4,5/3to4/3:4/3to4/4:4/4to5/4:5/4to6/4:6/4to7/4:7/4to8/4:,6,True,True
2603,484,645,161,11/13to10/13,3/15to4/15,11/13to10/13:10/13to9/13:9/13to8/13:8/13to7/13:7/13to6/13:6/13to5/13:5/13to4/13:4/13to3/13:3/13to3/14:3/14to3/15:3/15to4/15:,11,True,True
1621,484,562,78,3/7to3/8,6/9to6/10,3/7to3/8:3/8to3/9:3/9to4/9:4/9to5/9:5/9to6/9:6/9to6/10:,6,False,True
2379,485,753,268,10/13to10/14,3/1to3/0,10/13to10/14:10/14to9/14:9/14to8/14:8/14to7/14:7/14to6/14:6/14to5/14:5/14to4/14:4/14to3/14:3/14to3/13:3/13to3/12:3/12to3/11:3/11to3/10:3/10to3/9:3/9to3/8:3/8to3/7:3/7to3/6:3/6to3/5:3/5to3/4:3/4to3/3:3/3to3/2:3/2to3/1:3/1to3/0:,22,False,True
499,485,761,276,bottom10to10/0,0/9to0/10,bottom10to10/0:10/0to10/1:10/1to9/1:9/1to8/1:8/1to7/1:7/1to6/1:6/1to5/1:5/1to4/1:4/1to3/1:3/1to2/1:2/1to1/1:1/1to0/1:0/1to0/2:0/2to0/3:0/3to0/4:0/4to0/5:0/5to0/6:0/6to0/7:0/7to0/8:0/8to0/9:0/9to0/10:,21,True,True
1709,485,575,90,9/15to10/15,13/13to13/14,9/15to10/15:10/15to10/14:10/14to10/13:10/13to11/13:11/13to12/13:12/13to13/13:13/13to13/14:,7,True,True
501,486,698,212,11/12to10/12,13/1to14/1,11/12to10/12:10/12to10/11:10/11to11/11:11/11to12/11:12/11to12/10:12/10to12/9:12/9to12/8:12/8to12/7:12/7to12/6:12/6to12/5:12/5to12/4:12/4to12/3:12/3to12/2:12/2to12/1:12/1to13/1:13/1to14/1:,16,True,True
3205,486,569,83,9/14to8/14,9/10to9/11,9/14to8/14:8/14to8/13:8/13to8/12:8/12to8/11:8/11to8/10:8/10to9/10:9/10to9/11:,7,True,True
1200,487,640,153,7/3to6/3,4/12to4/13,7/3to6/3:6/3to5/3:5/3to4/3:4/3to4/4:4/4to4/5:4/5to4/6:4/6to4/7:4/7to4/8:4/8to4/9:4/9to4/10:4/10to4/11:4/11to4/12:4/12to4/13:,13,True,True
354,487,873,386,right0to15/0,0/15totop0,right0to15/0:15/0to14/0:14/0to13/0:13/0to12/0:12/0to11/0:11/0to10/0:10/0to9/0:9/0to8/0:8/0to7/0:7/0to6/0:6/0to5/0:5/0to4/0:4/0to3/0:3/0to2/0:2/0to1/0:1/0to0/0:0/0to0/1:0/1to0/2:0/2to0/3:0/3to0/4:0/4to0/5:0/5to0/6:0/6to0/7:0/7to0/8:0/8to0/9:0/9to0/10:0/10to0/11:0/11to0/12:0/12to0/13:0/13to0/14:0/14to0/15:0/15totop0:,32,True,True
518,487,548,61,6/10to6/9,5/7to5/6,6/10to6/9:6/9to5/9:5/9to5/8:5/8to5/7:5/7to5/6:,5,False,True
1963,487,710,223,bottom7to7/0,13/10to14/10,bottom7to7/0:7/0to8/0:8/0to9/0:9/0to10/0:10/0to10/1:10/1to10/2:10/2to10/3:10/3to10/4:10/4to10/5:10/5to10/6:10/6to10/7:10/7to10/8:10/8to10/9:10/9to10/10:10/10to11/10:11/10to12/10:12/10to13/10:13/10to14/10:,18,False,True
739,487,689,202,6/4to5/4,1/14to1/15,6/4to5/4:5/4to4/4:4/4to3/4:3/4to2/4:2/4to1/4:1/4to1/5:1/5to1/6:1/6to1/7:1/7to1/8:1/8to1/9:1/9to1/10:1/10to1/11:1/11to1/12:1/12to1/13:1/13to1/14:1/14to1/15:,16,True,True
2220,487,628,141,8/10to7/10,4/15to5/15,8/10to7/10:7/10to6/10:6/10to5/10:5/10to4/10:4/10to4/11:4/11to4/12:4/12to4/13:4/13to4/14:4/14to4/15:4/15to5/15:,10,True,True
650,487,720,233,2/4to3/4,15/0tobottom15,2/4to3/4:3/4to3/3:3/3to3/2:3/2to4/2:4/2to5/2:5/2to6/2:6/2to7/2:7/2to8/2:8/2to9/2:9/2to10/2:10/2to10/1:10/1to11/1:11/1to11/0:11/0to12/0:12/0to13/0:13/0to14/0:14/0to15/0:15/0tobottom15:,18,True,True
2253,487,758,271,6/9to6/10,10/12to11/12,6/9to6/10:6/10to7/10:7/10to8/10:8/10to9/10:9/10to10/10:10/10to10/11:10/11to10/12:10/12to11/12:,8,False,True
191,488,901,413,left0to0/0,15/15totop15,left0to0/0:0/0to1/0:1/0to2/0:2/0to3/0:3/0to4/0:4/0to5/0:5/0to6/0:6/0to7/0:7/0to8/0:8/0to9/0:9/0to10/0:10/0to10/1:10/1to10/2:10/2to10/3:10/3to10/4:10/4to10/5:10/5to10/6:10/6to10/7:10/7to10/8:10/8to10/9:10/9to10/10:10/10to10/11:10/11to10/12:10/12to10/13:10/13to10/14:10/14to10/15:10/15to11/15:11/15to12/15:12/15to13/15:13/15to14/15:14/15to15/15:15/15totop15:,32,False,True
2919,488,535,47,10/7to9/7,9/9to8/9,10/7to9/7:9/7to9/8:9/8to9/9:9/9to8/9:,4,False,True
2937,488,662,174,7/15to8/15,12/8to13/8,7/15to8/15:8/15to8/14:8/14to8/13:8/13to8/12:8/12to8/11:8/11to8/10:8/10to8/9:8/9to8/8:8/8to9/8:9/8to10/8:10/8to11/8:11/8to12/8:12/8to13/8:,13,True,True
138,488,894,406,left0to0/0,15/15totop15,left0to0/0:0/0to1/0:1/0to2/0:2/0to3/0:3/0to4/0:4/0to5/0:5/0to6/0:6/0to7/0:7/0to8/0:8/0to9/0:9/0to10/0:10/0to10/1:10/1to10/2:10/2to10/3:10/3to10/4:10/4to10/5:10/5to10/6:10/6to10/7:10/7to10/8:10/8to10/9:10/9to10/10:10/10to10/11:10/11to10/12:10/12to10/13:10/13to10/14:10/14to10/15:10/15to11/15:11/15to12/15:12/15to13/15:13/15to14/15:14/15to15/15:15/15totop15:,32,False,True
670,489,655,166,6/3to5/3,8/11to9/11,6/3to5/3:5/3to5/4:5/4to5/5:5/5to5/6:5/6to5/7:5/7to5/8:5/8to5/9:5/9to5/10:5/10to5/11:5/11to6/11:6/11to7/11:7/11to8/11:8/11to9/11:,13,False,True
425,489,686,197,9/8to8/8,2/15totop2,9/8to8/8:8/8to7/8:7/8to6/8:6/8to5/8:5/8to4/8:4/8to3/8:3/8to2/8:2/8to2/9:2/9to2/10:2/10to2/11:2/11to2/12:2/12to2/13:2/13to2/14:2/14to2/15:2/15totop2:,15,True,True
3129,489,665,176,left5to0/5,3/14to4/14,left5to0/5:0/5to0/6:0/6to0/7:0/7to0/8:0/8to0/9:0/9to0/10:0/10to0/11:0/11to0/12:0/12to0/13:0/13to0/14:0/14to1/14:1/14to2/14:2/14to3/14:3/14to4/14:,14,True,True
1674,489,686,197,11/3to11/2,6/11to6/12,11/3to11/2:11/2to10/2:10/2to9/2:9/2to8/2:8/2to7/2:7/2to6/2:6/2to6/3:6/3to6/4:6/4to6/5:6/5to6/6:6/6to6/7:6/7to6/8:6/8to6/9:6/9to6/10:6/10to6/11:6/11to6/12:,16,True,True
684,489,599,110,0/4to1/4,3/9to3/10,0/4to1/4:1/4to1/5:1/5to1/6:1/6to1/7:1/7to1/8:1/8to1/9:1/9to2/9:2/9to3/9:3/9to3/10:,9,True,True
240,489,869,380,right15to15/15,0/0tobottom0,right15to15/15:15/15to14/15:14/15to13/15:13/15to12/15:12/15to11/15:11/15to10/15:10/15to9/15:9/15to8/15:8/15to7/15:7/15to6/15:6/15to5/15:5/15to4/15:4/15to3/15:3/15to2/15:2/15to1/15:1/15to0/15:0/15to0/14:0/14to0/13:0/13to0/12:0/12to0/11:0/11to0/10:0/10to0/9:0/9to0/8:0/8to0/7:0/7to0/6:0/6to0/5:0/5to0/4:0/4to0/3:0/3to0/2:0/2to0/1:0/1to0/0:0/0tobottom0:,32,False,True
2616,489,686,197,7/8to7/9,12/0to13/0,7/8to7/9:7/9to8/9:8/9to9/9:9/9to10/9:10/9to10/8:10/8to10/7:10/7to10/6:10/6to10/5:10/5to10/4:10/4to10/3:10/3to10/2:10/2to10/1:10/1to10/0:10/0to11/0:11/0to12/0:12/0to13/0:,16,False,True
1788,490,562,72,6/11to6/12,9/13to9/12,6/11to6/12:6/12to6/13:6/13to7/13:7/13to8/13:8/13to9/13:9/13to9/12:,6,True,True
280,490,870,380,right15to15/15,0/0tobottom0,right15to15/15:15/15to14/15:14/15to13/15:13/15to12/15:12/15to11/15:11/15to10/15:10/15to9/15:9/15to8/15:8/15to7/15:7/15to6/15:6/15to5/15:5/15to4/15:4/15to3/15:3/15to2/15:2/15to1/15:1/15to0/15:0/15to0/14:0/14to0/13:0/13to0/12:0/12to0/11:0/11to0/10:0/10to0/9:0/9to0/8:0/8to0/7:0/7to0/6:0/6to0/5:0/5to0/4:0/4to0/3:0/3to0/2:0/2to0/1:0/1to0/0:0/0tobottom0:,32,False,True
2754,490,588,98,top8to8/15,11/12to11/11,top8to8/15:8/15to8/14:8/14to9/14:9/14to10/14:10/14to10/13:10/13to11/13:11/13to11/12:11/12to11/11:,8,True,True
366,490,888,398,right0to15/0,0/15totop0,right0to15/0:15/0to14/0:14/0to13/0:13/0to12/0:12/0to11/0:11/0to10/0:10/0to9/0:9/0to8/0:8/0to7/0:7/0to6/0:6/0to5/0:5/0to4/0:4/0to3/0:3/0to2/0:2/0to1/0:1/0to0/0:0/0to0/1:0/1to0/2:0/2to0/3:0/3to0/4:0/4to0/5:0/5to0/6:0/6to0/7:0/7to0/8:0/8to0/9:0/9to0/10:0/10to0/11:0/11to0/12:0/12to0/13:0/13to0/14:0/14to0/15:0/15totop0:,32,False,True
2897,490,561,71,8/8to7/8,7/12to7/13,8/8to7/8:7/8to7/9:7/9to7/10:7/10to7/11:7/11to7/12:7/12to7/13:,6,False,True
1914,491,756,265,4/1to5/1,14/11to15/11,4/1to5/1:5/1to6/1:6/1to7/1:7/1to8/1:8/1to9/1:9/1to10/1:10/1to10/2:10/2to10/3:10/3to10/4:10/4to10/5:10/5to10/6:10/6to10/7:10/7to10/8:10/8to10/9:10/9to10/10:10/10to10/11:10/11to11/11:11/11to12/11:12/11to13/11:13/11to14/11:14/11to15/11:,21,False,True
450,491,598,107,14/9to14/8,10/11to10/12,14/9to14/8:14/8to13/8:13/8to12/8:12/8to11/8:11/8to10/8:10/8to10/9:10/9to10/10:10/10to10/11:10/11to10/12:,9,False,True
1921,491,575,84,11/3to11/4,13/7to13/6,11/3to11/4:11/4to11/5:11/5to11/6:11/6to12/6:12/6to12/7:12/7to13/7:13/7to13/6:,7,True,True
2644,491,606,115,8/8to8/9,5/8to5/7,8/8to8/9:8/9to7/9:7/9to6/9:6/9to5/9:5/9to5/8:5/8to5/7:,6,False,True
93,491,873,382,left15to0/15,15/0tobottom15,left15to0/15:0/15to0/14:0/14to0/13:0/13to0/12:0/12to0/11:0/11to0/10:0/10to0/9:0/9to0/8:0/8to0/7:0/7to0/6:0/6to0/5:0/5to0/4:0/4to0/3:0/3to0/2:0/2to1/2:1/2to2/2:2/2to3/2:3/2to4/2:4/2to5/2:5/2to6/2:6/2to7/2:7/2to8/2:8/2to9/2:9/2to10/2:10/2to10/1:10/1to11/1:11/1to11/0:11/0to12/0:12/0to13/0:13/0to14/0:14/0to15/0:15/0tobottom15:,32,True,True
822,491,537,46,7/11to7/10,6/11to6/12,7/11to7/10:7/10to6/10:6/10to6/11:6/11to6/12:,4,True,True
2377,491,687,196,13/7to13/8,0/8to0/9,13/7to13/8:13/8to12/8:12/8to11/8:11/8to10/8:10/8to9/8:9/8to8/8:8/8to7/8:7/8to6/8:6/8to5/8:5/8to4/8:4/8to3/8:3/8to2/8:2/8to1/8:1/8to0/8:0/8to0/9:,15,True,True
433,491,697,206,0/11to1/11,5/0to5/1,0/11to1/11:1/11to1/10:1/10to1/9:1/9to1/8:1/8to1/7:1/7to1/6:1/6to1/5:1/5to1/4:1/4to1/3:1/3to1/2:1/2to1/1:1/1to1/0:1/0to2/0:2/0to3/0:3/0to4/0:4/0to5/0:5/0to5/1:,17,False,True
2695,491,528,37,14/9to14/8,13/8to13/7,14/9to14/8:14/8to13/8:13/8to13/7:,3,True,True
2496,492,614,122,5/6to5/5,3/11to2/11,5/6to5/5:5/5to4/5:4/5to3/5:3/5to3/6:3/6to3/7:3/7to3/8:3/8to3/9:3/9to3/10:3/10to3/11:3/11to2/11:,10,True,True
2006,492,847,355,bottom12to12/0,0/15toleft15,bottom12to12/0:12/0to11/0:11/0to10/0:10/0to9/0:9/0to8/0:8/0to7/0:7/0to6/0:6/0to5/0:5/0to4/0:4/0to3/0:3/0to2/0:2/0to1/0:1/0to0/0:0/0to0/1:0/1to0/2:0/2to0/3:0/3to0/4:0/4to0/5:0/5to0/6:0/6to0/7:0/7to0/8:0/8to0/9:0/9to0/10:0/10to0/11:0/11to0/12:0/12to0/13:0/13to0/14:0/14to0/15:0/15toleft15:,29,True,True
2185,492,734,242,top0to0/15,13/10to14/10,top0to0/15:0/15to1/15:1/15to2/15:2/15to3/15:3/15to4/15:4/15to5/15:5/15to6/15:6/15to7/15:7/15to8/15:8/15to9/15:9/15to10/15:10/15to10/14:10/14to10/13:10/13to10/12:10/12to10/11:10/11to10/10:10/10to11/10:11/10to12/10:12/10to13/10:13/10to14/10:,20,False,True
2798,493,707,214,0/9to1/9,11/10to11/9,0/9to1/9:1/9to2/9:2/9to3/9:3/9to4/9:4/9to5/9:5/9to6/9:6/9to7/9:7/9to8/9:8/9to9/9:9/9to10/9:10/9to11/9:11/9to11/10:11/10to11/9:,13,True,True
1668,493,577,84,4/5to5/5,7/8to7/9,4/5to5/5:5/5to5/6:5/6to5/7:5/7to5/8:5/8to6/8:6/8to7/8:7/8to7/9:,7,False,True
2740,494,539,45,3/0to3/1,3/3to4/3,3/0to3/1:3/1to3/2:3/2to3/3:3/3to4/3:,4,True,True
3113,494,722,228,4/13to4/14,10/3to10/2,4/13to4/14:4/14to5/14:5/14to6/14:6/14to7/14:7/14to8/14:8/14to9/14:9/14to10/14:10/14to10/13:10/13to10/12:10/12to10/11:10/11to10/10:10/10to10/9:10/9to10/8:10/8to10/7:10/7to10/6:10/6to10/5:10/5to10/4:10/4to10/3:10/3to10/2:,19,False,True
1964,494,735,241,0/9to1/9,14/9to15/9,0/9to1/9:1/9to2/9:2/9to3/9:3/9to4/9:4/9to5/9:5/9to6/9:6/9to7/9:7/9to8/9:8/9to9/9:9/9to10/9:10/9to11/9:11/9to12/9:12/9to13/9:13/9to14/9:14/9to15/9:,15,True,True
1364,495,751,256,2/9to2/10,10/1to11/1,2/9to2/10:2/10to2/9:2/9to2/8:2/8to2/7:2/7to2/6:2/6to2/5:2/5to2/4:2/4to2/3:2/3to3/3:3/3to4/3:4/3to5/3:5/3to6/3:6/3to7/3:7/3to8/3:8/3to9/3:9/3to10/3:10/3to10/2:10/2to10/1:10/1to11/1:,19,True,True
2000,495,592,97,top1to1/15,6/14to7/14,top1to1/15:1/15to1/14:1/14to2/14:2/14to3/14:3/14to4/14:4/14to5/14:5/14to6/14:6/14to7/14:,8,True,True
2372,495,710,215,10/1to9/1,2/8to2/9,10/1to9/1:9/1to8/1:8/1to7/1:7/1to6/1:6/1to5/1:5/1to4/1:4/1to3/1:3/1to2/1:2/1to2/2:2/2to2/3:2/3to2/4:2/4to2/5:2/5to2/6:2/6to2/7:2/7to2/8:2/8to2/9:,16,False,True
380,495,886,391,right0to15/0,0/15totop0,right0to15/0:15/0to14/0:14/0to13/0:13/0to12/0:12/0to11/0:11/0to11/1:11/1to10/1:10/1to9/1:9/1to8/1:8/1to7/1:7/1to6/1:6/1to5/1:5/1to4/1:4/1to3/1:3/1to2/1:2/1to1/1:1/1to0/1:0/1to0/2:0/2to0/3:0/3to0/4:0/4to0/5:0/5to0/6:0/6to0/7:0/7to0/8:0/8to0/9:0/9to0/10:0/10to0/11:0/11to0/12:0/12to0/13:0/13to0/14:0/14to0/15:0/15totop0:,32,True,True
1749,495,639,144,9/4to10/4,11/12to11/11,9/4to10/4:10/4to10/5:10/5to11/5:11/5to11/6:11/6to11/7:11/7to11/8:11/8to11/9:11/9to11/10:11/10to11/11:11/11to11/12:11/12to11/11:,11,True,True
168,496,906,410,left0to0/0,15/15totop15,left0to0/0:0/0to1/0:1/0to2/0:2/0to3/0:3/0to4/0:4/0to5/0:5/0to6/0:6/0to7/0:7/0to8/0:8/0to9/0:9/0to10/0:10/0to10/1:10/1to10/2:10/2to10/3:10/3to10/4:10/4to10/5:10/5to10/6:10/6to10/7:10/7to10/8:10/8to10/9:10/9to10/10:10/10to10/11:10/11to10/12:10/12to10/13:10/13to10/14:10/14to10/15:10/15to11/15:11/15to12/15:12/15to13/15:13/15to14/15:14/15to15/15:15/15totop15:,32,False,True
2770,496,949,453,1/4to1/5,14/12to15/12,1/4to1/5:1/5to1/6:1/6to1/7:1/7to1/8:1/8to1/9:1/9to1/10:1/10to2/10:2/10to3/10:3/10to4/10:4/10to5/10:5/10to6/10:6/10to7/10:7/10to8/10:8/10to9/10:9/10to10/10:10/10to10/11:10/11to11/11:11/11to11/12:11/12to12/12:12/12to13/12:13/12to14/12:14/12to15/12:,22,True,True
1550,496,582,86,0/15to1/15,2/11to3/11,0/15to1/15:1/15to1/14:1/14to1/13:1/13to1/12:1/12to1/11:1/11to2/11:2/11to3/11:,7,True,True
2344,497,731,234,14/8to14/7,3/11to3/12,14/8to14/7:14/7to13/7:13/7to12/7:12/7to12/8:12/8to11/8:11/8to10/8:10/8to9/8:9/8to8/8:8/8to7/8:7/8to6/8:6/8to5/8:5/8to4/8:4/8to3/8:3/8to3/9:3/9to3/10:3/10to3/11:3/11to3/12:,17,True,True
2932,497,588,91,8/2to8/3,9/8to9/7,8/2to8/3:8/3to8/4:8/4to8/5:8/5to8/6:8/6to8/7:8/7to8/8:8/8to9/8:9/8to9/7:,8,True,True
913,497,710,213,2/9to2/10,15/8to15/9,2/9to2/10:2/10to3/10:3/10to4/10:4/10to5/10:5/10to6/10:6/10to7/10:7/10to8/10:8/10to9/10:9/10to10/10:10/10to10/9:10/9to10/8:10/8to11/8:11/8to12/8:12/8to13/8:13/8to14/8:14/8to15/8:15/8to15/9:,17,False,True
369,497,888,391,right0to15/0,0/15totop0,right0to15/0:15/0to14/0:14/0to13/0:13/0to12/0:12/0to11/0:11/0to10/0:10/0to9/0:9/0to8/0:8/0to7/0:7/0to6/0:6/0to5/0:5/0to4/0:4/0to3/0:3/0to2/0:2/0to1/0:1/0to0/0:0/0to0/1:0/1to0/2:0/2to0/3:0/3to0/4:0/4to0/5:0/5to0/6:0/6to0/7:0/7to0/8:0/8to0/9:0/9to0/10:0/10to0/11:0/11to0/12:0/12to0/13:0/13to0/14:0/14to0/15:0/15totop0:,32,False,True
3391,497,768,271,2/14to3/14,13/6to14/6,2/14to3/14:3/14to4/14:4/14to5/14:5/14to6/14:6/14to7/14:7/14to8/14:8/14to9/14:9/14to10/14:10/14to10/13:10/13to10/12:10/12to10/11:10/11to10/10:10/10to10/9:10/9to10/8:10/8to10/7:10/7to10/6:10/6to11/6:11/6to12/6:12/6to13/6:13/6to14/6:,20,False,True
3096,497,664,167,8/0to8/1,5/9to4/9,8/0to8/1:8/1to7/1:7/1to6/1:6/1to5/1:5/1to5/2:5/2to5/3:5/3to5/4:5/4to5/5:5/5to5/6:5/6to5/7:5/7to5/8:5/8to5/9:5/9to4/9:,13,False,True
2325,497,546,49,5/1to4/1,2/1to1/1,5/1to4/1:4/1to3/1:3/1to2/1:2/1to1/1:,4,True,True
1738,498,572,74,4/6to4/7,5/10to5/11,4/6to4/7:4/7to4/8:4/8to4/9:4/9to4/10:4/10to5/10:5/10to5/11:,6,True,True
597,498,707,209,12/3to11/3,7/14to7/15,12/3to11/3:11/3to10/3:10/3to9/3:9/3to8/3:8/3to7/3:7/3to7/4:7/4to7/5:7/5to7/6:7/6to7/7:7/7to7/8:7/8to7/9:7/9to7/10:7/10to7/11:7/11to7/12:7/12to7/13:7/13to7/14:7/14to7/15:,17,False,True
1746,498,715,217,2/3to2/4,14/4to14/3,2/3to2/4:2/4to3/4:3/4to4/4:4/4to5/4:5/4to6/4:6/4to7/4:7/4to8/4:8/4to9/4:9/4to10/4:10/4to11/4:11/4to12/4:12/4to13/4:13/4to14/4:14/4to14/3:,14,False,True
233,499,900,401,right15to15/15,0/0tobottom0,right15to15/15:15/15to14/15:14/15to13/15:13/15to12/15:12/15to11/15:11/15to10/15:10/15to9/15:9/15to8/15:8/15to7/15:7/15to6/15:6/15to5/15:5/15to4/15:4/15to3/15:3/15to2/15:2/15to1/15:1/15to0/15:0/15to0/14:0/14to0/13:0/13to0/12:0/12to0/11:0/11to0/10:0/10to0/9:0/9to0/8:0/8to0/7:0/7to0/6:0/6to0/5:0/5to0/4:0/4to0/3:0/3to0/2:0/2to0/1:0/1to0/0:0/0tobottom0:,32,False,True
2785,499,918,419,13/11to13/10,1/0tobottom1,13/11to13/10:13/10to12/10:12/10to11/10:11/10to10/10:10/10to9/10:9/10to8/10:8/10to7/10:7/10to6/10:6/10to5/10:5/10to4/10:4/10to3/10:3/10to2/10:2/10to1/10:1/10to1/9:1/9to1/8:1/8to1/7:1/7to1/6:1/6to1/5:1/5to1/4:1/4to1/3:1/3to1/2:1/2to1/1:1/1to1/0:1/0tobottom1:,24,False,True
930,499,771,272,0/14to0/15,10/9to10/8,0/14to0/15:0/15to0/14:0/14to0/13:0/13to0/12:0/12to0/11:0/11to0/10:0/10to0/9:0/9to1/9:1/9to2/9:2/9to3/9:3/9to4/9:4/9to5/9:5/9to6/9:6/9to7/9:7/9to8/9:8/9to9/9:9/9to10/9:10/9to10/8:,18,True,True
2452,499,564,65,15/1to14/1,11/1to10/1,15/1to14/1:14/1to13/1:13/1to12/1:12/1to11/1:11/1to10/1:,5,True,True
1123,499,568,69,13/9to14/9,14/5to14/4,13/9to14/9:14/9to14/8:14/8to14/7:14/7to14/6:14/6to14/5:14/5to14/4:,6,True,True
3221,499,842,343,right11to15/11,4/3to4/2,right11to15/11:15/11to14/11:14/11to13/11:13/11to12/11:12/11to11/11:11/11to10/11:10/11to9/11:9/11to8/11:8/11to7/11:7/11to6/11:6/11to5/11:5/11to4/11:4/11to4/10:4/10to4/9:4/9to4/8:4/8to4/7:4/7to4/6:4/6to4/5:4/5to4/4:4/4to4/3:4/3to4/2:,21,False,True
2816,500,643,143,7/2to6/2,2/8to3/8,7/2to6/2:6/2to5/2:5/2to4/2:4/2to3/2:3/2to2/2:2/2to2/3:2/3to2/4:2/4to2/5:2/5to2/6:2/6to2/7:2/7to2/8:2/8to3/8:,12,True,True
3064,500,702,202,9/15to9/14,8/2to9/2,9/15to9/14:9/14to8/14:8/14to8/13:8/13to8/12:8/12to8/11:8/11to8/10:8/10to8/9:8/9to8/8:8/8to8/7:8/7to8/6:8/6to8/5:8/5to8/4:8/4to8/3:8/3to8/2:8/2to9/2:,15,True,True
1573,500,776,276,13/15to12/15,1/6to1/5,13/15to12/15:12/15to11/15:11/15to10/15:10/15to9/15:9/15to8/15:8/15to7/15:7/15to6/15:6/15to5/15:5/15to4/15:4/15to3/15:3/15to2/15:2/15to1/15:1/15to1/14:1/14to1/13:1/13to1/12:1/12to1/11:1/11to1/10:1/10to1/9:1/9to1/8:1/8to1/7:1/7to1/6:1/6to1/5:,22,False,True
1517,501,883,382,14/6to14/5,0/14toleft14,14/6to14/5:14/5to13/5:13/5to12/5:12/5to11/5:11/5to10/5:10/5to9/5:9/5to8/5:8/5to7/5:7/5to6/5:6/5to5/5:5/5to4/5:4/5to3/5:3/5to2/5:2/5to1/5:1/5to0/5:0/5to0/6:0/6to0/7:0/7to0/8:0/8to0/9:0/9to0/10:0/10to0/11:0/11to0/12:0/12to0/13:0/13to0/14:0/14toleft14:,25,True,True
950,501,844,343,10/13to10/14,0/1to0/0,10/13to10/14:10/14to9/14:9/14to8/14:8/14to7/14:7/14to6/14:6/14to5/14:5/14to4/14:4/14to3/14:3/14to2/14:2/14to1/14:1/14to0/14:0/14to0/13:0/13to0/12:0/12to0/11:0/11to0/10:0/10to0/9:0/9to0/8:0/8to0/7:0/7to0/6:0/6to0/5:0/5to0/4:0/4to0/3:0/3to0/2:0/2to0/1:0/1to0/0:,25,False,True
2714,501,571,70,5/12to5/13,7/15to7/14,5/12to5/13:5/13to5/14:5/14to5/15:5/15to6/15:6/15to7/15:7/15to7/14:,6,True,True
1174,501,685,184,5/6to5/5,12/0tobottom12,5/6to5/5:5/5to5/4:5/4to5/3:5/3to5/2:5/2to5/1:5/1to5/0:5/0to6/0:6/0to7/0:7/0to8/0:8/0to9/0:9/0to10/0:10/0to11/0:11/0to12/0:12/0tobottom12:,14,True,True
2143,501,657,156,8/12to8/11,3/6to3/5,8/12to8/11:8/11to7/11:7/11to6/11:6/11to5/11:5/11to4/11:4/11to3/11:3/11to3/10:3/10to3/9:3/9to3/8:3/8to3/7:3/7to3/6:3/6to3/5:,12,False,True
1923,501,686,185,1/10to1/9,7/4to8/4,1/10to1/9:1/9to1/8:1/8to1/7:1/7to1/6:1/6to1/5:1/5to1/4:1/4to2/4:2/4to3/4:3/4to4/4:4/4to5/4:5/4to6/4:6/4to7/4:7/4to8/4:,13,False,True
687,502,669,167,13/0to12/0,9/8to9/9,13/0to12/0:12/0to12/1:12/1to12/2:12/2to12/3:12/3to12/4:12/4to12/5:12/5to12/6:12/6to12/7:12/7to12/8:12/8to11/8:11/8to10/8:10/8to9/8:9/8to9/9:,13,True,True
2955,502,762,260,7/14to6/14,0/0tobottom0,7/14to6/14:6/14to5/14:5/14to4/14:4/14to3/14:3/14to2/14:2/14to1/14:1/14to0/14:0/14to0/13:0/13to0/12:0/12to0/11:0/11to0/10:0/10to0/9:0/9to0/8:0/8to0/7:0/7to0/6:0/6to0/5:0/5to0/4:0/4to0/3:0/3to0/2:0/2to0/1:0/1to0/0:0/0tobottom0:,22,True,True
1169,502,706,204,4/7to4/8,13/12to14/12,4/7to4/8:4/8to5/8:5/8to6/8:6/8to7/8:7/8to8/8:8/8to9/8:9/8to10/8:10/8to10/9:10/9to10/10:10/10to10/11:10/11to10/12:10/12to11/12:11/12to12/12:12/12to13/12:13/12to14/12:,15,False,True
2451,502,926,424,13/6to12/6,3/15totop3,13/6to12/6:12/6to11/6:11/6to10/6:10/6to9/6:9/6to8/6:8/6to7/6:7/6to6/6:6/6to5/6:5/6to4/6:4/6to3/6:3/6to3/7:3/7to3/8:3/8to3/9:3/9to3/10:3/10to3/11:3/11to3/12:3/12to3/13:3/13to3/14:3/14to3/15:3/15totop3:,20,True,True
2776,502,625,123,top9to9/15,1/15to1/14,top9to9/15:9/15to8/15:8/15to7/15:7/15to6/15:6/15to5/15:5/15to4/15:4/15to3/15:3/15to2/15:2/15to1/15:1/15to1/14:,10,True,True
2155,502,528,26,1/5to2/5,2/5to3/5,1/5to2/5:2/5to3/5:,2,False,True
570,502,707,205,4/14to4/13,15/11to15/12,4/14to4/13:4/13to5/13:5/13to6/13:6/13to7/13:7/13to8/13:8/13to9/13:9/13to10/13:10/13to10/12:10/12to10/11:10/11to11/11:11/11to12/11:12/11to13/11:13/11to14/11:14/11to15/11:15/11to15/12:,15,False,True
2918,503,839,336,15/14to15/13,4/2to3/2,15/14to15/13:15/13to14/13:14/13to13/13:13/13to12/13:12/13to12/12:12/12to11/12:11/12to10/12:10/12to9/12:9/12to8/12:8/12to7/12:7/12to6/12:6/12to5/12:5/12to4/12:4/12to4/11:4/11to4/10:4/10to4/9:4/9to4/8:4/8to4/7:4/7to4/6:4/6to4/5:4/5to4/4:4/4to4/3:4/3to4/2:4/2to3/2:,24,True,True
1622,503,553,50,10/0to10/1,10/3to9/3,10/0to10/1:10/1to10/2:10/2to10/3:10/3to9/3:,4,False,True
1891,504,746,242,3/1to2/1,7/14to8/14,3/1to2/1:2/1to2/2:2/2to2/3:2/3to2/4:2/4to2/5:2/5to2/6:2/6to2/7:2/7to2/8:2/8to2/9:2/9to2/10:2/10to2/11:2/11to2/12:2/12to2/13:2/13to2/14:2/14to3/14:3/14to4/14:4/14to5/14:5/14to6/14:6/14to7/14:7/14to8/14:,20,True,True
3304,504,713,209,11/9to11/10,6/8to5/8,11/9to11/10:11/10to10/10:10/10to9/10:9/10to8/10:8/10to7/10:7/10to6/10:6/10to6/9:6/9to6/8:6/8to5/8:,9,True,True
2131,504,790,286,10/13to10/14,2/1to2/0,10/13to10/14:10/14to9/14:9/14to8/14:8/14to7/14:7/14to6/14:6/14to5/14:5/14to4/14:4/14to3/14:3/14to2/14:2/14to2/13:2/13to2/12:2/12to2/11:2/11to2/10:2/10to2/9:2/9to2/8:2/8to2/7:2/7to2/6:2/6to2/5:2/5to2/4:2/4to2/3:2/3to2/2:2/2to2/1:2/1to2/0:,23,True,True
811,505,575,70,13/1to12/1,10/3to9/3,13/1to12/1:12/1to12/2:12/2to11/2:11/2to10/2:10/2to10/3:10/3to9/3:,6,True,True
2256,505,700,195,7/0to8/0,8/14to7/14,7/0to8/0:8/0to8/1:8/1to8/2:8/2to8/3:8/3to8/4:8/4to8/5:8/5to8/6:8/6to8/7:8/7to8/8:8/8to8/9:8/9to8/10:8/10to8/11:8/11to8/12:8/12to8/13:8/13to8/14:8/14to7/14:,16,True,True
1424,505,746,241,2/7to2/6,11/13to11/14,2/7to2/6:2/6to2/7:2/7to2/8:2/8to2/9:2/9to2/10:2/10to2/11:2/11to2/12:2/12to2/13:2/13to3/13:3/13to4/13:4/13to5/13:5/13to6/13:6/13to7/13:7/13to8/13:8/13to9/13:9/13to10/13:10/13to11/13:11/13to11/14:,18,True,True
1570,505,798,293,left10to0/10,13/1to14/1,left10to0/10:0/10to0/9:0/9to0/8:0/8to0/7:0/7to0/6:0/6to0/5:0/5to0/4:0/4to0/3:0/3to1/3:1/3to2/3:2/3to3/3:3/3to4/3:4/3to5/3:5/3to6/3:6/3to7/3:7/3to8/3:8/3to9/3:9/3to10/3:10/3to10/2:10/2to11/2:11/2to12/2:12/2to12/1:12/1to13/1:13/1to14/1:,24,True,True
1348,505,654,149,4/15to4/14,9/11to10/11,4/15to4/14:4/14to4/13:4/13to4/12:4/12to4/11:4/11to5/11:5/11to6/11:6/11to7/11:7/11to8/11:8/11to9/11:9/11to10/11:,10,True,True
3272,505,619,114,4/15to3/15,1/10to1/9,4/15to3/15:3/15to2/15:2/15to1/15:1/15to1/14:1/14to1/13:1/13to1/12:1/12to1/11:1/11to1/10:1/10to1/9:,9,False,True
1656,505,579,74,3/10to2/10,1/13to1/14,3/10to2/10:2/10to1/10:1/10to1/11:1/11to1/12:1/12to1/13:1/13to1/14:,6,False,True
1838,506,650,144,left3to0/3,5/3to5/4,left3to0/3:0/3to1/3:1/3to2/3:2/3to3/3:3/3to4/3:4/3to5/3:5/3to5/4:,7,False,True
1644,506,643,137,4/7to5/7,11/6to11/7,4/7to5/7:5/7to5/6:5/6to6/6:6/6to7/6:7/6to8/6:8/6to9/6:9/6to10/6:10/6to11/6:11/6to11/7:,9,True,True
464,506,628,122,0/10to1/10,5/14to6/14,0/10to1/10:1/10to1/11:1/11to1/12:1/12to1/13:1/13to1/14:1/14to2/14:2/14to3/14:3/14to4/14:4/14to5/14:5/14to6/14:,10,False,True
1510,506,761,255,5/1to5/2,10/7to10/8,5/1to5/2:5/2to6/2:6/2to7/2:7/2to8/2:8/2to9/2:9/2to10/2:10/2to10/3:10/3to10/4:10/4to10/5:10/5to10/6:10/6to10/7:10/7to10/8:,12,False,True
2172,506,669,163,6/0to6/1,4/11to5/11,6/0to6/1:6/1to5/1:5/1to4/1:4/1to4/2:4/2to4/3:4/3to4/4:4/4to4/5:4/5to4/6:4/6to4/7:4/7to4/8:4/8to4/9:4/9to4/10:4/10to4/11:4/11to5/11:,14,False,True
1791,506,556,50,12/14to13/14,14/13to15/13,12/14to13/14:13/14to13/13:13/13to14/13:14/13to15/13:,4,True,True
1712,507,733,226,15/9to14/9,2/7to1/7,15/9to14/9:14/9to13/9:13/9to12/9:12/9to11/9:11/9to11/8:11/8to10/8:10/8to9/8:9/8to8/8:8/8to7/8:7/8to6/8:6/8to5/8:5/8to4/8:4/8to3/8:3/8to2/8:2/8to2/7:2/7to1/7:,16,True,True
2093,507,892,385,right6to15/6,2/2to1/2,right6to15/6:15/6to14/6:14/6to13/6:13/6to12/6:12/6to11/6:11/6to10/6:10/6to9/6:9/6to8/6:8/6to7/6:7/6to6/6:6/6to5/6:5/6to4/6:4/6to3/6:3/6to2/6:2/6to2/5:2/5to2/4:2/4to2/3:2/3to2/2:2/2to1/2:,19,False,True
1251,507,612,105,7/0to7/1,3/3to3/4,7/0to7/1:7/1to6/1:6/1to5/1:5/1to4/1:4/1to3/1:3/1to3/2:3/2to3/3:3/3to3/4:,8,True,True
2069,508,640,132,3/15to4/15,5/7to6/7,3/15to4/15:4/15to4/14:4/14to4/13:4/13to4/12:4/12to4/11:4/11to4/10:4/10to4/9:4/9to4/8:4/8to4/7:4/7to5/7:5/7to6/7:,11,False,True
394,509,894,385,right0to15/0,0/15totop0,right0to15/0:15/0to14/0:14/0to13/0:13/0to12/0:12/0to11/0:11/0to11/1:11/1to10/1:10/1to9/1:9/1to8/1:8/1to7/1:7/1to6/1:6/1to5/1:5/1to4/1:4/1to3/1:3/1to2/1:2/1to1/1:1/1to0/1:0/1to0/2:0/2to0/3:0/3to0/4:0/4to0/5:0/5to0/6:0/6to0/7:0/7to0/8:0/8to0/9:0/9to0/10:0/10to0/11:0/11to0/12:0/12to0/13:0/13to0/14:0/14to0/15:0/15totop0:,32,True,True
109,509,920,411,left0to0/0,15/15totop15,left0to0/0:0/0to0/1:0/1to0/2:0/2to0/3:0/3to0/4:0/4to0/5:0/5to0/6:0/6to0/7:0/7to0/8:0/8to0/9:0/9to0/10:0/10to0/11:0/11to0/12:0/12to0/13:0/13to1/13:1/13to2/13:2/13to3/13:3/13to4/13:4/13to5/13:5/13to6/13:6/13to7/13:7/13to8/13:8/13to9/13:9/13to10/13:10/13to10/14:10/14to11/14:11/14to11/15:11/15to12/15:12/15to13/15:13/15to14/15:14/15to15/15:15/15totop15:,32,True,True
2225,509,670,161,6/5to6/4,4/14to5/14,6/5to6/4:6/4to5/4:5/4to4/4:4/4to4/5:4/5to4/6:4/6to4/7:4/7to4/8:4/8to4/9:4/9to4/10:4/10to4/11:4/11to4/12:4/12to4/13:4/13to4/14:4/14to5/14:,14,True,True
1417,510,691,181,8/1to7/1,7/14to6/14,8/1to7/1:7/1to7/2:7/2to7/3:7/3to7/4:7/4to7/5:7/5to7/6:7/6to7/7:7/7to7/8:7/8to7/9:7/9to7/10:7/10to7/11:7/11to7/12:7/12to7/13:7/13to7/14:7/14to6/14:,15,False,True
1362,510,594,84,9/5to9/4,8/0to7/0,9/5to9/4:9/4to8/4:8/4to8/3:8/3to8/2:8/2to8/1:8/1to8/0:8/0to7/0:,7,False,True
2656,510,577,67,3/7to3/6,4/4to5/4,3/7to3/6:3/6to3/5:3/5to3/4:3/4to4/4:4/4to5/4:,5,True,True
2716,510,605,95,7/0to7/1,9/5to9/6,7/0to7/1:7/1to7/2:7/2to7/3:7/3to7/4:7/4to7/5:7/5to8/5:8/5to9/5:9/5to9/6:,8,True,True
1056,511,675,164,3/14to3/13,6/5to6/6,3/14to3/13:3/13to3/12:3/12to3/11:3/11to3/10:3/10to3/9:3/9to3/8:3/8to3/7:3/7to3/6:3/6to3/5:3/5to4/5:4/5to5/5:5/5to6/5:6/5to6/6:,13,False,True
2079,511,652,141,3/8to2/8,5/15to6/15,3/8to2/8:2/8to2/9:2/9to2/10:2/10to2/11:2/11to2/12:2/12to2/13:2/13to2/14:2/14to2/15:2/15to3/15:3/15to4/15:4/15to5/15:5/15to6/15:,12,True,True
2822,511,684,173,7/14to7/13,6/1to5/1,7/14to7/13:7/13to6/13:6/13to6/12:6/12to6/11:6/11to6/10:6/10to6/9:6/9to6/8:6/8to6/7:6/7to6/6:6/6to6/5:6/5to6/4:6/4to6/3:6/3to6/2:6/2to6/1:6/1to5/1:,15,False,True
258,512,903,391,right15to15/15,0/0tobottom0,right15to15/15:15/15to14/15:14/15to13/15:13/15to12/15:12/15to11/15:11/15to11/14:11/14to10/14:10/14to9/14:9/14to8/14:8/14to7/14:7/14to6/14:6/14to5/14:5/14to4/14:4/14to3/14:3/14to2/14:2/14to1/14:1/14to0/14:0/14to0/13:0/13to0/12:0/12to0/11:0/11to0/10:0/10to0/9:0/9to0/8:0/8to0/7:0/7to0/6:0/6to0/5:0/5to0/4:0/4to0/3:0/3to0/2:0/2to0/1:0/1to0/0:0/0tobottom0:,32,True,True
2778,512,914,402,1/8to1/7,15/13to15/14,1/8to1/7:1/7to1/8:1/8to1/9:1/9to1/10:1/10to1/11:1/11to2/11:2/11to3/11:3/11to4/11:4/11to5/11:5/11to6/11:6/11to7/11:7/11to8/11:8/11to9/11:9/11to10/11:10/11to10/12:10/12to11/12:11/12to12/12:12/12to12/13:12/13to13/13:13/13to14/13:14/13to15/13:15/13to15/14:,22,True,True
2025,512,804,292,0/15to1/15,13/7to14/7,0/15to1/15:1/15to2/15:2/15to3/15:3/15to4/15:4/15to5/15:5/15to6/15:6/15to7/15:7/15to8/15:8/15to9/15:9/15to10/15:10/15to10/14:10/14to10/13:10/13to10/12:10/12to10/11:10/11to10/10:10/10to10/9:10/9to10/8:10/8to10/7:10/7to11/7:11/7to12/7:12/7to13/7:13/7to14/7:,22,False,True
1463,513,860,347,13/14to13/15,1/1to0/1,13/14to13/15:13/15to12/15:12/15to11/15:11/15to10/15:10/15to9/15:9/15to8/15:8/15to7/15:7/15to6/15:6/15to5/15:5/15to4/15:4/15to3/15:3/15to2/15:2/15to1/15:1/15to1/14:1/14to1/13:1/13to1/12:1/12to1/11:1/11to1/10:1/10to1/9:1/9to1/8:1/8to1/7:1/7to1/6:1/6to1/5:1/5to1/4:1/4to1/3:1/3to1/2:1/2to1/1:1/1to0/1:,28,False,True
1064,513,758,245,right15to15/15,0/14to0/13,right15to15/15:15/15to14/15:14/15to13/15:13/15to12/15:12/15to11/15:11/15to11/14:11/14to10/14:10/14to9/14:9/14to8/14:8/14to7/14:7/14to6/14:6/14to5/14:5/14to4/14:4/14to3/14:3/14to2/14:2/14to1/14:1/14to0/14:0/14to0/13:,18,True,True
1553,513,629,116,2/13to1/13,0/12toleft12,2/13to1/13:1/13to0/13:0/13to0/12:0/12toleft12:,4,False,True
1211,514,600,86,8/13to8/12,5/10to5/9,8/13to8/12:8/12to7/12:7/12to6/12:6/12to5/12:5/12to5/11:5/11to5/10:5/10to5/9:,7,True,True
1821,514,565,51,6/8to6/9,8/9to8/8,6/8to6/9:6/9to7/9:7/9to8/9:8/9to8/8:,4,True,True
1356,514,647,133,4/9to4/8,1/14to1/15,4/9to4/8:4/8to3/8:3/8to2/8:2/8to1/8:1/8to1/9:1/9to1/10:1/10to1/11:1/11to1/12:1/12to1/13:1/13to1/14:1/14to1/15:,11,True,True
386,515,908,393,right0to15/0,0/15totop0,right0to15/0:15/0to14/0:14/0to13/0:13/0to12/0:12/0to11/0:11/0to11/1:11/1to10/1:10/1to9/1:9/1to8/1:8/1to7/1:7/1to6/1:6/1to5/1:5/1to4/1:4/1to3/1:3/1to2/1:2/1to1/1:1/1to0/1:0/1to0/2:0/2to0/3:0/3to0/4:0/4to0/5:0/5to0/6:0/6to0/7:0/7to0/8:0/8to0/9:0/9to0/10:0/10to0/11:0/11to0/12:0/12to0/13:0/13to0/14:0/14to0/15:0/15totop0:,32,True,True
2416,515,647,132,10/14to10/13,13/9to14/9,10/14to10/13:10/13to11/13:11/13to11/12:11/12to11/11:11/11to11/10:11/10to11/9:11/9to12/9:12/9to13/9:13/9to14/9:,9,True,True
2836,515,708,193,11/14to10/14,7/8to6/8,11/14to10/14:10/14to9/14:9/14to8/14:8/14to7/14:7/14to7/13:7/13to7/12:7/12to7/11:7/11to7/10:7/10to7/9:7/9to7/8:7/8to6/8:,11,True,True
431,516,632,116,2/10to3/10,3/2to4/2,2/10to3/10:3/10to3/9:3/9to3/8:3/8to3/7:3/7to3/6:3/6to3/5:3/5to3/4:3/4to3/3:3/3to3/2:3/2to4/2:,10,True,True
1627,517,691,174,9/7to10/7,10/1to11/1,9/7to10/7:10/7to11/7:11/7to11/6:11/6to11/5:11/5to11/4:11/4to11/3:11/3to11/2:11/2to10/2:10/2to10/1:10/1to11/1:,10,True,True
1956,517,822,305,15/12to15/11,8/1to7/1,15/12to15/11:15/11to14/11:14/11to13/11:13/11to12/11:12/11to11/11:11/11to10/11:10/11to9/11:9/11to8/11:8/11to8/10:8/10to8/9:8/9to8/8:8/8to8/7:8/7to8/6:8/6to8/5:8/5to8/4:8/4to8/3:8/3to8/2:8/2to8/1:8/1to7/1:,19,False,True
120,517,930,413,left0to0/0,15/15totop15,left0to0/0:0/0to1/0:1/0to2/0:2/0to3/0:3/0to4/0:4/0to5/0:5/0to6/0:6/0to7/0:7/0to8/0:8/0to9/0:9/0to10/0:10/0to10/1:10/1to10/2:10/2to10/3:10/3to10/4:10/4to10/5:10/5to10/6:10/6to10/7:10/7to10/8:10/8to10/9:10/9to10/10:10/10to10/11:10/11to10/12:10/12to10/13:10/13to10/14:10/14to10/15:10/15to11/15:11/15to12/15:12/15to13/15:13/15to14/15:14/15to15/15:15/15totop15:,32,False,True
3145,517,672,155,7/12to6/12,2/7to2/6,7/12to6/12:6/12to5/12:5/12to4/12:4/12to3/12:3/12to2/12:2/12to2/11:2/11to2/10:2/10to2/9:2/9to2/8:2/8to2/7:2/7to2/6:,11,True,True
321,518,920,402,right0to15/0,0/15totop0,right0to15/0:15/0to14/0:14/0to13/0:13/0to12/0:12/0to11/0:11/0to10/0:10/0to9/0:9/0to8/0:8/0to7/0:7/0to6/0:6/0to5/0:5/0to4/0:4/0to3/0:3/0to2/0:2/0to1/0:1/0to0/0:0/0to0/1:0/1to0/2:0/2to0/3:0/3to0/4:0/4to0/5:0/5to0/6:0/6to0/7:0/7to0/8:0/8to0/9:0/9to0/10:0/10to0/11:0/11to0/12:0/12to0/13:0/13to0/14:0/14to0/15:0/15totop0:,32,False,True
1238,518,563,45,10/13to10/14,9/15totop9,10/13to10/14:10/14to10/15:10/15to9/15:9/15totop9:,4,False,True
795,518,776,258,top3to3/15,10/6to11/6,top3to3/15:3/15to3/14:3/14to3/13:3/13to3/12:3/12to3/11:3/11to3/10:3/10to3/9:3/9to3/8:3/8to3/7:3/7to3/6:3/6to4/6:4/6to5/6:5/6to6/6:6/6to7/6:7/6to8/6:8/6to9/6:9/6to10/6:10/6to11/6:,18,True,True
1641,518,673,155,9/10to10/10,13/4to14/4,9/10to10/10:10/10to10/9:10/9to10/8:10/8to10/7:10/7to10/6:10/6to10/5:10/5to10/4:10/4to11/4:11/4to12/4:12/4to13/4:13/4to14/4:,11,False,True
2737,518,680,162,11/7to11/6,10/0to9/0,11/7to11/6:11/6to10/6:10/6to10/5:10/5to10/4:10/4to10/3:10/3to10/2:10/2to10/1:10/1to10/0:10/0to9/0:,9,False,True
2865,519,789,270,top4to4/15,15/7toright7,top4to4/15:4/15to4/14:4/14to4/13:4/13to4/12:4/12to4/11:4/11to4/10:4/10to4/9:4/9to5/9:5/9to6/9:6/9to7/9:7/9to8/9:8/9to9/9:9/9to10/9:10/9to10/8:10/8to11/8:11/8to12/8:12/8to12/7:12/7to13/7:13/7to14/7:14/7to15/7:15/7toright7:,21,True,True
2150,519,668,149,15/10to14/10,5/9to6/9,15/10to14/10:14/10to13/10:13/10to12/10:12/10to12/9:12/9to11/9:11/9to10/9:10/9to9/9:9/9to8/9:8/9to7/9:7/9to6/9:6/9to5/9:5/9to6/9:,12,True,True
1096,519,623,104,8/8to8/9,9/15to10/15,8/8to8/9:8/9to8/10:8/10to8/11:8/11to8/12:8/12to8/13:8/13to8/14:8/14to8/15:8/15to9/15:9/15to10/15:,9,True,True
1603,519,612,93,11/2to10/2,10/8to10/9,11/2to10/2:10/2to10/3:10/3to10/4:10/4to10/5:10/5to10/6:10/6to10/7:10/7to10/8:10/8to10/9:,8,False,True
1999,519,705,186,3/12to3/11,8/4to8/3,3/12to3/11:3/11to3/10:3/10to3/9:3/9to3/8:3/8to3/7:3/7to3/6:3/6to3/5:3/5to3/4:3/4to4/4:4/4to5/4:5/4to6/4:6/4to7/4:7/4to8/4:8/4to8/3:,14,True,True
1901,519,743,224,11/2to11/1,4/10to4/11,11/2to11/1:11/1to10/1:10/1to9/1:9/1to8/1:8/1to7/1:7/1to6/1:6/1to5/1:5/1to4/1:4/1to4/2:4/2to4/3:4/3to4/4:4/4to4/5:4/5to4/6:4/6to4/7:4/7to4/8:4/8to4/9:4/9to4/10:4/10to4/11:,18,False,True
1832,520,719,199,9/2to9/1,10/15totop10,9/2to9/1:9/1to10/1:10/1to10/2:10/2to10/3:10/3to10/4:10/4to10/5:10/5to10/6:10/6to10/7:10/7to10/8:10/8to10/9:10/9to10/10:10/10to10/11:10/11to10/12:10/12to10/13:10/13to10/14:10/14to10/15:10/15totop10:,17,False,True
1428,520,687,167,3/15to3/14,9/11to9/10,3/15to3/14:3/14to3/13:3/13to3/12:3/12to3/11:3/11to4/11:4/11to5/11:5/11to6/11:6/11to7/11:7/11to8/11:8/11to9/11:9/11to9/10:,11,True,True
2750,520,841,321,0/3to0/2,12/6to13/6,0/3to0/2:0/2to1/2:1/2to2/2:2/2to3/2:3/2to4/2:4/2to5/2:5/2to6/2:6/2to7/2:7/2to8/2:8/2to9/2:9/2to10/2:10/2to10/3:10/3to10/4:10/4to10/5:10/5to10/6:10/6to11/6:11/6to12/6:12/6to13/6:,18,False,True
1859,520,937,417,12/7to12/6,0/0tobottom0,12/7to12/6:12/6to11/6:11/6to10/6:10/6to9/6:9/6to8/6:8/6to7/6:7/6to6/6:6/6to5/6:5/6to4/6:4/6to3/6:3/6to2/6:2/6to1/6:1/6to0/6:0/6to0/5:0/5to0/4:0/4to0/3:0/3to0/2:0/2to0/1:0/1to0/0:0/0tobottom0:,20,False,True
2645,520,662,142,5/4to5/5,8/12to9/12,5/4to5/5:5/5to5/6:5/6to5/7:5/7to5/8:5/8to5/9:5/9to5/10:5/10to5/11:5/11to5/12:5/12to6/12:6/12to7/12:7/12to8/12:8/12to9/12:,12,True,True
1884,520,695,175,3/6to4/6,8/14to9/14,3/6to4/6:4/6to4/7:4/7to4/8:4/8to4/9:4/9to4/10:4/10to4/11:4/11to4/12:4/12to4/13:4/13to4/14:4/14to5/14:5/14to6/14:6/14to7/14:7/14to8/14:8/14to9/14:,14,True,True
2752,520,823,303,0/2to1/2,11/13to12/13,0/2to1/2:1/2to1/3:1/3to1/4:1/4to1/5:1/5to1/6:1/6to1/7:1/7to1/8:1/8to1/9:1/9to1/10:1/10to1/11:1/11to1/12:1/12to1/13:1/13to2/13:2/13to3/13:3/13to4/13:4/13to5/13:5/13to6/13:6/13to7/13:7/13to8/13:8/13to9/13:9/13to10/13:10/13to11/13:11/13to12/13:,23,True,True
2321,520,745,225,top0to0/15,4/2to4/1,top0to0/15:0/15to0/14:0/14to0/13:0/13to0/12:0/12to0/11:0/11to0/10:0/10to0/9:0/9to0/8:0/8to0/7:0/7to0/6:0/6to0/5:0/5to0/4:0/4to0/3:0/3to0/2:0/2to1/2:1/2to2/2:2/2to3/2:3/2to4/2:4/2to4/1:,19,True,True
979,520,621,101,4/8to4/9,2/13to2/14,4/8to4/9:4/9to3/9:3/9to2/9:2/9to2/10:2/10to2/11:2/11to2/12:2/12to2/13:2/13to2/14:,8,True,True
1041,521,743,222,2/13to2/12,8/2to8/1,2/13to2/12:2/12to2/11:2/11to2/10:2/10to2/9:2/9to2/8:2/8to2/7:2/7to2/6:2/6to2/5:2/5to2/4:2/4to2/3:2/3to2/2:2/2to3/2:3/2to4/2:4/2to5/2:5/2to6/2:6/2to7/2:7/2to8/2:8/2to8/1:,18,True,True
587,522,594,72,9/4to8/4,7/7to7/8,9/4to8/4:8/4to7/4:7/4to7/5:7/5to7/6:7/6to7/7:7/7to7/8:,6,True,True
2106,522,807,285,15/13to14/13,5/1to6/1,15/13to14/13:14/13to13/13:13/13to12/13:12/13to11/13:11/13to10/13:10/13to9/13:9/13to8/13:8/13to7/13:7/13to6/13:6/13to5/13:5/13to5/12:5/12to5/11:5/11to5/10:5/10to5/9:5/9to5/8:5/8to5/7:5/7to5/6:5/6to5/5:5/5to5/4:5/4to5/3:5/3to5/2:5/2to5/1:5/1to6/1:,23,True,True
1846,522,718,196,6/2to7/2,15/7toright7,6/2to7/2:7/2to7/3:7/3to7/4:7/4to7/5:7/5to7/6:7/6to7/7:7/7to8/7:8/7to9/7:9/7to10/7:10/7to11/7:11/7to12/7:12/7to13/7:13/7to14/7:14/7to15/7:15/7toright7:,15,True,True
1293,522,810,288,right15to15/15,7/0tobottom7,right15to15/15:15/15to14/15:14/15to13/15:13/15to12/15:12/15to11/15:11/15to10/15:10/15to9/15:9/15to8/15:8/15to7/15:7/15to7/14:7/14to7/13:7/13to7/12:7/12to7/11:7/11to7/10:7/10to7/9:7/9to7/8:7/8to7/7:7/7to7/6:7/6to7/5:7/5to7/4:7/4to7/3:7/3to7/2:7/2to7/1:7/1to7/0:7/0tobottom7:,25,False,True
1175,522,680,158,11/6to10/6,2/5to2/4,11/6to10/6:10/6to10/5:10/5to9/5:9/5to8/5:8/5to7/5:7/5to6/5:6/5to5/5:5/5to4/5:4/5to3/5:3/5to2/5:2/5to2/4:,11,True,True
1655,522,645,123,10/12to10/11,14/7to15/7,10/12to10/11:10/11to10/10:10/10to11/10:11/10to11/9:11/9to11/8:11/8to11/7:11/7to12/7:12/7to13/7:13/7to14/7:14/7to15/7:,10,True,True
3358,522,580,58,5/6to5/7,5/10to5/11,5/6to5/7:5/7to5/8:5/8to5/9:5/9to5/10:5/10to5/11:,5,False,True
754,523,691,168,13/10to13/9,10/0to9/0,13/10to13/9:13/9to12/9:12/9to11/9:11/9to10/9:10/9to10/8:10/8to10/7:10/7to10/6:10/6to10/5:10/5to10/4:10/4to10/3:10/3to10/2:10/2to10/1:10/1to10/0:10/0to9/0:,14,False,True
1288,523,681,158,1/10to1/9,6/3to7/3,1/10to1/9:1/9to1/8:1/8to1/7:1/7to1/6:1/6to1/5:1/5to1/4:1/4to1/3:1/3to2/3:2/3to3/3:3/3to4/3:4/3to5/3:5/3to6/3:6/3to7/3:,13,True,True
511,523,890,367,right6to15/6,8/14to9/14,right6to15/6:15/6to14/6:14/6to13/6:13/6to12/6:12/6to11/6:11/6to10/6:10/6to9/6:9/6to8/6:8/6to8/7:8/7to8/8:8/8to8/9:8/9to8/10:8/10to8/11:8/11to8/12:8/12to8/13:8/13to8/14:8/14to9/14:,17,True,True
2129,523,772,249,bottom0to0/0,9/8to9/7,bottom0to0/0:0/0to0/1:0/1to0/2:0/2to0/3:0/3to0/4:0/4to0/5:0/5to0/6:0/6to0/7:0/7to0/8:0/8to1/8:1/8to2/8:2/8to3/8:3/8to4/8:4/8to5/8:5/8to6/8:6/8to7/8:7/8to8/8:8/8to9/8:9/8to9/7:,19,True,True
1447,523,582,59,8/5to8/6,9/8to10/8,8/5to8/6:8/6to8/7:8/7to8/8:8/8to9/8:9/8to10/8:,5,False,True
1560,524,647,123,9/1to10/1,15/4to15/5,9/1to10/1:10/1to10/2:10/2to10/3:10/3to10/4:10/4to11/4:11/4to12/4:12/4to13/4:13/4to14/4:14/4to15/4:15/4to15/5:,10,False,True
2741,524,791,267,top2to2/15,14/9to14/8,top2to2/15:2/15to2/14:2/14to2/13:2/13to2/12:2/12to2/11:2/11to2/10:2/10to2/9:2/9to3/9:3/9to4/9:4/9to5/9:5/9to6/9:6/9to7/9:7/9to8/9:8/9to9/9:9/9to10/9:10/9to11/9:11/9to12/9:12/9to13/9:13/9to14/9:14/9to14/8:,20,True,True
3260,524,735,211,11/7to11/8,6/1to6/0,11/7to11/8:11/8to10/8:10/8to9/8:9/8to8/8:8/8to7/8:7/8to6/8:6/8to6/7:6/7to6/6:6/6to6/5:6/5to6/4:6/4to6/3:6/3to6/2:6/2to6/1:6/1to6/0:,14,True,True
3102,524,595,71,11/8to10/8,10/7to9/7,11/8to10/8:10/8to10/7:10/7to9/7:,3,True,True
3006,525,753,228,top2to2/15,12/10to13/10,top2to2/15:2/15to3/15:3/15to4/15:4/15to5/15:5/15to6/15:6/15to7/15:7/15to8/15:8/15to9/15:9/15to10/15:10/15to10/14:10/14to10/13:10/13to10/12:10/12to10/11:10/11to10/10:10/10to11/10:11/10to12/10:12/10to13/10:,17,False,True
1810,525,869,344,3/1to3/0,12/11to13/11,3/1to3/0:3/0to3/1:3/1to3/2:3/2to3/3:3/3to3/4:3/4to3/5:3/5to3/6:3/6to3/7:3/7to3/8:3/8to3/9:3/9to3/10:3/10to3/11:3/11to4/11:4/11to5/11:5/11to6/11:6/11to7/11:7/11to8/11:8/11to9/11:9/11to10/11:10/11to11/11:11/11to12/11:12/11to13/11:,22,True,True
622,526,755,229,13/3to13/4,3/6to4/6,13/3to13/4:13/4to12/4:12/4to12/5:12/5to11/5:11/5to10/5:10/5to9/5:9/5to8/5:8/5to7/5:7/5to6/5:6/5to5/5:5/5to4/5:4/5to3/5:3/5to3/6:3/6to4/6:,14,True,True
2375,526,637,111,7/1to6/1,3/5to4/5,7/1to6/1:6/1to5/1:5/1to4/1:4/1to3/1:3/1to3/2:3/2to3/3:3/3to3/4:3/4to3/5:3/5to4/5:,9,True,True
908,526,659,133,8/6to8/5,13/8to13/9,8/6to8/5:8/5to8/6:8/6to8/7:8/7to8/8:8/8to9/8:9/8to10/8:10/8to11/8:11/8to12/8:12/8to13/8:13/8to13/9:,10,True,True
61,526,906,380,left15to0/15,15/0tobottom15,left15to0/15:0/15to1/15:1/15to2/15:2/15to3/15:3/15to4/15:4/15to5/15:5/15to6/15:6/15to7/15:7/15to8/15:8/15to9/15:9/15to10/15:10/15to10/14:10/14to10/13:10/13to10/12:10/12to10/11:10/11to10/10:10/10to10/9:10/9to10/8:10/8to10/7:10/7to10/6:10/6to10/5:10/5to10/4:10/4to10/3:10/3to10/2:10/2to10/1:10/1to10/0:10/0to11/0:11/0to12/0:12/0to13/0:13/0to14/0:14/0to15/0:15/0tobottom15:,32,False,True
1389,527,689,162,11/14to11/13,12/2to12/3,11/14to11/13:11/13to11/12:11/12to11/11:11/11to11/10:11/10to11/9:11/9to11/8:11/8to11/7:11/7to11/6:11/6to11/5:11/5to11/4:11/4to11/3:11/3to11/2:11/2to12/2:12/2to12/3:,14,False,True
1841,527,598,71,9/4to9/5,7/4to8/4,9/4to9/5:9/5to8/5:8/5to7/5:7/5to7/4:7/4to8/4:,5,False,True
2031,527,588,61,2/3to1/3,1/6to0/6,2/3to1/3:1/3to1/4:1/4to1/5:1/5to1/6:1/6to0/6:,5,False,True
2643,527,598,71,8/3to9/3,12/3to12/4,8/3to9/3:9/3to10/3:10/3to11/3:11/3to12/3:12/3to12/4:,5,True,True
50,527,897,370,left15to0/15,15/0tobottom15,left15to0/15:0/15to0/14:0/14to0/13:0/13to0/12:0/12to0/11:0/11to0/10:0/10to0/9:0/9to0/8:0/8to0/7:0/7to0/6:0/6to0/5:0/5to0/4:0/4to0/3:0/3to0/2:0/2to0/1:0/1to0/0:0/0to1/0:1/0to2/0:2/0to3/0:3/0to4/0:4/0to5/0:5/0to6/0:6/0to7/0:7/0to8/0:8/0to9/0:9/0to10/0:10/0to11/0:11/0to12/0:12/0to13/0:13/0to14/0:14/0to15/0:15/0tobottom15:,32,True,True
1178,528,697,169,7/9to7/10,0/12toleft12,7/9to7/10:7/10to6/10:6/10to5/10:5/10to4/10:4/10to3/10:3/10to2/10:2/10to1/10:1/10to0/10:0/10to0/11:0/11to0/12:0/12toleft12:,11,False,True
999,528,772,244,bottom11to11/0,15/15totop15,bottom11to11/0:11/0to11/1:11/1to11/2:11/2to11/3:11/3to11/4:11/4to11/5:11/5to11/6:11/6to11/7:11/7to11/8:11/8to11/9:11/9to11/10:11/10to11/11:11/11to11/12:11/12to11/13:11/13to11/14:11/14to11/15:11/15to12/15:12/15to13/15:13/15to14/15:14/15to15/15:15/15totop15:,21,True,True
2738,529,802,273,14/7to14/8,3/1to3/0,14/7to14/8:14/8to13/8:13/8to12/8:12/8to11/8:11/8to10/8:10/8to9/8:9/8to8/8:8/8to7/8:7/8to6/8:6/8to5/8:5/8to4/8:4/8to3/8:3/8to3/7:3/7to3/6:3/6to3/5:3/5to3/4:3/4to3/3:3/3to3/2:3/2to3/1:3/1to3/0:,20,False,True
196,529,932,403,left0to0/0,15/15totop15,left0to0/0:0/0to1/0:1/0to2/0:2/0to3/0:3/0to4/0:4/0to5/0:5/0to6/0:6/0to7/0:7/0to8/0:8/0to9/0:9/0to10/0:10/0to10/1:10/1to10/2:10/2to10/3:10/3to10/4:10/4to10/5:10/5to10/6:10/6to10/7:10/7to10/8:10/8to10/9:10/9to10/10:10/10to10/11:10/11to10/12:10/12to10/13:10/13to10/14:10/14to10/15:10/15to11/15:11/15to12/15:12/15to13/15:13/15to14/15:14/15to15/15:15/15totop15:,32,False,True
2574,530,678,148,4/11to5/11,5/0to4/0,4/11to5/11:5/11to5/10:5/10to5/9:5/9to5/8:5/8to5/7:5/7to5/6:5/6to5/5:5/5to5/4:5/4to5/3:5/3to5/2:5/2to5/1:5/1to5/0:5/0to4/0:,13,False,True
680,530,668,138,9/12to10/12,9/3to9/2,9/12to10/12:10/12to10/11:10/11to9/11:9/11to9/10:9/10to9/9:9/9to9/8:9/8to9/7:9/7to9/6:9/6to9/5:9/5to9/4:9/4to9/3:9/3to9/2:,12,True,True
1922,530,601,71,7/1to6/1,3/1to3/0,7/1to6/1:6/1to5/1:5/1to4/1:4/1to3/1:3/1to3/0:,5,True,True
1332,531,602,71,6/7to6/8,6/12to6/13,6/7to6/8:6/8to6/9:6/9to6/10:6/10to6/11:6/11to6/12:6/12to6/13:,6,False,True
869,531,805,274,5/3to6/3,13/15totop13,5/3to6/3:6/3to7/3:7/3to8/3:8/3to9/3:9/3to10/3:10/3to10/4:10/4to10/5:10/5to10/6:10/6to10/7:10/7to10/8:10/8to10/9:10/9to10/10:10/10to10/11:10/11to10/12:10/12to10/13:10/13to10/14:10/14to10/15:10/15to11/15:11/15to12/15:12/15to13/15:13/15totop13:,21,False,True
905,531,698,167,10/15to10/14,10/7to9/7,10/15to10/14:10/14to10/13:10/13to11/13:11/13to11/12:11/12to11/11:11/11to11/10:11/10to11/9:11/9to11/8:11/8to10/8:10/8to10/7:10/7to9/7:,11,True,True
9,532,917,385,left15to0/15,15/0tobottom15,left15to0/15:0/15to1/15:1/15to2/15:2/15to3/15:3/15to4/15:4/15to5/15:5/15to6/15:6/15to7/15:7/15to8/15:8/15to9/15:9/15to10/15:10/15to10/14:10/14to10/13:10/13to10/12:10/12to10/11:10/11to10/10:10/10to10/9:10/9to10/8:10/8to10/7:10/7to10/6:10/6to10/5:10/5to10/4:10/4to10/3:10/3to10/2:10/2to10/1:10/1to10/0:10/0to11/0:11/0to12/0:12/0to13/0:13/0to14/0:14/0to15/0:15/0tobottom15:,32,False,True
1875,532,660,128,15/3to15/2,9/2to9/1,15/3to15/2:15/2to14/2:14/2to13/2:13/2to12/2:12/2to11/2:11/2to10/2:10/2to9/2:9/2to9/1:,8,False,True
149,532,927,395,left0to0/0,15/15totop15,left0to0/0:0/0to0/1:0/1to0/2:0/2to0/3:0/3to0/4:0/4to0/5:0/5to0/6:0/6to0/7:0/7to0/8:0/8to0/9:0/9to0/10:0/10to0/11:0/11to0/12:0/12to0/13:0/13to1/13:1/13to2/13:2/13to3/13:3/13to4/13:4/13to5/13:5/13to6/13:6/13to7/13:7/13to8/13:8/13to9/13:9/13to10/13:10/13to10/14:10/14to11/14:11/14to11/15:11/15to12/15:12/15to13/15:13/15to14/15:14/15to15/15:15/15totop15:,32,True,True
2206,532,910,378,2/15to3/15,14/3to15/3,2/15to3/15:3/15to3/14:3/14to3/13:3/13to3/12:3/12to3/11:3/11to3/10:3/10to3/9:3/9to3/8:3/8to3/7:3/7to3/6:3/6to3/5:3/5to3/4:3/4to3/3:3/3to4/3:4/3to5/3:5/3to6/3:6/3to7/3:7/3to8/3:8/3to9/3:9/3to10/3:10/3to11/3:11/3to12/3:12/3to13/3:13/3to14/3:14/3to15/3:,25,True,True
3055,533,694,161,9/15to8/15,0/13to0/12,9/15to8/15:8/15to7/15:7/15to6/15:6/15to5/15:5/15to4/15:4/15to3/15:3/15to2/15:2/15to1/15:1/15to0/15:0/15to0/14:0/14to0/13:0/13to0/12:,12,False,True
527,533,822,289,12/3to11/3,3/12to2/12,12/3to11/3:11/3to10/3:10/3to9/3:9/3to8/3:8/3to7/3:7/3to6/3:6/3to5/3:5/3to4/3:4/3to3/3:3/3to3/4:3/4to3/5:3/5to3/6:3/6to3/7:3/7to3/8:3/8to3/9:3/9to3/10:3/10to3/11:3/11to3/12:3/12to2/12:,19,False,True
626,534,586,52,7/4to8/4,10/4to10/5,7/4to8/4:8/4to9/4:9/4to10/4:10/4to10/5:,4,False,True
1259,534,664,130,9/7to8/7,8/15to9/15,9/7to8/7:8/7to8/8:8/8to8/9:8/9to8/10:8/10to8/11:8/11to8/12:8/12to8/13:8/13to8/14:8/14to8/15:8/15to9/15:,10,True,True
986,535,630,95,4/5to4/4,1/2to2/2,4/5to4/4:4/4to3/4:3/4to2/4:2/4to1/4:1/4to1/3:1/3to1/2:1/2to2/2:,7,False,True
1101,535,630,95,top5to5/15,3/11to4/11,top5to5/15:5/15to4/15:4/15to3/15:3/15to3/14:3/14to3/13:3/13to3/12:3/12to3/11:3/11to4/11:,8,True,True
357,535,934,399,right0to15/0,0/15totop0,right0to15/0:15/0to14/0:14/0to13/0:13/0to12/0:12/0to11/0:11/0to10/0:10/0to9/0:9/0to8/0:8/0to7/0:7/0to6/0:6/0to5/0:5/0to4/0:4/0to3/0:3/0to2/0:2/0to1/0:1/0to0/0:0/0to0/1:0/1to0/2:0/2to0/3:0/3to0/4:0/4to0/5:0/5to0/6:0/6to0/7:0/7to0/8:0/8to0/9:0/9to0/10:0/10to0/11:0/11to0/12:0/12to0/13:0/13to0/14:0/14to0/15:0/15totop0:,32,False,True
397,535,934,399,right0to15/0,0/15totop0,right0to15/0:15/0to14/0:14/0to13/0:13/0to12/0:12/0to11/0:11/0to10/0:10/0to9/0:9/0to8/0:8/0to7/0:7/0to6/0:6/0to5/0:5/0to4/0:4/0to3/0:3/0to2/0:2/0to1/0:1/0to0/0:0/0to0/1:0/1to0/2:0/2to0/3:0/3to0/4:0/4to0/5:0/5to0/6:0/6to0/7:0/7to0/8:0/8to0/9:0/9to0/10:0/10to0/11:0/11to0/12:0/12to0/13:0/13to0/14:0/14to0/15:0/15totop0:,32,True,True
1471,536,742,206,10/13to10/12,1/8to1/7,10/13to10/12:10/12to9/12:9/12to8/12:8/12to7/12:7/12to6/12:6/12to5/12:5/12to4/12:4/12to3/12:3/12to2/12:2/12to1/12:1/12to1/11:1/11to1/10:1/10to1/9:1/9to1/8:1/8to1/7:,15,True,True
1850,537,787,250,3/9to3/10,14/9to14/8,3/9to3/10:3/10to4/10:4/10to5/10:5/10to6/10:6/10to7/10:7/10to8/10:8/10to9/10:9/10to10/10:10/10to11/10:11/10to11/9:11/9to12/9:12/9to13/9:13/9to14/9:14/9to14/8:,14,True,True
2660,537,699,162,9/15to8/15,5/7to5/6,9/15to8/15:8/15to7/15:7/15to6/15:6/15to5/15:5/15to5/14:5/14to5/13:5/13to5/12:5/12to5/11:5/11to5/10:5/10to5/9:5/9to5/8:5/8to5/7:5/7to5/6:,13,True,True
1294,537,1030,493,0/4to0/5,14/14to14/15,0/4to0/5:0/5to1/5:1/5to2/5:2/5to3/5:3/5to4/5:4/5to5/5:5/5to6/5:6/5to7/5:7/5to8/5:8/5to9/5:9/5to10/5:10/5to10/6:10/6to10/7:10/7to10/8:10/8to10/9:10/9to10/10:10/10to10/11:10/11to10/12:10/12to10/13:10/13to10/14:10/14to11/14:11/14to12/14:12/14to13/14:13/14to14/14:14/14to14/15:,25,False,True
1402,538,813,275,0/9to0/8,15/4toright4,0/9to0/8:0/8to0/7:0/7to0/6:0/6to0/5:0/5to1/5:1/5to2/5:2/5to3/5:3/5to4/5:4/5to5/5:5/5to6/5:6/5to7/5:7/5to8/5:8/5to9/5:9/5to10/5:10/5to10/4:10/4to11/4:11/4to12/4:12/4to13/4:13/4to14/4:14/4to15/4:15/4toright4:,21,True,True
1604,538,737,199,6/15to6/14,9/2to9/3,6/15to6/14:6/14to6/13:6/13to6/12:6/12to6/11:6/11to6/10:6/10to6/9:6/9to6/8:6/8to6/7:6/7to6/6:6/6to6/5:6/5to6/4:6/4to6/3:6/3to6/2:6/2to7/2:7/2to8/2:8/2to9/2:9/2to9/3:,17,True,True
430,539,626,87,12/8to11/8,14/10to15/10,12/8to11/8:11/8to11/9:11/9to11/10:11/10to12/10:12/10to13/10:13/10to14/10:14/10to15/10:,7,False,True
3256,539,638,99,bottom8to8/0,9/6to10/6,bottom8to8/0:8/0to8/1:8/1to8/2:8/2to8/3:8/3to8/4:8/4to8/5:8/5to8/6:8/6to9/6:9/6to10/6:,9,True,True
1576,539,768,229,5/5to5/6,10/12to10/13,5/5to5/6:5/6to6/6:6/6to7/6:7/6to8/6:8/6to9/6:9/6to10/6:10/6to10/7:10/7to10/8:10/8to10/9:10/9to10/10:10/10to10/11:10/11to10/12:10/12to10/13:,13,False,True
895,540,738,198,14/2to14/1,2/1to2/0,14/2to14/1:14/1to13/1:13/1to12/1:12/1to11/1:11/1to10/1:10/1to9/1:9/1to8/1:8/1to7/1:7/1to6/1:6/1to5/1:5/1to4/1:4/1to3/1:3/1to2/1:2/1to2/0:,14,False,True
251,541,920,379,right15to15/15,0/0tobottom0,right15to15/15:15/15to14/15:14/15to13/15:13/15to12/15:12/15to11/15:11/15to11/14:11/14to10/14:10/14to9/14:9/14to8/14:8/14to7/14:7/14to6/14:6/14to5/14:5/14to4/14:4/14to3/14:3/14to2/14:2/14to1/14:1/14to0/14:0/14to0/13:0/13to0/12:0/12to0/11:0/11to0/10:0/10to0/9:0/9to0/8:0/8to0/7:0/7to0/6:0/6to0/5:0/5to0/4:0/4to0/3:0/3to0/2:0/2to0/1:0/1to0/0:0/0tobottom0:,32,True,True
3035,541,662,121,10/15to9/15,3/14to3/13,10/15to9/15:9/15to8/15:8/15to7/15:7/15to6/15:6/15to5/15:5/15to4/15:4/15to3/15:3/15to3/14:3/14to3/13:,9,True,True
773,541,656,115,9/14to9/15,3/14to3/13,9/14to9/15:9/15to8/15:8/15to7/15:7/15to6/15:6/15to5/15:5/15to4/15:4/15to3/15:3/15to3/14:3/14to3/13:,9,True,True
606,541,622,81,2/7to2/6,1/2to1/1,2/7to2/6:2/6to1/6:1/6to1/5:1/5to1/4:1/4to1/3:1/3to1/2:1/2to1/1:,7,True,True
1386,542,751,209,12/1to12/2,0/1toleft1,12/1to12/2:12/2to11/2:11/2to10/2:10/2to9/2:9/2to8/2:8/2to7/2:7/2to6/2:6/2to5/2:5/2to4/2:4/2to3/2:3/2to2/2:2/2to1/2:1/2to0/2:0/2to0/1:0/1toleft1:,15,True,True
3063,542,867,325,1/2to2/2,12/11to12/10,1/2to2/2:2/2to3/2:3/2to4/2:4/2to5/2:5/2to6/2:6/2to7/2:7/2to8/2:8/2to9/2:9/2to10/2:10/2to10/3:10/3to10/4:10/4to10/5:10/5to10/6:10/6to10/7:10/7to10/8:10/8to10/9:10/9to10/10:10/10to10/11:10/11to11/11:11/11to12/11:12/11to12/10:,21,False,True
2979,543,809,266,3/3to3/4,15/5to15/4,3/3to3/4:3/4to4/4:4/4to5/4:5/4to6/4:6/4to7/4:7/4to8/4:8/4to9/4:9/4to10/4:10/4to10/5:10/5to11/5:11/5to12/5:12/5to13/5:13/5to14/5:14/5to15/5:15/5to15/4:,15,False,True
1005,543,600,57,10/10to10/11,10/13to9/13,10/10to10/11:10/11to10/12:10/12to10/13:10/13to9/13:,4,True,True
356,544,936,392,right0to15/0,0/15totop0,right0to15/0:15/0to14/0:14/0to13/0:13/0to12/0:12/0to11/0:11/0to11/1:11/1to10/1:10/1to9/1:9/1to8/1:8/1to7/1:7/1to6/1:6/1to5/1:5/1to4/1:4/1to3/1:3/1to2/1:2/1to1/1:1/1to0/1:0/1to0/2:0/2to0/3:0/3to0/4:0/4to0/5:0/5to0/6:0/6to0/7:0/7to0/8:0/8to0/9:0/9to0/10:0/10to0/11:0/11to0/12:0/12to0/13:0/13to0/14:0/14to0/15:0/15totop0:,32,True,True
2620,544,746,202,6/11to6/10,0/6toleft6,6/11to6/10:6/10to5/10:5/10to4/10:4/10to3/10:3/10to2/10:2/10to1/10:1/10to0/10:0/10to0/9:0/9to0/8:0/8to0/7:0/7to0/6:0/6toleft6:,12,True,True
1135,544,596,52,11/2to10/2,9/0tobottom9,11/2to10/2:10/2to10/1:10/1to10/0:10/0to9/0:9/0tobottom9:,5,False,True
3325,546,714,168,top0to0/15,7/12to8/12,top0to0/15:0/15to0/14:0/14to0/13:0/13to0/12:0/12to1/12:1/12to2/12:2/12to3/12:3/12to4/12:4/12to5/12:5/12to6/12:6/12to7/12:7/12to8/12:,12,True,True
2659,546,863,317,1/0to2/0,14/12to15/12,1/0to2/0:2/0to3/0:3/0to4/0:4/0to5/0:5/0to6/0:6/0to7/0:7/0to8/0:8/0to9/0:9/0to10/0:10/0to10/1:10/1to10/2:10/2to10/3:10/3to10/4:10/4to10/5:10/5to10/6:10/6to10/7:10/7to10/8:10/8to10/9:10/9to10/10:10/10to10/11:10/11to10/12:10/12to11/12:11/12to12/12:12/12to13/12:13/12to14/12:14/12to15/12:,26,False,True
3268,546,889,343,0/1to1/1,10/10to9/10,0/1to1/1:1/1to2/1:2/1to3/1:3/1to4/1:4/1to5/1:5/1to6/1:6/1to7/1:7/1to8/1:8/1to9/1:9/1to10/1:10/1to10/2:10/2to10/3:10/3to10/4:10/4to10/5:10/5to10/6:10/6to10/7:10/7to10/8:10/8to10/9:10/9to10/10:10/10to9/10:,20,False,True
2661,546,641,95,11/3to10/3,13/6to14/6,11/3to10/3:10/3to10/4:10/4to10/5:10/5to10/6:10/6to11/6:11/6to12/6:12/6to13/6:13/6to14/6:,8,False,True
1672,547,597,50,12/4to11/4,10/3to10/2,12/4to11/4:11/4to10/4:10/4to10/3:10/3to10/2:,4,False,True
759,547,694,147,bottom4to4/0,6/9to6/10,bottom4to4/0:4/0to4/1:4/1to4/2:4/2to4/3:4/3to4/4:4/4to4/5:4/5to4/6:4/6to4/7:4/7to4/8:4/8to4/9:4/9to5/9:5/9to6/9:6/9to6/10:,13,True,True
367,548,979,431,right0to15/0,0/15totop0,right0to15/0:15/0to14/0:14/0to13/0:13/0to12/0:12/0to11/0:11/0to11/1:11/1to10/1:10/1to9/1:9/1to8/1:8/1to7/1:7/1to6/1:6/1to5/1:5/1to4/1:4/1to3/1:3/1to2/1:2/1to1/1:1/1to0/1:0/1to0/2:0/2to0/3:0/3to0/4:0/4to0/5:0/5to0/6:0/6to0/7:0/7to0/8:0/8to0/9:0/9to0/10:0/10to0/11:0/11to0/12:0/12to0/13:0/13to0/14:0/14to0/15:0/15totop0:,32,True,True
2943,548,878,330,15/3to15/2,0/8toleft8,15/3to15/2:15/2to14/2:14/2to13/2:13/2to12/2:12/2to11/2:11/2to10/2:10/2to9/2:9/2to8/2:8/2to7/2:7/2to6/2:6/2to5/2:5/2to4/2:4/2to3/2:3/2to2/2:2/2to1/2:1/2to0/2:0/2to0/3:0/3to0/4:0/4to0/5:0/5to0/6:0/6to0/7:0/7to0/8:0/8toleft8:,23,False,True
1193,548,737,189,4/8to4/7,13/11to14/11,4/8to4/7:4/7to4/8:4/8to4/9:4/9to4/10:4/10to4/11:4/11to5/11:5/11to6/11:6/11to7/11:7/11to8/11:8/11to9/11:9/11to10/11:10/11to11/11:11/11to12/11:12/11to13/11:13/11to14/11:,15,True,True
1684,548,681,133,11/9to10/9,15/13toright13,11/9to10/9:10/9to10/10:10/10to10/11:10/11to10/12:10/12to10/13:10/13to11/13:11/13to12/13:12/13to13/13:13/13to14/13:14/13to15/13:15/13toright13:,11,False,True
3187,548,842,294,bottom11to11/0,2/14to2/15,bottom11to11/0:11/0to10/0:10/0to9/0:9/0to8/0:8/0to7/0:7/0to6/0:6/0to5/0:5/0to4/0:4/0to3/0:3/0to2/0:2/0to2/1:2/1to2/2:2/2to2/3:2/3to2/4:2/4to2/5:2/5to2/6:2/6to2/7:2/7to2/8:2/8to2/9:2/9to2/10:2/10to2/11:2/11to2/12:2/12to2/13:2/13to2/14:2/14to2/15:,25,False,True
3074,549,778,229,5/10to5/11,15/13to15/14,5/10to5/11:5/11to6/11:6/11to7/11:7/11to8/11:8/11to9/11:9/11to10/11:10/11to10/12:10/12to11/12:11/12to12/12:12/12to12/13:12/13to13/13:13/13to14/13:14/13to15/13:15/13to15/14:,14,True,True
1191,549,680,131,9/5to9/6,3/7to4/7,9/5to9/6:9/6to8/6:8/6to7/6:7/6to6/6:6/6to5/6:5/6to4/6:4/6to3/6:3/6to3/7:3/7to4/7:,9,True,True
1261,550,743,193,13/0to12/0,11/13to12/13,13/0to12/0:12/0to11/0:11/0to11/1:11/1to11/2:11/2to11/3:11/3to11/4:11/4to11/5:11/5to11/6:11/6to11/7:11/7to11/8:11/8to11/9:11/9to11/10:11/10to11/11:11/11to11/12:11/12to11/13:11/13to12/13:,16,False,True
1156,550,697,147,3/7to3/6,1/15totop1,3/7to3/6:3/6to2/6:2/6to1/6:1/6to1/7:1/7to1/8:1/8to1/9:1/9to1/10:1/10to1/11:1/11to1/12:1/12to1/13:1/13to1/14:1/14to1/15:1/15totop1:,13,False,True
1090,550,794,244,2/2to1/2,7/14to8/14,2/2to1/2:1/2to1/3:1/3to1/4:1/4to1/5:1/5to1/6:1/6to1/7:1/7to1/8:1/8to1/9:1/9to1/10:1/10to1/11:1/11to1/12:1/12to1/13:1/13to1/14:1/14to2/14:2/14to3/14:3/14to4/14:4/14to5/14:5/14to6/14:6/14to7/14:7/14to8/14:,20,True,True
942,551,709,158,bottom11to11/0,2/0to1/0,bottom11to11/0:11/0to11/1:11/1to10/1:10/1to9/1:9/1to8/1:8/1to7/1:7/1to6/1:6/1to5/1:5/1to4/1:4/1to3/1:3/1to2/1:2/1to2/0:2/0to1/0:,13,True,True
1028,551,791,240,left8to0/8,8/12to8/13,left8to0/8:0/8to0/9:0/9to0/10:0/10to0/11:0/11to0/12:0/12to1/12:1/12to2/12:2/12to3/12:3/12to4/12:4/12to5/12:5/12to6/12:6/12to7/12:7/12to8/12:8/12to8/13:,14,False,True
1140,551,701,150,6/10to6/11,13/14to14/14,6/10to6/11:6/11to6/12:6/12to6/13:6/13to6/14:6/14to7/14:7/14to8/14:8/14to9/14:9/14to10/14:10/14to11/14:11/14to12/14:12/14to13/14:13/14to14/14:,12,True,True
1042,551,616,65,6/1to7/1,8/0to8/1,6/1to7/1:7/1to7/0:7/0to8/0:8/0to8/1:,4,False,True
2745,551,756,205,0/8to0/9,9/14to10/14,0/8to0/9:0/9to0/10:0/10to0/11:0/11to0/12:0/12to0/13:0/13to0/14:0/14to1/14:1/14to2/14:2/14to3/14:3/14to4/14:4/14to5/14:5/14to6/14:6/14to7/14:7/14to8/14:8/14to9/14:9/14to10/14:,16,False,True
2509,551,650,99,1/13to1/12,7/12to7/13,1/13to1/12:1/12to2/12:2/12to3/12:3/12to4/12:4/12to5/12:5/12to6/12:6/12to7/12:7/12to7/13:,8,False,True
3088,552,792,240,2/14to3/14,15/11toright11,2/14to3/14:3/14to3/13:3/13to3/12:3/12to4/12:4/12to5/12:5/12to6/12:6/12to7/12:7/12to8/12:8/12to9/12:9/12to10/12:10/12to10/11:10/11to11/11:11/11to12/11:12/11to13/11:13/11to14/11:14/11to15/11:15/11toright11:,17,True,True
953,552,676,124,left3to0/3,6/1to7/1,left3to0/3:0/3to0/2:0/2to0/1:0/1to1/1:1/1to2/1:2/1to3/1:3/1to4/1:4/1to5/1:5/1to6/1:6/1to7/1:,10,True,True
2857,552,740,188,13/3to12/3,7/4to7/5,13/3to12/3:12/3to11/3:11/3to10/3:10/3to9/3:9/3to8/3:8/3to7/3:7/3to7/4:7/4to7/5:,8,True,True
1176,552,680,128,7/12to7/11,1/10to2/10,7/12to7/11:7/11to6/11:6/11to5/11:5/11to4/11:4/11to3/11:3/11to2/11:2/11to1/11:1/11to1/10:1/10to2/10:,9,False,True
204,553,927,374,right15to15/15,0/0tobottom0,right15to15/15:15/15to14/15:14/15to13/15:13/15to12/15:12/15to11/15:11/15to10/15:10/15to9/15:9/15to8/15:8/15to7/15:7/15to6/15:6/15to5/15:5/15to4/15:4/15to3/15:3/15to2/15:2/15to1/15:1/15to0/15:0/15to0/14:0/14to0/13:0/13to0/12:0/12to0/11:0/11to0/10:0/10to0/9:0/9to0/8:0/8to0/7:0/7to0/6:0/6to0/5:0/5to0/4:0/4to0/3:0/3to0/2:0/2to0/1:0/1to0/0:0/0tobottom0:,32,True,True
2186,553,647,94,5/8to4/8,4/14to4/15,5/8to4/8:4/8to4/9:4/9to4/10:4/10to4/11:4/11to4/12:4/12to4/13:4/13to4/14:4/14to4/15:,8,False,True
964,553,704,151,5/6to6/6,11/0tobottom11,5/6to6/6:6/6to6/5:6/5to6/4:6/4to6/3:6/3to6/2:6/2to6/1:6/1to6/0:6/0to7/0:7/0to8/0:8/0to9/0:9/0to10/0:10/0to11/0:11/0tobottom11:,13,True,True
3089,553,733,180,left6to0/6,3/14to4/14,left6to0/6:0/6to0/7:0/7to0/8:0/8to0/9:0/9to0/10:0/10to0/11:0/11to0/12:0/12to0/13:0/13to0/14:0/14to1/14:1/14to2/14:2/14to3/14:3/14to4/14:,13,True,True
2773,553,691,138,4/12to4/11,5/2to5/1,4/12to4/11:4/11to4/10:4/10to4/9:4/9to4/8:4/8to4/7:4/7to4/6:4/6to4/5:4/5to4/4:4/4to4/3:4/3to4/2:4/2to5/2:5/2to5/1:,12,True,True
1397,554,792,238,1/14to2/14,11/7to11/6,1/14to2/14:2/14to3/14:3/14to4/14:4/14to5/14:5/14to6/14:6/14to7/14:7/14to8/14:8/14to9/14:9/14to10/14:10/14to10/13:10/13to10/12:10/12to10/11:10/11to10/10:10/10to10/9:10/9to10/8:10/8to10/7:10/7to11/7:11/7to11/6:,18,False,True
533,554,777,223,5/10to5/9,15/11to15/12,5/10to5/9:5/9to6/9:6/9to7/9:7/9to8/9:8/9to9/9:9/9to10/9:10/9to10/10:10/10to10/11:10/11to11/11:11/11to12/11:12/11to13/11:13/11to14/11:14/11to15/11:15/11to15/12:,14,False,True
49,555,926,371,left15to0/15,15/0tobottom15,left15to0/15:0/15to1/15:1/15to2/15:2/15to3/15:3/15to4/15:4/15to5/15:5/15to6/15:6/15to7/15:7/15to8/15:8/15to9/15:9/15to10/15:10/15to10/14:10/14to10/13:10/13to10/12:10/12to10/11:10/11to10/10:10/10to10/9:10/9to10/8:10/8to10/7:10/7to10/6:10/6to10/5:10/5to10/4:10/4to10/3:10/3to10/2:10/2to10/1:10/1to10/0:10/0to11/0:11/0to12/0:12/0to13/0:13/0to14/0:14/0to15/0:15/0tobottom15:,32,False,True
3220,555,670,115,3/12to4/12,6/7to7/7,3/12to4/12:4/12to4/11:4/11to4/10:4/10to4/9:4/9to4/8:4/8to4/7:4/7to5/7:5/7to6/7:6/7to7/7:,9,False,True
227,555,939,384,right15to15/15,0/0tobottom0,right15to15/15:15/15to14/15:14/15to13/15:13/15to12/15:12/15to11/15:11/15to10/15:10/15to9/15:9/15to8/15:8/15to7/15:7/15to6/15:6/15to5/15:5/15to4/15:4/15to3/15:3/15to2/15:2/15to1/15:1/15to0/15:0/15to0/14:0/14to0/13:0/13to0/12:0/12to0/11:0/11to0/10:0/10to0/9:0/9to0/8:0/8to0/7:0/7to0/6:0/6to0/5:0/5to0/4:0/4to0/3:0/3to0/2:0/2to0/1:0/1to0/0:0/0tobottom0:,32,True,True
493,555,762,207,11/1to11/2,3/9to4/9,11/1to11/2:11/2to10/2:10/2to9/2:9/2to8/2:8/2to7/2:7/2to6/2:6/2to5/2:5/2to4/2:4/2to3/2:3/2to3/3:3/3to3/4:3/4to3/5:3/5to3/6:3/6to3/7:3/7to3/8:3/8to3/9:3/9to4/9:,17,True,True
764,556,732,176,14/6to13/6,9/14to8/14,14/6to13/6:13/6to12/6:12/6to11/6:11/6to10/6:10/6to10/7:10/7to10/8:10/8to10/9:10/9to10/10:10/10to10/11:10/11to10/12:10/12to10/13:10/13to10/14:10/14to9/14:9/14to8/14:,14,False,True
3194,556,883,327,15/9to14/9,0/0tobottom0,15/9to14/9:14/9to13/9:13/9to12/9:12/9to11/9:11/9to10/9:10/9to9/9:9/9to8/9:8/9to7/9:7/9to6/9:6/9to5/9:5/9to4/9:4/9to3/9:3/9to2/9:2/9to1/9:1/9to0/9:0/9to0/8:0/8to0/7:0/7to0/6:0/6to0/5:0/5to0/4:0/4to0/3:0/3to0/2:0/2to0/1:0/1to0/0:0/0tobottom0:,25,False,True
3262,556,666,110,14/9to13/9,10/13to10/14,14/9to13/9:13/9to12/9:12/9to12/10:12/10to12/11:12/11to11/11:11/11to10/11:10/11to10/12:10/12to10/13:10/13to10/14:,9,True,True
1687,556,692,136,5/11to4/11,2/5to2/4,5/11to4/11:4/11to3/11:3/11to2/11:2/11to2/10:2/10to2/9:2/9to2/8:2/8to2/7:2/7to2/6:2/6to2/5:2/5to2/4:,10,True,True
2440,557,671,114,bottom15to15/0,11/4to11/5,bottom15to15/0:15/0to14/0:14/0to13/0:13/0to12/0:12/0to12/1:12/1to12/2:12/2to11/2:11/2to11/3:11/3to11/4:11/4to11/5:,10,True,True
1690,557,810,253,12/15to11/15,4/3to3/3,12/15to11/15:11/15to10/15:10/15to9/15:9/15to8/15:8/15to7/15:7/15to6/15:6/15to5/15:5/15to4/15:4/15to4/14:4/14to4/13:4/13to4/12:4/12to4/11:4/11to4/10:4/10to4/9:4/9to4/8:4/8to4/7:4/7to4/6:4/6to4/5:4/5to4/4:4/4to4/3:4/3to3/3:,21,False,True
2213,557,602,45,3/14to3/13,4/13to5/13,3/14to3/13:3/13to4/13:4/13to5/13:,3,True,True
2939,557,692,135,13/0to12/0,12/10to13/10,13/0to12/0:12/0to12/1:12/1to12/2:12/2to12/3:12/3to12/4:12/4to12/5:12/5to12/6:12/6to12/7:12/7to12/8:12/8to12/9:12/9to12/10:12/10to13/10:,12,False,True
2433,557,793,236,10/12to9/12,2/4to3/4,10/12to9/12:9/12to8/12:8/12to7/12:7/12to6/12:6/12to5/12:5/12to4/12:4/12to3/12:3/12to2/12:2/12to2/11:2/11to2/10:2/10to2/9:2/9to2/8:2/8to2/7:2/7to2/6:2/6to2/5:2/5to2/4:2/4to3/4:,17,False,True
2483,558,633,75,13/4to12/4,14/2to14/1,13/4to12/4:12/4to12/3:12/3to12/2:12/2to13/2:13/2to14/2:14/2to14/1:,6,False,True
390,558,984,426,right0to15/0,0/15totop0,right0to15/0:15/0to14/0:14/0to13/0:13/0to12/0:12/0to11/0:11/0to11/1:11/1to10/1:10/1to9/1:9/1to8/1:8/1to7/1:7/1to6/1:6/1to5/1:5/1to4/1:4/1to3/1:3/1to2/1:2/1to1/1:1/1to0/1:0/1to0/2:0/2to0/3:0/3to0/4:0/4to0/5:0/5to0/6:0/6to0/7:0/7to0/8:0/8to0/9:0/9to0/10:0/10to0/11:0/11to0/12:0/12to0/13:0/13to0/14:0/14to0/15:0/15totop0:,32,True,True
1973,558,797,239,5/14to5/13,11/2to12/2,5/14to5/13:5/13to6/13:6/13to7/13:7/13to8/13:8/13to9/13:9/13to10/13:10/13to10/12:10/12to10/11:10/11to10/10:10/10to10/9:10/9to10/8:10/8to10/7:10/7to10/6:10/6to10/5:10/5to10/4:10/4to10/3:10/3to10/2:10/2to11/2:11/2to12/2:,19,False,True
2933,558,689,131,1/10to1/9,7/7to8/7,1/10to1/9:1/9to1/8:1/8to1/7:1/7to2/7:2/7to3/7:3/7to4/7:4/7to5/7:5/7to6/7:6/7to7/7:7/7to8/7:,10,True,True
854,558,700,142,6/11to5/11,1/8to1/7,6/11to5/11:5/11to4/11:4/11to3/11:3/11to2/11:2/11to1/11:1/11to1/10:1/10to1/9:1/9to1/8:1/8to1/7:,9,True,True
2552,558,685,127,13/4to14/4,14/13to14/14,13/4to14/4:14/4to14/5:14/5to14/6:14/6to14/7:14/7to14/8:14/8to14/9:14/9to14/10:14/10to14/11:14/11to14/12:14/12to14/13:14/13to14/14:,11,False,True
2405,558,625,67,2/3to1/3,0/2to0/1,2/3to1/3:1/3to0/3:0/3to0/2:0/2to0/1:,4,False,True
2337,559,734,175,9/14to8/14,3/8to3/7,9/14to8/14:8/14to7/14:7/14to6/14:6/14to5/14:5/14to4/14:4/14to3/14:3/14to3/13:3/13to3/12:3/12to3/11:3/11to3/10:3/10to3/9:3/9to3/8:3/8to3/7:,13,False,True
2504,559,717,158,14/9to14/10,12/1to12/0,14/9to14/10:14/10to13/10:13/10to12/10:12/10to12/9:12/9to12/8:12/8to12/7:12/7to12/6:12/6to12/5:12/5to12/4:12/4to12/3:12/3to12/2:12/2to12/1:12/1to12/0:,13,True,True
758,560,822,262,6/14to7/14,14/1to14/0,6/14to7/14:7/14to7/13:7/13to7/12:7/12to7/11:7/11to7/10:7/10to7/9:7/9to7/8:7/8to7/7:7/7to7/6:7/6to7/5:7/5to7/4:7/4to7/3:7/3to7/2:7/2to8/2:8/2to9/2:9/2to10/2:10/2to10/1:10/1to11/1:11/1to12/1:12/1to13/1:13/1to14/1:14/1to14/0:,22,True,True
2648,560,714,154,4/2to5/2,9/9to9/8,4/2to5/2:5/2to5/3:5/3to5/4:5/4to5/5:5/5to5/6:5/6to5/7:5/7to5/8:5/8to5/9:5/9to6/9:6/9to7/9:7/9to8/9:8/9to9/9:9/9to9/8:,13,True,True
2705,560,1006,446,bottom5to5/0,14/5to14/4,bottom5to5/0:5/0to5/1:5/1to5/2:5/2to5/3:5/3to5/4:5/4to6/4:6/4to7/4:7/4to8/4:8/4to9/4:9/4to10/4:10/4to10/5:10/5to11/5:11/5to12/5:12/5to13/5:13/5to14/5:14/5to14/4:,16,True,True
3098,560,736,176,10/14to10/13,14/5to15/5,10/14to10/13:10/13to10/12:10/12to10/11:10/11to10/10:10/10to10/9:10/9to10/8:10/8to10/7:10/7to10/6:10/6to10/5:10/5to11/5:11/5to12/5:12/5to13/5:13/5to14/5:14/5to15/5:,14,False,True
1412,560,852,292,12/1to11/1,2/12to2/13,12/1to11/1:11/1to10/1:10/1to9/1:9/1to8/1:8/1to7/1:7/1to6/1:6/1to5/1:5/1to4/1:4/1to3/1:3/1to2/1:2/1to2/2:2/2to2/3:2/3to2/4:2/4to2/5:2/5to2/6:2/6to2/7:2/7to2/8:2/8to2/9:2/9to2/10:2/10to2/11:2/11to2/12:2/12to2/13:,22,False,True
165,560,952,392,left0to0/0,15/15totop15,left0to0/0:0/0to1/0:1/0to2/0:2/0to3/0:3/0to4/0:4/0to5/0:5/0to6/0:6/0to7/0:7/0to8/0:8/0to9/0:9/0to10/0:10/0to10/1:10/1to10/2:10/2to10/3:10/3to10/4:10/4to10/5:10/5to10/6:10/6to10/7:10/7to10/8:10/8to10/9:10/9to10/10:10/10to10/11:10/11to10/12:10/12to10/13:10/13to10/14:10/14to10/15:10/15to11/15:11/15to12/15:12/15to13/15:13/15to14/15:14/15to15/15:15/15totop15:,32,False,True
2363,560,827,267,15/2to15/1,4/4to4/5,15/2to15/1:15/1to14/1:14/1to13/1:13/1to12/1:12/1to11/1:11/1to10/1:10/1to9/1:9/1to8/1:8/1to7/1:7/1to6/1:6/1to5/1:5/1to4/1:4/1to4/2:4/2to4/3:4/3to4/4:4/4to4/5:,16,False,True
3068,561,685,124,1/2to0/2,1/9to2/9,1/2to0/2:0/2to0/3:0/3to0/4:0/4to0/5:0/5to0/6:0/6to0/7:0/7to0/8:0/8to0/9:0/9to1/9:1/9to2/9:,10,False,True
2459,561,750,189,5/10to5/11,13/10to13/9,5/10to5/11:5/11to6/11:6/11to7/11:7/11to8/11:8/11to9/11:9/11to10/11:10/11to10/10:10/10to11/10:11/10to12/10:12/10to13/10:13/10to13/9:,11,False,True
2767,561,826,265,11/3to10/3,0/1toleft1,11/3to10/3:10/3to9/3:9/3to8/3:8/3to7/3:7/3to6/3:6/3to5/3:5/3to4/3:4/3to3/3:3/3to2/3:2/3to1/3:1/3to0/3:0/3to0/2:0/2to0/1:0/1toleft1:,14,False,True
2485,561,634,73,bottom8to8/0,7/4to8/4,bottom8to8/0:8/0to7/0:7/0to7/1:7/1to7/2:7/2to7/3:7/3to7/4:7/4to8/4:,7,False,True
261,561,948,387,right15to15/15,0/0tobottom0,right15to15/15:15/15to14/15:14/15to13/15:13/15to12/15:12/15to11/15:11/15to10/15:10/15to9/15:9/15to8/15:8/15to7/15:7/15to6/15:6/15to5/15:5/15to4/15:4/15to3/15:3/15to2/15:2/15to1/15:1/15to0/15:0/15to0/14:0/14to0/13:0/13to0/12:0/12to0/11:0/11to0/10:0/10to0/9:0/9to0/8:0/8to0/7:0/7to0/6:0/6to0/5:0/5to0/4:0/4to0/3:0/3to0/2:0/2to0/1:0/1to0/0:0/0tobottom0:,32,False,True
2341,562,750,188,7/9to8/9,12/0to13/0,7/9to8/9:8/9to8/8:8/8to8/7:8/7to8/6:8/6to8/5:8/5to8/4:8/4to8/3:8/3to8/2:8/2to8/1:8/1to8/0:8/0to9/0:9/0to10/0:10/0to11/0:11/0to12/0:12/0to13/0:,15,True,True
1836,562,676,114,15/6to15/5,11/8to10/8,15/6to15/5:15/5to14/5:14/5to13/5:13/5to12/5:12/5to12/6:12/6to12/7:12/7to12/8:12/8to11/8:11/8to10/8:,9,True,True
2830,562,717,155,12/13to13/13,13/2to12/2,12/13to13/13:13/13to13/12:13/12to13/11:13/11to13/10:13/10to13/9:13/9to13/8:13/8to13/7:13/7to13/6:13/6to13/5:13/5to13/4:13/4to13/3:13/3to13/2:13/2to12/2:,13,True,True
788,562,665,103,15/9to14/9,10/7to9/7,15/9to14/9:14/9to13/9:13/9to12/9:12/9to11/9:11/9to10/9:10/9to10/8:10/8to10/7:10/7to9/7:,8,False,True
480,563,699,136,11/14to10/14,9/10to8/10,11/14to10/14:10/14to10/13:10/13to11/13:11/13to11/12:11/12to11/11:11/11to10/11:10/11to10/10:10/10to9/10:9/10to8/10:,9,True,True
2812,563,714,151,7/10to7/11,12/8to13/8,7/10to7/11:7/11to7/10:7/10to7/9:7/9to7/8:7/8to8/8:8/8to9/8:9/8to10/8:10/8to11/8:11/8to12/8:12/8to13/8:,10,True,True
2608,563,748,185,top2to2/15,0/7to1/7,top2to2/15:2/15to1/15:1/15to0/15:0/15to0/14:0/14to0/13:0/13to0/12:0/12to0/11:0/11to0/10:0/10to0/9:0/9to0/8:0/8to0/7:0/7to1/7:,12,False,True
1611,564,806,242,14/5to13/5,2/7to2/8,14/5to13/5:13/5to12/5:12/5to11/5:11/5to10/5:10/5to9/5:9/5to8/5:8/5to7/5:7/5to6/5:6/5to5/5:5/5to4/5:4/5to3/5:3/5to2/5:2/5to2/6:2/6to2/7:2/7to2/8:,15,True,True
2355,564,686,122,13/4to12/4,9/9to9/10,13/4to12/4:12/4to11/4:11/4to10/4:10/4to10/5:10/5to10/6:10/6to10/7:10/7to10/8:10/8to10/9:10/9to9/9:9/9to9/10:,10,False,True
3002,564,636,72,5/0to5/1,7/3to7/4,5/0to5/1:5/1to5/2:5/2to5/3:5/3to6/3:6/3to7/3:7/3to7/4:,6,False,True
2820,564,884,320,1/14to2/14,11/1to12/1,1/14to2/14:2/14to2/13:2/13to2/12:2/12to2/11:2/11to2/10:2/10to2/9:2/9to2/8:2/8to2/7:2/7to2/6:2/6to2/5:2/5to2/4:2/4to2/3:2/3to2/2:2/2to3/2:3/2to4/2:4/2to5/2:5/2to6/2:6/2to7/2:7/2to8/2:8/2to9/2:9/2to10/2:10/2to10/1:10/1to11/1:11/1to12/1:,24,True,True
1268,564,707,143,9/7to9/8,6/15to5/15,9/7to9/8:9/8to8/8:8/8to7/8:7/8to6/8:6/8to6/9:6/9to6/10:6/10to6/11:6/11to6/12:6/12to6/13:6/13to6/14:6/14to6/15:6/15to5/15:,12,False,True
2858,565,590,25,4/7to5/7,5/7to4/7,4/7to5/7:5/7to4/7:,2,False,True
848,565,647,82,10/2to10/3,14/3to14/2,10/2to10/3:10/3to11/3:11/3to12/3:12/3to13/3:13/3to14/3:14/3to14/2:,6,False,True
1396,566,727,161,5/1to5/2,4/13to3/13,5/1to5/2:5/2to4/2:4/2to4/3:4/3to4/4:4/4to4/5:4/5to4/6:4/6to4/7:4/7to4/8:4/8to4/9:4/9to4/10:4/10to4/11:4/11to4/12:4/12to4/13:4/13to3/13:,14,False,True
434,566,750,184,bottom9to9/0,9/15to10/15,bottom9to9/0:9/0to9/1:9/1to9/2:9/2to9/3:9/3to9/4:9/4to9/5:9/5to9/6:9/6to9/7:9/7to9/8:9/8to9/9:9/9to9/10:9/10to9/11:9/11to9/12:9/12to9/13:9/13to9/14:9/14to9/15:9/15to10/15:,17,False,True
2609,566,702,136,bottom12to12/0,6/3to6/4,bottom12to12/0:12/0to11/0:11/0to11/1:11/1to10/1:10/1to9/1:9/1to8/1:8/1to7/1:7/1to6/1:6/1to6/2:6/2to6/3:6/3to6/4:,11,True,True
3031,566,618,52,3/3to3/2,2/1to2/0,3/3to3/2:3/2to2/2:2/2to2/1:2/1to2/0:,4,True,True
2320,567,738,171,6/12to6/13,11/8to12/8,6/12to6/13:6/13to6/12:6/12to6/11:6/11to6/10:6/10to6/9:6/9to6/8:6/8to7/8:7/8to8/8:8/8to9/8:9/8to10/8:10/8to11/8:11/8to12/8:,12,True,True
3308,567,630,63,0/5to0/4,0/1to1/1,0/5to0/4:0/4to0/3:0/3to0/2:0/2to0/1:0/1to1/1:,5,True,True
2528,567,814,247,9/2to10/2,11/15totop11,9/2to10/2:10/2to10/3:10/3to9/3:9/3to9/4:9/4to9/5:9/5to9/6:9/6to9/7:9/7to9/8:9/8to9/9:9/9to9/10:9/10to9/11:9/11to9/12:9/12to9/13:9/13to9/14:9/14to10/14:10/14to10/15:10/15to11/15:11/15totop11:,18,True,True
463,568,681,113,6/6to6/5,9/0tobottom9,6/6to6/5:6/5to6/4:6/4to6/3:6/3to6/2:6/2to6/1:6/1to6/0:6/0to7/0:7/0to8/0:8/0to9/0:9/0tobottom9:,10,False,True
3165,568,704,136,7/7to6/7,8/14to9/14,7/7to6/7:6/7to6/8:6/8to6/9:6/9to6/10:6/10to6/11:6/11to6/12:6/12to6/13:6/13to6/14:6/14to7/14:7/14to8/14:8/14to9/14:,11,False,True
155,568,941,373,left0to0/0,15/15totop15,left0to0/0:0/0to0/1:0/1to0/2:0/2to0/3:0/3to0/4:0/4to0/5:0/5to0/6:0/6to0/7:0/7to0/8:0/8to0/9:0/9to0/10:0/10to0/11:0/11to0/12:0/12to0/13:0/13to0/14:0/14to1/14:1/14to2/14:2/14to3/14:3/14to4/14:4/14to5/14:5/14to6/14:6/14to7/14:7/14to8/14:8/14to9/14:9/14to10/14:10/14to10/15:10/15to11/15:11/15to12/15:12/15to13/15:13/15to14/15:14/15to15/15:15/15totop15:,32,True,True
729,568,675,107,5/8to5/9,1/7to0/7,5/8to5/9:5/9to4/9:4/9to3/9:3/9to2/9:2/9to1/9:1/9to1/8:1/8to1/7:1/7to0/7:,8,False,True
2402,568,895,327,2/12to2/11,14/3to15/3,2/12to2/11:2/11to3/11:3/11to4/11:4/11to5/11:5/11to6/11:6/11to7/11:7/11to8/11:8/11to9/11:9/11to10/11:10/11to10/10:10/10to10/9:10/9to10/8:10/8to10/7:10/7to10/6:10/6to10/5:10/5to10/4:10/4to10/3:10/3to11/3:11/3to12/3:12/3to13/3:13/3to14/3:14/3to15/3:,22,False,True
572,568,715,147,0/2to0/3,1/11to2/11,0/2to0/3:0/3to0/4:0/4to0/5:0/5to0/6:0/6to0/7:0/7to0/8:0/8to0/9:0/9to0/10:0/10to0/11:0/11to1/11:1/11to2/11:,11,False,True
2646,569,841,272,top15to15/15,7/2to6/2,top15to15/15:15/15to14/15:14/15to13/15:13/15to12/15:12/15to11/15:11/15to10/15:10/15to9/15:9/15to8/15:8/15to7/15:7/15to7/14:7/14to7/13:7/13to7/12:7/12to7/11:7/11to7/10:7/10to7/9:7/9to7/8:7/8to7/7:7/7to7/6:7/6to7/5:7/5to7/4:7/4to7/3:7/3to7/2:7/2to6/2:,23,False,True
667,569,824,255,8/1to9/1,14/6to14/7,8/1to9/1:9/1to10/1:10/1to10/2:10/2to10/3:10/3to10/4:10/4to10/5:10/5to10/6:10/6to11/6:11/6to12/6:12/6to13/6:13/6to14/6:14/6to14/7:,12,False,True
1327,570,828,258,top9to9/15,15/1to15/2,top9to9/15:9/15to10/15:10/15to10/14:10/14to10/13:10/13to10/12:10/12to10/11:10/11to10/10:10/10to10/9:10/9to10/8:10/8to10/7:10/7to10/6:10/6to10/5:10/5to10/4:10/4to10/3:10/3to10/2:10/2to10/1:10/1to11/1:11/1to12/1:12/1to13/1:13/1to14/1:14/1to15/1:15/1to15/2:,22,False,True
2651,570,772,202,top5to5/15,8/2to8/1,top5to5/15:5/15to5/14:5/14to5/13:5/13to5/12:5/12to5/11:5/11to5/10:5/10to5/9:5/9to5/8:5/8to5/7:5/7to5/6:5/6to5/5:5/5to5/4:5/4to5/3:5/3to5/2:5/2to6/2:6/2to7/2:7/2to8/2:8/2to8/1:,18,True,True
2593,570,668,98,12/10to13/10,15/15toright15,12/10to13/10:13/10to13/11:13/11to13/12:13/12to13/13:13/13to13/14:13/14to13/15:13/15to14/15:14/15to15/15:15/15toright15:,9,True,True
398,571,953,382,right0to15/0,0/15totop0,right0to15/0:15/0to14/0:14/0to13/0:13/0to12/0:12/0to11/0:11/0to10/0:10/0to9/0:9/0to8/0:8/0to7/0:7/0to6/0:6/0to5/0:5/0to4/0:4/0to3/0:3/0to2/0:2/0to1/0:1/0to0/0:0/0to0/1:0/1to0/2:0/2to0/3:0/3to0/4:0/4to0/5:0/5to0/6:0/6to0/7:0/7to0/8:0/8to0/9:0/9to0/10:0/10to0/11:0/11to0/12:0/12to0/13:0/13to0/14:0/14to0/15:0/15totop0:,32,False,True
1112,571,616,45,left4to0/4,0/2to1/2,left4to0/4:0/4to0/3:0/3to0/2:0/2to1/2:,4,True,True
2790,572,732,160,6/15to5/15,0/9to1/9,6/15to5/15:5/15to4/15:4/15to3/15:3/15to2/15:2/15to1/15:1/15to0/15:0/15to0/14:0/14to0/13:0/13to0/12:0/12to0/11:0/11to0/10:0/10to0/9:0/9to1/9:,13,True,True
2811,572,924,352,15/11to15/10,0/15to1/15,15/11to15/10:15/10to14/10:14/10to13/10:13/10to12/10:12/10to11/10:11/10to10/10:10/10to9/10:9/10to8/10:8/10to7/10:7/10to6/10:6/10to5/10:5/10to4/10:4/10to3/10:3/10to2/10:2/10to1/10:1/10to0/10:0/10to0/11:0/11to0/12:0/12to0/13:0/13to0/14:0/14to0/15:0/15to1/15:,22,False,True
3361,572,796,224,3/10to3/11,10/5to11/5,3/10to3/11:3/11to4/11:4/11to5/11:5/11to6/11:6/11to7/11:7/11to8/11:8/11to9/11:9/11to10/11:10/11to10/10:10/10to10/9:10/9to10/8:10/8to10/7:10/7to10/6:10/6to10/5:10/5to11/5:,15,False,True
1324,573,723,150,15/11to14/11,8/11to8/12,15/11to14/11:14/11to13/11:13/11to12/11:12/11to11/11:11/11to10/11:10/11to9/11:9/11to8/11:8/11to8/12:,8,False,True
543,573,806,233,13/13to13/12,7/0tobottom7,13/13to13/12:13/12to12/12:12/12to11/12:11/12to10/12:10/12to9/12:9/12to8/12:8/12to7/12:7/12to7/11:7/11to7/10:7/10to7/9:7/9to7/8:7/8to7/7:7/7to7/6:7/6to7/5:7/5to7/4:7/4to7/3:7/3to7/2:7/2to7/1:7/1to7/0:7/0tobottom7:,20,False,True
2141,573,772,199,1/4to1/3,12/1to13/1,1/4to1/3:1/3to1/2:1/2to2/2:2/2to3/2:3/2to4/2:4/2to5/2:5/2to6/2:6/2to7/2:7/2to8/2:8/2to9/2:9/2to10/2:10/2to10/1:10/1to11/1:11/1to12/1:12/1to13/1:,15,True,True
2487,573,909,336,bottom2to2/0,14/14to14/15,bottom2to2/0:2/0to2/1:2/1to2/2:2/2to2/3:2/3to2/4:2/4to2/5:2/5to2/6:2/6to2/7:2/7to2/8:2/8to2/9:2/9to2/10:2/10to2/11:2/11to2/12:2/12to2/13:2/13to3/13:3/13to4/13:4/13to5/13:5/13to6/13:6/13to7/13:7/13to8/13:8/13to9/13:9/13to10/13:10/13to10/14:10/14to11/14:11/14to12/14:12/14to13/14:13/14to14/14:14/14to14/15:,28,True,True
806,573,650,77,14/8to14/9,12/7to11/7,14/8to14/9:14/9to13/9:13/9to12/9:12/9to12/8:12/8to12/7:12/7to11/7:,6,False,True
259,574,983,409,right15to15/15,0/0tobottom0,right15to15/15:15/15to14/15:14/15to13/15:13/15to12/15:12/15to11/15:11/15to11/14:11/14to10/14:10/14to9/14:9/14to8/14:8/14to7/14:7/14to6/14:6/14to5/14:5/14to4/14:4/14to3/14:3/14to2/14:2/14to1/14:1/14to0/14:0/14to0/13:0/13to0/12:0/12to0/11:0/11to0/10:0/10to0/9:0/9to0/8:0/8to0/7:0/7to0/6:0/6to0/5:0/5to0/4:0/4to0/3:0/3to0/2:0/2to0/1:0/1to0/0:0/0tobottom0:,32,True,True
2849,574,723,149,6/12to7/12,12/7to12/8,6/12to7/12:7/12to8/12:8/12to9/12:9/12to10/12:10/12to10/11:10/11to10/10:10/10to10/9:10/9to10/8:10/8to10/7:10/7to11/7:11/7to12/7:12/7to12/8:,12,False,True
1124,575,792,217,1/15to1/14,7/4to8/4,1/15to1/14:1/14to1/13:1/13to1/12:1/12to1/11:1/11to1/10:1/10to1/9:1/9to1/8:1/8to1/7:1/7to1/6:1/6to1/5:1/5to1/4:1/4to2/4:2/4to3/4:3/4to4/4:4/4to5/4:5/4to6/4:6/4to7/4:7/4to8/4:,18,True,True
1629,575,652,77,10/2to10/3,14/3to15/3,10/2to10/3:10/3to11/3:11/3to12/3:12/3to13/3:13/3to14/3:14/3to15/3:,6,True,True
422,575,940,365,11/6to10/6,0/9toleft9,11/6to10/6:10/6to9/6:9/6to8/6:8/6to7/6:7/6to6/6:6/6to5/6:5/6to4/6:4/6to3/6:3/6to2/6:2/6to1/6:1/6to0/6:0/6to0/7:0/7to0/8:0/8to0/9:0/9toleft9:,15,True,True
1588,575,826,251,13/5to13/6,3/1to3/0,13/5to13/6:13/6to12/6:12/6to11/6:11/6to11/5:11/5to10/5:10/5to9/5:9/5to8/5:8/5to7/5:7/5to6/5:6/5to5/5:5/5to4/5:4/5to3/5:3/5to3/4:3/4to3/3:3/3to3/2:3/2to3/1:3/1to3/0:,17,True,True
1035,576,628,52,15/11to15/12,13/12to12/12,15/11to15/12:15/12to14/12:14/12to13/12:13/12to12/12:,4,False,True
1185,577,871,294,0/2to0/1,11/8to11/7,0/2to0/1:0/1to0/2:0/2to0/3:0/3to0/4:0/4to0/5:0/5to0/6:0/6to0/7:0/7to0/8:0/8to1/8:1/8to2/8:2/8to3/8:3/8to4/8:4/8to5/8:5/8to6/8:6/8to7/8:7/8to8/8:8/8to9/8:9/8to10/8:10/8to11/8:11/8to11/7:,20,True,True
928,578,640,62,12/12to11/12,10/14to10/15,12/12to11/12:11/12to11/13:11/13to10/13:10/13to10/14:10/14to10/15:,5,True,True
2878,579,708,129,2/4to2/3,8/0tobottom8,2/4to2/3:2/3to2/2:2/2to2/1:2/1to2/0:2/0to3/0:3/0to4/0:4/0to5/0:5/0to6/0:6/0to7/0:7/0to8/0:8/0tobottom8:,11,False,True
2419,579,769,190,7/13to6/13,0/7to1/7,7/13to6/13:6/13to5/13:5/13to4/13:4/13to3/13:3/13to2/13:2/13to1/13:1/13to0/13:0/13to0/12:0/12to0/11:0/11to0/10:0/10to0/9:0/9to0/8:0/8to0/7:0/7to1/7:,14,True,True
2470,579,639,60,7/1to7/2,10/2to10/1,7/1to7/2:7/2to8/2:8/2to9/2:9/2to10/2:10/2to10/1:,5,True,True
1473,580,923,343,1/3to2/3,14/13to15/13,1/3to2/3:2/3to3/3:3/3to4/3:4/3to5/3:5/3to6/3:6/3to7/3:7/3to8/3:8/3to9/3:9/3to10/3:10/3to10/4:10/4to10/5:10/5to10/6:10/6to10/7:10/7to10/8:10/8to10/9:10/9to10/10:10/10to10/11:10/11to10/12:10/12to10/13:10/13to11/13:11/13to12/13:12/13to13/13:13/13to14/13:14/13to15/13:,24,False,True
706,580,609,29,15/2to15/1,15/0toright0,15/2to15/1:15/1to15/0:15/0toright0:,3,False,True
681,580,720,140,6/12to6/11,8/4to8/3,6/12to6/11:6/11to6/10:6/10to6/9:6/9to6/8:6/8to6/7:6/7to6/6:6/6to6/5:6/5to6/4:6/4to7/4:7/4to8/4:8/4to8/3:,11,False,True
934,580,870,290,3/0to3/1,11/2to12/2,3/0to3/1:3/1to4/1:4/1to5/1:5/1to6/1:6/1to7/1:7/1to8/1:8/1to9/1:9/1to10/1:10/1to10/2:10/2to11/2:11/2to12/2:,11,False,True
3254,580,683,103,3/6to3/5,5/1to6/1,3/6to3/5:3/5to3/4:3/4to3/3:3/3to3/2:3/2to3/1:3/1to4/1:4/1to5/1:5/1to6/1:,8,False,True
1920,581,650,69,8/11to8/10,7/13to7/14,8/11to8/10:8/10to7/10:7/10to7/11:7/11to7/12:7/12to7/13:7/13to7/14:,6,False,True
104,581,976,395,left0to0/0,15/15totop15,left0to0/0:0/0to0/1:0/1to0/2:0/2to0/3:0/3to0/4:0/4to0/5:0/5to0/6:0/6to0/7:0/7to0/8:0/8to0/9:0/9to0/10:0/10to0/11:0/11to0/12:0/12to0/13:0/13to0/14:0/14to1/14:1/14to2/14:2/14to3/14:3/14to4/14:4/14to5/14:5/14to6/14:6/14to7/14:7/14to8/14:8/14to9/14:9/14to10/14:10/14to10/15:10/15to11/15:11/15to12/15:12/15to13/15:13/15to14/15:14/15to15/15:15/15totop15:,32,True,True
1166,581,678,97,4/13to5/13,10/13to10/12,4/13to5/13:5/13to6/13:6/13to7/13:7/13to8/13:8/13to9/13:9/13to10/13:10/13to10/12:,7,False,True
714,581,738,157,2/2to3/2,6/10to6/9,2/2to3/2:3/2to3/3:3/3to3/4:3/4to3/5:3/5to3/6:3/6to3/7:3/7to3/8:3/8to3/9:3/9to3/10:3/10to4/10:4/10to5/10:5/10to6/10:6/10to6/9:,13,True,True
2519,581,627,46,13/14to12/14,11/15to12/15,13/14to12/14:12/14to11/14:11/14to11/15:11/15to12/15:,4,False,True
506,582,640,58,6/9to5/9,5/12to5/13,6/9to5/9:5/9to5/10:5/10to5/11:5/11to5/12:5/12to5/13:,5,True,True
1591,582,808,226,2/10to2/11,10/6to9/6,2/10to2/11:2/11to3/11:3/11to4/11:4/11to5/11:5/11to6/11:6/11to7/11:7/11to8/11:8/11to9/11:9/11to10/11:10/11to10/10:10/10to10/9:10/9to10/8:10/8to10/7:10/7to10/6:10/6to9/6:,15,False,True
819,582,810,228,9/6to9/7,0/3toleft3,9/6to9/7:9/7to8/7:8/7to7/7:7/7to6/7:6/7to5/7:5/7to4/7:4/7to3/7:3/7to2/7:2/7to1/7:1/7to0/7:0/7to0/6:0/6to0/5:0/5to0/4:0/4to0/3:0/3toleft3:,15,True,True
108,583,961,378,left0to0/0,15/15totop15,left0to0/0:0/0to1/0:1/0to2/0:2/0to3/0:3/0to4/0:4/0to5/0:5/0to6/0:6/0to7/0:7/0to8/0:8/0to9/0:9/0to10/0:10/0to10/1:10/1to10/2:10/2to10/3:10/3to10/4:10/4to10/5:10/5to10/6:10/6to10/7:10/7to10/8:10/8to10/9:10/9to10/10:10/10to10/11:10/11to10/12:10/12to10/13:10/13to10/14:10/14to10/15:10/15to11/15:11/15to12/15:12/15to13/15:13/15to14/15:14/15to15/15:15/15totop15:,32,False,True
1761,584,640,56,6/11to6/12,6/15to7/15,6/11to6/12:6/12to6/13:6/13to6/14:6/14to6/15:6/15to7/15:,5,False,True
1059,584,709,125,6/7to5/7,2/4to2/3,6/7to5/7:5/7to4/7:4/7to3/7:3/7to2/7:2/7to2/6:2/6to2/5:2/5to2/4:2/4to2/3:,8,False,True
490,585,905,320,3/4to3/5,13/13to14/13,3/4to3/5:3/5to3/6:3/6to3/7:3/7to3/8:3/8to3/9:3/9to3/10:3/10to3/11:3/11to4/11:4/11to5/11:5/11to6/11:6/11to7/11:7/11to8/11:8/11to9/11:9/11to10/11:10/11to10/12:10/12to11/12:11/12to12/12:12/12to12/13:12/13to13/13:13/13to14/13:,20,True,True
675,585,926,341,12/7to11/7,3/2to4/2,12/7to11/7:11/7to11/6:11/6to10/6:10/6to9/6:9/6to8/6:8/6to7/6:7/6to6/6:6/6to5/6:5/6to4/6:4/6to3/6:3/6to3/5:3/5to3/4:3/4to3/3:3/3to3/2:3/2to4/2:,15,True,True
1762,585,643,58,4/5to3/5,2/6to1/6,4/5to3/5:3/5to2/5:2/5to2/6:2/6to1/6:,4,True,True
2223,586,752,166,9/2to10/2,13/8to14/8,9/2to10/2:10/2to11/2:11/2to11/3:11/3to11/4:11/4to11/5:11/5to11/6:11/6to11/7:11/7to11/8:11/8to12/8:12/8to13/8:13/8to14/8:,11,True,True
310,586,1017,431,right0to15/0,0/15totop0,right0to15/0:15/0to14/0:14/0to13/0:13/0to12/0:12/0to11/0:11/0to11/1:11/1to10/1:10/1to9/1:9/1to8/1:8/1to7/1:7/1to6/1:6/1to5/1:5/1to4/1:4/1to3/1:3/1to2/1:2/1to1/1:1/1to0/1:0/1to0/2:0/2to0/3:0/3to0/4:0/4to0/5:0/5to0/6:0/6to0/7:0/7to0/8:0/8to0/9:0/9to0/10:0/10to0/11:0/11to0/12:0/12to0/13:0/13to0/14:0/14to0/15:0/15totop0:,32,True,True
1363,586,822,236,6/1to6/0,14/9to15/9,6/1to6/0:6/0to7/0:7/0to8/0:8/0to9/0:9/0to10/0:10/0to10/1:10/1to10/2:10/2to10/3:10/3to10/4:10/4to10/5:10/5to10/6:10/6to10/7:10/7to10/8:10/8to10/9:10/9to11/9:11/9to12/9:12/9to13/9:13/9to14/9:14/9to15/9:,19,False,True
2283,586,746,160,8/9to8/8,1/7to2/7,8/9to8/8:8/8to7/8:7/8to6/8:6/8to5/8:5/8to4/8:4/8to3/8:3/8to2/8:2/8to1/8:1/8to1/7:1/7to2/7:,10,True,True
1215,586,686,100,4/6to4/5,9/5to9/4,4/6to4/5:4/5to5/5:5/5to6/5:6/5to7/5:7/5to8/5:8/5to9/5:9/5to9/4:,7,True,True
1881,587,874,287,9/4to10/4,9/10to8/10,9/4to10/4:10/4to10/5:10/5to11/5:11/5to11/6:11/6to11/7:11/7to11/8:11/8to11/9:11/9to11/10:11/10to10/10:10/10to9/10:9/10to8/10:,11,True,True
458,587,815,228,13/13to12/13,6/4to6/3,13/13to12/13:12/13to12/12:12/12to11/12:11/12to10/12:10/12to9/12:9/12to8/12:8/12to7/12:7/12to6/12:6/12to6/11:6/11to6/10:6/10to6/9:6/9to6/8:6/8to6/7:6/7to6/6:6/6to6/5:6/5to6/4:6/4to6/3:,17,True,True
2903,587,866,279,0/10to0/11,10/14to10/15,0/10to0/11:0/11to1/11:1/11to2/11:2/11to3/11:3/11to4/11:4/11to5/11:5/11to6/11:6/11to7/11:7/11to8/11:8/11to9/11:9/11to10/11:10/11to10/12:10/12to10/13:10/13to10/14:10/14to10/15:,15,False,True
969,587,670,83,left2to0/2,3/3to4/3,left2to0/2:0/2to0/3:0/3to1/3:1/3to2/3:2/3to3/3:3/3to4/3:,6,False,True
63,587,964,377,left15to0/15,15/0tobottom15,left15to0/15:0/15to1/15:1/15to2/15:2/15to3/15:3/15to4/15:4/15to5/15:5/15to6/15:6/15to7/15:7/15to8/15:8/15to9/15:9/15to10/15:10/15to10/14:10/14to10/13:10/13to10/12:10/12to10/11:10/11to10/10:10/10to10/9:10/9to10/8:10/8to10/7:10/7to10/6:10/6to10/5:10/5to10/4:10/4to10/3:10/3to10/2:10/2to10/1:10/1to10/0:10/0to11/0:11/0to12/0:12/0to13/0:13/0to14/0:14/0to15/0:15/0tobottom15:,32,False,True
207,587,963,376,right15to15/15,0/0tobottom0,right15to15/15:15/15to14/15:14/15to13/15:13/15to12/15:12/15to11/15:11/15to10/15:10/15to9/15:9/15to8/15:8/15to7/15:7/15to6/15:6/15to5/15:5/15to4/15:4/15to3/15:3/15to2/15:2/15to1/15:1/15to0/15:0/15to0/14:0/14to0/13:0/13to0/12:0/12to0/11:0/11to0/10:0/10to0/9:0/9to0/8:0/8to0/7:0/7to0/6:0/6to0/5:0/5to0/4:0/4to0/3:0/3to0/2:0/2to0/1:0/1to0/0:0/0tobottom0:,32,True,True
54,587,971,384,left15to0/15,15/0tobottom15,left15to0/15:0/15to1/15:1/15to2/15:2/15to3/15:3/15to4/15:4/15to5/15:5/15to6/15:6/15to7/15:7/15to8/15:8/15to9/15:9/15to10/15:10/15to10/14:10/14to10/13:10/13to10/12:10/12to10/11:10/11to10/10:10/10to10/9:10/9to10/8:10/8to10/7:10/7to10/6:10/6to10/5:10/5to10/4:10/4to10/3:10/3to10/2:10/2to10/1:10/1to10/0:10/0to11/0:11/0to12/0:12/0to13/0:13/0to14/0:14/0to15/0:15/0tobottom15:,32,False,True
654,588,922,334,bottom5to5/0,14/9to14/8,bottom5to5/0:5/0to5/1:5/1to5/2:5/2to5/3:5/3to5/4:5/4to5/5:5/5to5/6:5/6to5/7:5/7to5/8:5/8to6/8:6/8to7/8:7/8to8/8:8/8to9/8:9/8to10/8:10/8to10/9:10/9to11/9:11/9to12/9:12/9to13/9:13/9to14/9:14/9to14/8:,20,True,True
1043,588,667,79,11/4to11/5,15/6toright6,11/4to11/5:11/5to11/6:11/6to12/6:12/6to13/6:13/6to14/6:14/6to15/6:15/6toright6:,7,True,True
244,589,1002,413,right15to15/15,0/0tobottom0,right15to15/15:15/15to14/15:14/15to13/15:13/15to12/15:12/15to11/15:11/15to11/14:11/14to10/14:10/14to9/14:9/14to8/14:8/14to7/14:7/14to6/14:6/14to5/14:5/14to4/14:4/14to3/14:3/14to2/14:2/14to1/14:1/14to0/14:0/14to0/13:0/13to0/12:0/12to0/11:0/11to0/10:0/10to0/9:0/9to0/8:0/8to0/7:0/7to0/6:0/6to0/5:0/5to0/4:0/4to0/3:0/3to0/2:0/2to0/1:0/1to0/0:0/0tobottom0:,32,True,True
911,589,709,120,13/1to13/2,15/9toright9,13/1to13/2:13/2to13/3:13/3to13/4:13/4to13/5:13/5to13/6:13/6to13/7:13/7to13/8:13/8to13/9:13/9to14/9:14/9to15/9:15/9toright9:,11,False,True
1037,589,735,146,9/8to10/8,14/3to15/3,9/8to10/8:10/8to10/7:10/7to10/6:10/6to10/5:10/5to10/4:10/4to10/3:10/3to11/3:11/3to12/3:12/3to13/3:13/3to14/3:14/3to15/3:,11,False,True
786,589,768,179,4/4to5/4,13/0to14/0,4/4to5/4:5/4to5/3:5/3to5/2:5/2to5/1:5/1to5/0:5/0to6/0:6/0to7/0:7/0to8/0:8/0to9/0:9/0to10/0:10/0to11/0:11/0to12/0:12/0to13/0:13/0to14/0:,14,True,True
2234,589,695,106,7/6to8/6,8/13to8/14,7/6to8/6:8/6to8/7:8/7to8/8:8/8to8/9:8/9to8/10:8/10to8/11:8/11to8/12:8/12to8/13:8/13to8/14:,9,False,True
515,590,832,242,14/5to14/4,3/4to3/3,14/5to14/4:14/4to13/4:13/4to12/4:12/4to11/4:11/4to10/4:10/4to9/4:9/4to8/4:8/4to7/4:7/4to6/4:6/4to5/4:5/4to4/4:4/4to3/4:3/4to3/3:,13,False,True
1500,590,906,316,3/15to4/15,15/3toright3,3/15to4/15:4/15to4/14:4/14to4/13:4/13to4/12:4/12to4/11:4/11to4/10:4/10to4/9:4/9to4/8:4/8to4/7:4/7to4/6:4/6to4/5:4/5to5/5:5/5to6/5:6/5to7/5:7/5to8/5:8/5to9/5:9/5to10/5:10/5to10/4:10/4to11/4:11/4to11/3:11/3to12/3:12/3to13/3:13/3to14/3:14/3to15/3:15/3toright3:,25,True,True
1991,590,693,103,12/6to12/7,12/14to12/15,12/6to12/7:12/7to12/8:12/8to12/9:12/9to12/10:12/10to12/11:12/11to12/12:12/12to12/13:12/13to12/14:12/14to12/15:,9,True,True
1100,590,817,227,top12to12/15,0/10to0/9,top12to12/15:12/15to11/15:11/15to10/15:10/15to9/15:9/15to8/15:8/15to7/15:7/15to6/15:6/15to5/15:5/15to4/15:4/15to3/15:3/15to2/15:2/15to1/15:1/15to0/15:0/15to0/14:0/14to0/13:0/13to0/12:0/12to0/11:0/11to0/10:0/10to0/9:,19,True,True
3252,591,747,156,7/15to8/15,10/6to10/5,7/15to8/15:8/15to8/14:8/14to8/13:8/13to8/12:8/12to8/11:8/11to8/10:8/10to8/9:8/9to8/8:8/8to9/8:9/8to10/8:10/8to10/7:10/7to10/6:10/6to10/5:,13,True,True
2682,591,685,94,12/13to11/13,6/13to5/13,12/13to11/13:11/13to10/13:10/13to9/13:9/13to8/13:8/13to7/13:7/13to6/13:6/13to5/13:,7,True,True
262,591,971,380,right15to15/15,0/0tobottom0,right15to15/15:15/15to14/15:14/15to13/15:13/15to12/15:12/15to11/15:11/15to10/15:10/15to9/15:9/15to8/15:8/15to7/15:7/15to6/15:6/15to5/15:5/15to4/15:4/15to3/15:3/15to2/15:2/15to1/15:1/15to0/15:0/15to0/14:0/14to0/13:0/13to0/12:0/12to0/11:0/11to0/10:0/10to0/9:0/9to0/8:0/8to0/7:0/7to0/6:0/6to0/5:0/5to0/4:0/4to0/3:0/3to0/2:0/2to0/1:0/1to0/0:0/0tobottom0:,32,False,True
902,591,697,106,3/4to3/5,4/10to4/11,3/4to3/5:3/5to3/6:3/6to3/7:3/7to3/8:3/8to3/9:3/9to3/10:3/10to4/10:4/10to4/11:,8,False,True
2429,592,887,295,13/15to13/14,4/1to4/0,13/15to13/14:13/14to12/14:12/14to11/14:11/14to10/14:10/14to9/14:9/14to8/14:8/14to7/14:7/14to6/14:6/14to5/14:5/14to4/14:4/14to4/13:4/13to4/12:4/12to4/11:4/11to4/10:4/10to4/9:4/9to4/8:4/8to4/7:4/7to4/6:4/6to4/5:4/5to4/4:4/4to4/3:4/3to4/2:4/2to4/1:4/1to4/0:,24,False,True
2914,592,714,122,12/6to11/6,11/15totop11,12/6to11/6:11/6to11/7:11/7to11/8:11/8to11/9:11/9to11/10:11/10to11/11:11/11to11/12:11/12to11/13:11/13to11/14:11/14to11/15:11/15totop11:,11,False,True
627,592,668,76,2/7to1/7,2/4to3/4,2/7to1/7:1/7to1/6:1/6to1/5:1/5to1/4:1/4to2/4:2/4to3/4:,6,False,True
1440,593,805,212,4/9to5/9,14/4to14/3,4/9to5/9:5/9to6/9:6/9to7/9:7/9to8/9:8/9to9/9:9/9to10/9:10/9to10/8:10/8to10/7:10/7to10/6:10/6to10/5:10/5to10/4:10/4to11/4:11/4to12/4:12/4to13/4:13/4to14/4:14/4to14/3:,16,False,True
1660,593,651,58,14/7to14/6,13/8to12/8,14/7to14/6:14/6to13/6:13/6to13/7:13/7to13/8:13/8to12/8:,5,False,True
235,595,1016,421,right15to15/15,0/0tobottom0,right15to15/15:15/15to14/15:14/15to13/15:13/15to12/15:12/15to11/15:11/15to11/14:11/14to10/14:10/14to9/14:9/14to8/14:8/14to7/14:7/14to6/14:6/14to5/14:5/14to4/14:4/14to3/14:3/14to2/14:2/14to1/14:1/14to0/14:0/14to0/13:0/13to0/12:0/12to0/11:0/11to0/10:0/10to0/9:0/9to0/8:0/8to0/7:0/7to0/6:0/6to0/5:0/5to0/4:0/4to0/3:0/3to0/2:0/2to0/1:0/1to0/0:0/0tobottom0:,32,True,True
983,595,833,238,2/10to2/9,10/0to11/0,2/10to2/9:2/9to2/8:2/8to2/7:2/7to2/6:2/6to2/5:2/5to2/4:2/4to2/3:2/3to2/2:2/2to2/1:2/1to2/0:2/0to3/0:3/0to4/0:4/0to5/0:5/0to6/0:6/0to7/0:7/0to8/0:8/0to9/0:9/0to10/0:10/0to11/0:,19,True,True
323,596,1085,489,right0to15/0,0/15totop0,right0to15/0:15/0to14/0:14/0to13/0:13/0to12/0:12/0to11/0:11/0to11/1:11/1to10/1:10/1to9/1:9/1to8/1:8/1to7/1:7/1to6/1:6/1to5/1:5/1to4/1:4/1to3/1:3/1to2/1:2/1to1/1:1/1to0/1:0/1to0/2:0/2to0/3:0/3to0/4:0/4to0/5:0/5to0/6:0/6to0/7:0/7to0/8:0/8to0/9:0/9to0/10:0/10to0/11:0/11to0/12:0/12to0/13:0/13to0/14:0/14to0/15:0/15totop0:,32,True,True
2921,596,782,186,5/14to6/14,10/5to10/4,5/14to6/14:6/14to7/14:7/14to8/14:8/14to9/14:9/14to10/14:10/14to10/13:10/13to10/12:10/12to10/11:10/11to10/10:10/10to10/9:10/9to10/8:10/8to10/7:10/7to10/6:10/6to10/5:10/5to10/4:,15,False,True
426,596,818,222,10/13to10/14,1/7to0/7,10/13to10/14:10/14to9/14:9/14to8/14:8/14to7/14:7/14to6/14:6/14to5/14:5/14to4/14:4/14to3/14:3/14to2/14:2/14to1/14:1/14to1/13:1/13to1/12:1/12to1/11:1/11to1/10:1/10to1/9:1/9to1/8:1/8to1/7:1/7to0/7:,18,True,True
2044,597,845,248,2/8to2/9,12/2to12/3,2/8to2/9:2/9to2/8:2/8to2/7:2/7to2/6:2/6to2/5:2/5to2/4:2/4to2/3:2/3to2/2:2/2to3/2:3/2to4/2:4/2to5/2:5/2to6/2:6/2to7/2:7/2to8/2:8/2to9/2:9/2to10/2:10/2to11/2:11/2to12/2:12/2to12/3:,19,True,True
2411,597,854,257,0/14to1/14,9/3to9/2,0/14to1/14:1/14to1/13:1/13to1/12:1/12to1/11:1/11to1/10:1/10to1/9:1/9to1/8:1/8to1/7:1/7to1/6:1/6to1/5:1/5to1/4:1/4to1/3:1/3to2/3:2/3to3/3:3/3to4/3:4/3to5/3:5/3to6/3:6/3to7/3:7/3to8/3:8/3to9/3:9/3to9/2:,21,True,True
1805,597,773,176,14/3to13/3,11/14to10/14,14/3to13/3:13/3to12/3:12/3to11/3:11/3to11/4:11/4to11/5:11/5to11/6:11/6to11/7:11/7to11/8:11/8to11/9:11/9to11/10:11/10to11/11:11/11to11/12:11/12to11/13:11/13to11/14:11/14to10/14:,15,True,True
704,597,819,222,right8to15/8,9/3to9/2,right8to15/8:15/8to14/8:14/8to13/8:13/8to12/8:12/8to11/8:11/8to10/8:10/8to10/7:10/7to10/6:10/6to10/5:10/5to10/4:10/4to10/3:10/3to9/3:9/3to9/2:,13,False,True
3083,597,1117,520,right6to15/6,0/15totop0,right6to15/6:15/6to14/6:14/6to13/6:13/6to12/6:12/6to11/6:11/6to10/6:10/6to9/6:9/6to8/6:8/6to7/6:7/6to6/6:6/6to5/6:5/6to4/6:4/6to3/6:3/6to2/6:2/6to1/6:1/6to0/6:0/6to0/7:0/7to0/8:0/8to0/9:0/9to0/10:0/10to0/11:0/11to0/12:0/12to0/13:0/13to0/14:0/14to0/15:0/15totop0:,26,True,True
1209,598,761,163,13/5to13/4,8/11to9/11,13/5to13/4:13/4to12/4:12/4to11/4:11/4to10/4:10/4to9/4:9/4to8/4:8/4to8/5:8/5to8/6:8/6to8/7:8/7to8/8:8/8to8/9:8/9to8/10:8/10to8/11:8/11to9/11:,14,False,True
1098,599,823,224,14/14to13/14,7/5to6/5,14/14to13/14:13/14to12/14:12/14to11/14:11/14to10/14:10/14to9/14:9/14to8/14:8/14to7/14:7/14to7/13:7/13to7/12:7/12to7/11:7/11to7/10:7/10to7/9:7/9to7/8:7/8to7/7:7/7to7/6:7/6to7/5:7/5to6/5:,17,True,True
900,599,733,134,5/4to5/3,0/0to1/0,5/4to5/3:5/3to4/3:4/3to3/3:3/3to2/3:2/3to1/3:1/3to0/3:0/3to0/2:0/2to0/1:0/1to0/0:0/0to1/0:,10,True,True
1609,599,722,123,left12to0/12,4/15totop4,left12to0/12:0/12to0/13:0/13to0/14:0/14to0/15:0/15to1/15:1/15to2/15:2/15to3/15:3/15to4/15:4/15totop4:,9,False,True
1935,600,684,84,9/5to10/5,10/0to11/0,9/5to10/5:10/5to10/4:10/4to10/3:10/3to10/2:10/2to10/1:10/1to10/0:10/0to11/0:,7,False,True
211,600,990,390,right15to15/15,0/0tobottom0,right15to15/15:15/15to14/15:14/15to13/15:13/15to12/15:12/15to11/15:11/15to10/15:10/15to9/15:9/15to8/15:8/15to7/15:7/15to6/15:6/15to5/15:5/15to4/15:4/15to3/15:3/15to2/15:2/15to1/15:1/15to0/15:0/15to0/14:0/14to0/13:0/13to0/12:0/12to0/11:0/11to0/10:0/10to0/9:0/9to0/8:0/8to0/7:0/7to0/6:0/6to0/5:0/5to0/4:0/4to0/3:0/3to0/2:0/2to0/1:0/1to0/0:0/0tobottom0:,32,True,True
3239,600,709,109,15/15to15/14,11/11to12/11,15/15to15/14:15/14to14/14:14/14to13/14:13/14to12/14:12/14to12/13:12/13to12/12:12/12to11/12:11/12to11/11:11/11to12/11:,9,True,True
1229,600,799,199,12/1to11/1,1/1to0/1,12/1to11/1:11/1to11/0:11/0to10/0:10/0to9/0:9/0to8/0:8/0to7/0:7/0to6/0:6/0to5/0:5/0to4/0:4/0to3/0:3/0to2/0:2/0to1/0:1/0to1/1:1/1to0/1:,14,True,True
749,600,780,180,11/11to10/11,8/6to8/5,11/11to10/11:10/11to9/11:9/11to8/11:8/11to8/10:8/10to8/9:8/9to8/8:8/8to8/7:8/7to8/6:8/6to8/5:,9,False,True
1721,600,879,279,bottom9to9/0,13/11to14/11,bottom9to9/0:9/0to9/1:9/1to9/2:9/2to9/3:9/3to9/4:9/4to9/5:9/5to9/6:9/6to9/7:9/7to9/8:9/8to9/9:9/9to9/10:9/10to9/11:9/11to10/11:10/11to11/11:11/11to12/11:12/11to13/11:13/11to14/11:,17,True,True
1715,601,643,42,3/4to2/4,2/3to2/2,3/4to2/4:2/4to2/3:2/3to2/2:,3,False,True
2568,601,896,295,15/7to14/7,2/2to2/1,15/7to14/7:14/7to13/7:13/7to12/7:12/7to11/7:11/7to10/7:10/7to9/7:9/7to8/7:8/7to7/7:7/7to6/7:6/7to5/7:5/7to4/7:4/7to3/7:3/7to2/7:2/7to2/6:2/6to2/5:2/5to2/4:2/4to2/3:2/3to2/2:2/2to2/1:,19,False,True
2808,602,879,277,9/11to9/12,0/0toleft0,9/11to9/12:9/12to8/12:8/12to7/12:7/12to6/12:6/12to5/12:5/12to4/12:4/12to3/12:3/12to2/12:2/12to1/12:1/12to0/12:0/12to0/11:0/11to0/10:0/10to0/9:0/9to0/8:0/8to0/7:0/7to0/6:0/6to0/5:0/5to0/4:0/4to0/3:0/3to0/2:0/2to0/1:0/1to0/0:0/0toleft0:,23,False,True
3236,602,723,121,2/3to1/3,0/10to1/10,2/3to1/3:1/3to0/3:0/3to0/4:0/4to0/5:0/5to0/6:0/6to0/7:0/7to0/8:0/8to0/9:0/9to0/10:0/10to1/10:,10,False,True
891,602,820,218,13/2to13/1,10/15to11/15,13/2to13/1:13/1to12/1:12/1to11/1:11/1to10/1:10/1to10/2:10/2to10/3:10/3to10/4:10/4to10/5:10/5to10/6:10/6to10/7:10/7to10/8:10/8to10/9:10/9to10/10:10/10to10/11:10/11to10/12:10/12to10/13:10/13to10/14:10/14to10/15:10/15to11/15:,19,False,True
23,602,979,377,left15to0/15,15/0tobottom15,left15to0/15:0/15to1/15:1/15to2/15:2/15to3/15:3/15to4/15:4/15to5/15:5/15to6/15:6/15to7/15:7/15to8/15:8/15to9/15:9/15to10/15:10/15to10/14:10/14to10/13:10/13to10/12:10/12to10/11:10/11to10/10:10/10to10/9:10/9to10/8:10/8to10/7:10/7to10/6:10/6to10/5:10/5to10/4:10/4to10/3:10/3to10/2:10/2to10/1:10/1to10/0:10/0to11/0:11/0to12/0:12/0to13/0:13/0to14/0:14/0to15/0:15/0tobottom15:,32,False,True
1780,602,826,224,1/8to2/8,11/15totop11,1/8to2/8:2/8to3/8:3/8to4/8:4/8to5/8:5/8to6/8:6/8to7/8:7/8to8/8:8/8to9/8:9/8to10/8:10/8to10/9:10/9to10/10:10/10to10/11:10/11to10/12:10/12to10/13:10/13to10/14:10/14to10/15:10/15to11/15:11/15totop11:,18,False,True
2970,604,825,221,14/15to13/15,6/6to5/6,14/15to13/15:13/15to12/15:12/15to11/15:11/15to10/15:10/15to9/15:9/15to8/15:8/15to7/15:7/15to6/15:6/15to6/14:6/14to6/13:6/13to6/12:6/12to6/11:6/11to6/10:6/10to6/9:6/9to6/8:6/8to6/7:6/7to6/6:6/6to5/6:,18,True,True
1781,604,997,393,5/8to5/7,10/8to11/8,5/8to5/7:5/7to6/7:6/7to7/7:7/7to8/7:8/7to9/7:9/7to10/7:10/7to10/8:10/8to11/8:,8,True,True
3303,604,840,236,10/5to9/5,1/13to2/13,10/5to9/5:9/5to8/5:8/5to7/5:7/5to6/5:6/5to5/5:5/5to4/5:4/5to3/5:3/5to2/5:2/5to1/5:1/5to1/6:1/6to1/7:1/7to1/8:1/8to1/9:1/9to1/10:1/10to1/11:1/11to1/12:1/12to1/13:1/13to2/13:,18,True,True
372,604,1096,492,right0to15/0,0/15totop0,right0to15/0:15/0to14/0:14/0to13/0:13/0to12/0:12/0to11/0:11/0to11/1:11/1to10/1:10/1to9/1:9/1to8/1:8/1to7/1:7/1to6/1:6/1to5/1:5/1to4/1:4/1to3/1:3/1to2/1:2/1to1/1:1/1to0/1:0/1to0/2:0/2to0/3:0/3to0/4:0/4to0/5:0/5to0/6:0/6to0/7:0/7to0/8:0/8to0/9:0/9to0/10:0/10to0/11:0/11to0/12:0/12to0/13:0/13to0/14:0/14to0/15:0/15totop0:,32,True,True
1367,604,961,357,6/5to6/4,10/7to10/8,6/5to6/4:6/4to7/4:7/4to8/4:8/4to9/4:9/4to10/4:10/4to10/5:10/5to10/6:10/6to10/7:10/7to10/8:,9,False,True
1677,605,779,174,5/9to5/10,13/9to13/8,5/9to5/10:5/10to6/10:6/10to7/10:7/10to8/10:8/10to9/10:9/10to10/10:10/10to11/10:11/10to11/9:11/9to12/9:12/9to13/9:13/9to13/8:,11,True,True
907,605,688,83,6/11to6/12,11/12to11/11,6/11to6/12:6/12to7/12:7/12to8/12:8/12to9/12:9/12to10/12:10/12to11/12:11/12to11/11:,7,True,True
38,605,983,378,left15to0/15,15/0tobottom15,left15to0/15:0/15to1/15:1/15to2/15:2/15to3/15:3/15to4/15:4/15to5/15:5/15to6/15:6/15to7/15:7/15to8/15:8/15to9/15:9/15to10/15:10/15to10/14:10/14to10/13:10/13to10/12:10/12to10/11:10/11to10/10:10/10to10/9:10/9to10/8:10/8to10/7:10/7to10/6:10/6to10/5:10/5to10/4:10/4to10/3:10/3to10/2:10/2to10/1:10/1to10/0:10/0to11/0:11/0to12/0:12/0to13/0:13/0to14/0:14/0to15/0:15/0tobottom15:,32,False,True
3383,606,683,77,5/9to5/8,3/6to3/5,5/9to5/8:5/8to4/8:4/8to3/8:3/8to3/7:3/7to3/6:3/6to3/5:,6,True,True
1120,606,812,206,10/10to10/9,4/0tobottom4,10/10to10/9:10/9to9/9:9/9to8/9:8/9to7/9:7/9to6/9:6/9to5/9:5/9to4/9:4/9to4/8:4/8to4/7:4/7to4/6:4/6to4/5:4/5to4/4:4/4to4/3:4/3to4/2:4/2to4/1:4/1to4/0:4/0tobottom4:,17,True,True
1499,606,699,93,8/9to9/9,11/10to11/11,8/9to9/9:9/9to9/10:9/10to10/10:10/10to11/10:11/10to11/11:,5,True,True
721,607,642,35,8/11to8/10,8/9to8/8,8/11to8/10:8/10to8/9:8/9to8/8:,3,False,True
3081,608,943,335,15/5to14/5,4/14to5/14,15/5to14/5:14/5to13/5:13/5to12/5:12/5to11/5:11/5to10/5:10/5to9/5:9/5to8/5:8/5to7/5:7/5to6/5:6/5to5/5:5/5to4/5:4/5to4/6:4/6to4/7:4/7to4/8:4/8to4/9:4/9to4/10:4/10to4/11:4/11to4/12:4/12to4/13:4/13to4/14:4/14to5/14:,21,True,True
1474,608,712,104,7/8to8/8,11/6to11/7,7/8to8/8:8/8to8/7:8/7to8/6:8/6to9/6:9/6to10/6:10/6to11/6:11/6to11/7:,7,True,True
3120,608,1085,477,8/6to9/6,12/15totop12,8/6to9/6:9/6to9/7:9/7to10/7:10/7to10/8:10/8to11/8:11/8to11/9:11/9to11/10:11/10to11/11:11/11to11/12:11/12to11/13:11/13to11/14:11/14to11/15:11/15to12/15:12/15totop12:,14,True,True
3182,608,671,63,8/13to7/13,4/13to4/14,8/13to7/13:7/13to6/13:6/13to5/13:5/13to4/13:4/13to4/14:,5,True,True
2482,609,807,198,14/12to14/11,9/2to9/3,14/12to14/11:14/11to13/11:13/11to12/11:12/11to12/10:12/10to12/9:12/9to12/8:12/8to12/7:12/7to12/6:12/6to12/5:12/5to12/4:12/4to12/3:12/3to11/3:11/3to10/3:10/3to10/2:10/2to9/2:9/2to9/3:,16,True,True
2588,610,936,326,left8to0/8,15/7to15/6,left8to0/8:0/8to1/8:1/8to2/8:2/8to3/8:3/8to4/8:4/8to5/8:5/8to6/8:6/8to7/8:7/8to8/8:8/8to9/8:9/8to10/8:10/8to10/7:10/7to11/7:11/7to12/7:12/7to13/7:13/7to14/7:14/7to15/7:15/7to15/6:,18,False,True
2312,610,771,161,10/10to10/11,3/8to3/7,10/10to10/11:10/11to9/11:9/11to8/11:8/11to7/11:7/11to6/11:6/11to5/11:5/11to4/11:4/11to3/11:3/11to3/10:3/10to3/9:3/9to3/8:3/8to3/7:,12,True,True
2801,610,907,297,2/1to3/1,11/6to11/5,2/1to3/1:3/1to3/2:3/2to3/3:3/3to3/4:3/4to3/5:3/5to4/5:4/5to5/5:5/5to6/5:6/5to7/5:7/5to8/5:8/5to9/5:9/5to10/5:10/5to10/6:10/6to11/6:11/6to11/5:,15,True,True
1785,611,713,102,14/10to14/9,12/14to13/14,14/10to14/9:14/9to13/9:13/9to12/9:12/9to12/10:12/10to12/11:12/11to12/12:12/12to12/13:12/13to12/14:12/14to13/14:,9,False,True
1813,611,798,187,13/4to12/4,4/3to4/2,13/4to12/4:12/4to11/4:11/4to10/4:10/4to9/4:9/4to8/4:8/4to7/4:7/4to6/4:6/4to5/4:5/4to4/4:4/4to4/3:4/3to4/2:,11,False,True
1752,611,772,161,6/1to5/1,7/10to7/11,6/1to5/1:5/1to5/2:5/2to5/3:5/3to5/4:5/4to5/5:5/5to5/6:5/6to5/7:5/7to5/8:5/8to5/9:5/9to5/10:5/10to6/10:6/10to7/10:7/10to7/11:,13,False,True
405,611,660,49,15/11to15/12,15/15totop15,15/11to15/12:15/12to15/13:15/13to15/14:15/14to15/15:15/15totop15:,5,False,True
1521,611,706,95,5/9to5/10,3/7to3/6,5/9to5/10:5/10to4/10:4/10to3/10:3/10to3/9:3/9to3/8:3/8to3/7:3/7to3/6:,7,False,True
2386,611,740,129,top4to4/15,7/9to7/8,top4to4/15:4/15to4/14:4/14to4/13:4/13to4/12:4/12to4/11:4/11to4/10:4/10to4/9:4/9to5/9:5/9to6/9:6/9to7/9:7/9to7/8:,11,True,True
143,612,1021,409,left0to0/0,15/15totop15,left0to0/0:0/0to1/0:1/0to2/0:2/0to3/0:3/0to4/0:4/0to5/0:5/0to6/0:6/0to7/0:7/0to8/0:8/0to9/0:9/0to10/0:10/0to10/1:10/1to10/2:10/2to10/3:10/3to10/4:10/4to10/5:10/5to10/6:10/6to10/7:10/7to10/8:10/8to10/9:10/9to10/10:10/10to10/11:10/11to10/12:10/12to10/13:10/13to10/14:10/14to10/15:10/15to11/15:11/15to12/15:12/15to13/15:13/15to14/15:14/15to15/15:15/15totop15:,32,False,True
2783,613,637,24,13/8to13/7,13/7to13/6,13/8to13/7:13/7to13/6:,2,False,True
1776,613,742,129,3/6to2/6,4/0tobottom4,3/6to2/6:2/6to2/5:2/5to2/4:2/4to2/3:2/3to2/2:2/2to2/1:2/1to2/0:2/0to3/0:3/0to4/0:4/0tobottom4:,10,False,True
2758,613,767,154,8/9to8/10,10/1to10/0,8/9to8/10:8/10to9/10:9/10to10/10:10/10to10/9:10/9to10/8:10/8to10/7:10/7to10/6:10/6to10/5:10/5to10/4:10/4to10/3:10/3to10/2:10/2to10/1:10/1to10/0:,13,False,True
1667,613,888,275,1/0to2/0,11/7to12/7,1/0to2/0:2/0to2/1:2/1to2/2:2/2to2/3:2/3to2/4:2/4to2/5:2/5to2/6:2/6to2/7:2/7to3/7:3/7to4/7:4/7to5/7:5/7to6/7:6/7to7/7:7/7to8/7:8/7to9/7:9/7to10/7:10/7to11/7:11/7to12/7:,18,True,True
2966,613,651,38,9/15to8/15,8/14to8/13,9/15to8/15:8/15to8/14:8/14to8/13:,3,True,True
2500,614,979,365,15/6to15/5,1/7to1/8,15/6to15/5:15/5to14/5:14/5to13/5:13/5to12/5:12/5to11/5:11/5to10/5:10/5to9/5:9/5to8/5:8/5to7/5:7/5to6/5:6/5to5/5:5/5to4/5:4/5to3/5:3/5to2/5:2/5to1/5:1/5to1/6:1/6to1/7:1/7to1/8:,18,True,True
656,614,855,241,6/2to6/3,13/14to14/14,6/2to6/3:6/3to7/3:7/3to8/3:8/3to9/3:9/3to10/3:10/3to10/4:10/4to10/5:10/5to10/6:10/6to10/7:10/7to10/8:10/8to10/9:10/9to10/10:10/10to10/11:10/11to10/12:10/12to10/13:10/13to10/14:10/14to11/14:11/14to12/14:12/14to13/14:13/14to14/14:,20,False,True
1118,614,899,285,1/7to1/6,14/14to14/13,1/7to1/6:1/6to1/7:1/7to1/8:1/8to1/9:1/9to1/10:1/10to1/11:1/11to1/12:1/12to1/13:1/13to2/13:2/13to3/13:3/13to4/13:4/13to5/13:5/13to6/13:6/13to7/13:7/13to8/13:8/13to9/13:9/13to10/13:10/13to10/14:10/14to11/14:11/14to12/14:12/14to13/14:13/14to14/14:14/14to14/13:,23,True,True
2113,614,769,155,top15to15/15,12/8to11/8,top15to15/15:15/15to14/15:14/15to13/15:13/15to12/15:12/15to12/14:12/14to12/13:12/13to12/12:12/12to12/11:12/11to12/10:12/10to12/9:12/9to12/8:12/8to11/8:,12,False,True
1845,614,863,249,9/4to9/3,11/13to12/13,9/4to9/3:9/3to9/4:9/4to9/5:9/5to9/6:9/6to9/7:9/7to9/8:9/8to9/9:9/9to9/10:9/10to9/11:9/11to10/11:10/11to10/12:10/12to11/12:11/12to11/13:11/13to12/13:,14,True,True
3315,614,661,47,13/13to13/12,11/12to11/13,13/13to13/12:13/12to12/12:12/12to11/12:11/12to11/13:,4,True,True
160,615,985,370,left0to0/0,15/15totop15,left0to0/0:0/0to0/1:0/1to0/2:0/2to0/3:0/3to0/4:0/4to0/5:0/5to0/6:0/6to0/7:0/7to0/8:0/8to0/9:0/9to0/10:0/10to0/11:0/11to0/12:0/12to0/13:0/13to0/14:0/14to1/14:1/14to2/14:2/14to3/14:3/14to4/14:4/14to5/14:5/14to6/14:6/14to7/14:7/14to8/14:8/14to9/14:9/14to10/14:10/14to10/15:10/15to11/15:11/15to12/15:12/15to13/15:13/15to14/15:14/15to15/15:15/15totop15:,32,True,True
1902,615,978,363,0/9to1/9,10/10to10/11,0/9to1/9:1/9to1/10:1/10to2/10:2/10to3/10:3/10to4/10:4/10to5/10:5/10to6/10:6/10to7/10:7/10to8/10:8/10to9/10:9/10to10/10:10/10to10/11:,12,True,True
166,615,1037,422,left0to0/0,15/15totop15,left0to0/0:0/0to1/0:1/0to2/0:2/0to3/0:3/0to4/0:4/0to5/0:5/0to6/0:6/0to7/0:7/0to8/0:8/0to9/0:9/0to10/0:10/0to10/1:10/1to10/2:10/2to10/3:10/3to10/4:10/4to10/5:10/5to10/6:10/6to10/7:10/7to10/8:10/8to10/9:10/9to10/10:10/10to10/11:10/11to10/12:10/12to10/13:10/13to10/14:10/14to10/15:10/15to11/15:11/15to12/15:12/15to13/15:13/15to14/15:14/15to15/15:15/15totop15:,32,False,True
273,615,1021,406,right15to15/15,0/0tobottom0,right15to15/15:15/15to14/15:14/15to13/15:13/15to12/15:12/15to11/15:11/15to10/15:10/15to9/15:9/15to8/15:8/15to7/15:7/15to6/15:6/15to5/15:5/15to4/15:4/15to3/15:3/15to2/15:2/15to1/15:1/15to0/15:0/15to0/14:0/14to0/13:0/13to0/12:0/12to0/11:0/11to0/10:0/10to0/9:0/9to0/8:0/8to0/7:0/7to0/6:0/6to0/5:0/5to0/4:0/4to0/3:0/3to0/2:0/2to0/1:0/1to0/0:0/0tobottom0:,32,True,True
2177,615,765,150,4/7to5/7,8/15totop8,4/7to5/7:5/7to5/8:5/8to5/9:5/9to5/10:5/10to5/11:5/11to5/12:5/12to5/13:5/13to5/14:5/14to5/15:5/15to6/15:6/15to7/15:7/15to8/15:8/15totop8:,13,True,True
2327,617,876,259,right1to15/1,2/6to2/7,right1to15/1:15/1to14/1:14/1to13/1:13/1to12/1:12/1to12/2:12/2to11/2:11/2to10/2:10/2to9/2:9/2to8/2:8/2to7/2:7/2to6/2:6/2to5/2:5/2to4/2:4/2to3/2:3/2to2/2:2/2to2/3:2/3to2/4:2/4to2/5:2/5to2/6:2/6to2/7:,20,True,True
1369,617,784,167,6/4to6/3,0/8toleft8,6/4to6/3:6/3to5/3:5/3to4/3:4/3to3/3:3/3to2/3:2/3to1/3:1/3to0/3:0/3to0/4:0/4to0/5:0/5to0/6:0/6to0/7:0/7to0/8:0/8toleft8:,13,False,True
411,617,740,123,1/4to0/4,5/2to6/2,1/4to0/4:0/4to0/3:0/3to0/2:0/2to1/2:1/2to2/2:2/2to3/2:3/2to4/2:4/2to5/2:5/2to6/2:,9,True,True
3247,618,642,24,5/4to5/3,5/3to6/3,5/4to5/3:5/3to6/3:,2,False,True
1058,618,862,244,13/1to12/1,1/7to1/8,13/1to12/1:12/1to12/2:12/2to11/2:11/2to10/2:10/2to9/2:9/2to8/2:8/2to7/2:7/2to6/2:6/2to5/2:5/2to4/2:4/2to3/2:3/2to2/2:2/2to1/2:1/2to1/3:1/3to1/4:1/4to1/5:1/5to1/6:1/6to1/7:1/7to1/8:,19,True,True
3386,618,674,56,9/15to9/14,7/15totop7,9/15to9/14:9/14to8/14:8/14to7/14:7/14to7/15:7/15totop7:,5,False,True
1584,618,929,311,bottom14to14/0,8/11to9/11,bottom14to14/0:14/0to13/0:13/0to12/0:12/0to11/0:11/0to11/1:11/1to10/1:10/1to9/1:9/1to8/1:8/1to8/2:8/2to8/3:8/3to8/4:8/4to8/5:8/5to8/6:8/6to8/7:8/7to8/8:8/8to8/9:8/9to8/10:8/10to8/11:8/11to9/11:,19,True,True
2591,619,942,323,6/7to7/7,13/11to14/11,6/7to7/7:7/7to7/8:7/8to7/9:7/9to7/10:7/10to8/10:8/10to9/10:9/10to10/10:10/10to10/11:10/11to11/11:11/11to12/11:12/11to13/11:13/11to14/11:,12,True,True
2607,619,866,247,15/1to14/1,6/2to5/2,15/1to14/1:14/1to13/1:13/1to12/1:12/1to11/1:11/1to10/1:10/1to9/1:9/1to8/1:8/1to7/1:7/1to6/1:6/1to6/2:6/2to5/2:,11,True,True
81,620,1005,385,left15to0/15,15/0tobottom15,left15to0/15:0/15to0/14:0/14to0/13:0/13to0/12:0/12to0/11:0/11to0/10:0/10to0/9:0/9to0/8:0/8to0/7:0/7to0/6:0/6to0/5:0/5to0/4:0/4to0/3:0/3to0/2:0/2to1/2:1/2to2/2:2/2to3/2:3/2to4/2:4/2to5/2:5/2to6/2:6/2to7/2:7/2to8/2:8/2to9/2:9/2to10/2:10/2to10/1:10/1to11/1:11/1to11/0:11/0to12/0:12/0to13/0:13/0to14/0:14/0to15/0:15/0tobottom15:,32,True,True
1542,620,761,141,8/8to7/8,1/6to0/6,8/8to7/8:7/8to6/8:6/8to5/8:5/8to4/8:4/8to3/8:3/8to2/8:2/8to1/8:1/8to1/7:1/7to1/6:1/6to0/6:,10,True,True
58,620,993,373,left15to0/15,15/0tobottom15,left15to0/15:0/15to1/15:1/15to2/15:2/15to3/15:3/15to4/15:4/15to5/15:5/15to6/15:6/15to7/15:7/15to8/15:8/15to9/15:9/15to10/15:10/15to10/14:10/14to10/13:10/13to10/12:10/12to10/11:10/11to10/10:10/10to10/9:10/9to10/8:10/8to10/7:10/7to10/6:10/6to10/5:10/5to10/4:10/4to10/3:10/3to10/2:10/2to10/1:10/1to10/0:10/0to11/0:11/0to12/0:12/0to13/0:13/0to14/0:14/0to15/0:15/0tobottom15:,32,False,True
2043,621,762,141,10/5to10/6,6/11to5/11,10/5to10/6:10/6to9/6:9/6to8/6:8/6to7/6:7/6to6/6:6/6to6/7:6/7to6/8:6/8to6/9:6/9to6/10:6/10to6/11:6/11to5/11:,11,False,True
2132,621,750,129,0/14to0/15,8/15totop8,0/14to0/15:0/15to1/15:1/15to2/15:2/15to3/15:3/15to4/15:4/15to5/15:5/15to6/15:6/15to7/15:7/15to8/15:8/15totop8:,10,True,True
1267,621,762,141,0/13to0/12,7/11to7/10,0/13to0/12:0/12to0/11:0/11to1/11:1/11to2/11:2/11to3/11:3/11to4/11:4/11to5/11:5/11to6/11:6/11to7/11:7/11to7/10:,10,True,True
1652,622,927,305,15/2to15/1,8/9to8/10,15/2to15/1:15/1to14/1:14/1to13/1:13/1to12/1:12/1to11/1:11/1to10/1:10/1to9/1:9/1to8/1:8/1to8/2:8/2to8/3:8/3to8/4:8/4to8/5:8/5to8/6:8/6to8/7:8/7to8/8:8/8to8/9:8/9to8/10:,17,False,True
1309,622,826,204,5/15to5/14,14/10to14/9,5/15to5/14:5/14to6/14:6/14to7/14:7/14to8/14:8/14to9/14:9/14to10/14:10/14to10/13:10/13to10/12:10/12to10/11:10/11to10/10:10/10to11/10:11/10to12/10:12/10to13/10:13/10to14/10:14/10to14/9:,15,False,True
636,622,855,233,12/8to11/8,3/15to4/15,12/8to11/8:11/8to10/8:10/8to9/8:9/8to8/8:8/8to7/8:7/8to6/8:6/8to5/8:5/8to4/8:4/8to3/8:3/8to3/9:3/9to3/10:3/10to3/11:3/11to3/12:3/12to3/13:3/13to3/14:3/14to3/15:3/15to4/15:,17,False,True
951,622,853,231,11/12to11/11,5/5to6/5,11/12to11/11:11/11to10/11:10/11to9/11:9/11to8/11:8/11to7/11:7/11to6/11:6/11to5/11:5/11to5/10:5/10to5/9:5/9to5/8:5/8to5/7:5/7to5/6:5/6to5/5:5/5to6/5:,14,False,True
1247,623,657,34,9/2to9/3,8/3to8/4,9/2to9/3:9/3to8/3:8/3to8/4:,3,False,True
1924,623,794,171,13/7to12/7,7/11to7/12,13/7to12/7:12/7to11/7:11/7to10/7:10/7to9/7:9/7to8/7:8/7to7/7:7/7to7/8:7/8to7/9:7/9to7/10:7/10to7/11:7/11to7/12:,11,False,True
3342,623,804,181,9/1to8/1,0/5toleft5,9/1to8/1:8/1to7/1:7/1to6/1:6/1to5/1:5/1to4/1:4/1to3/1:3/1to2/1:2/1to1/1:1/1to0/1:0/1to0/2:0/2to0/3:0/3to0/4:0/4to0/5:0/5toleft5:,14,True,True
2248,623,685,62,0/4to0/5,2/6to2/7,0/4to0/5:0/5to0/6:0/6to1/6:1/6to2/6:2/6to2/7:,5,True,True
842,623,734,111,5/6to6/6,9/10to10/10,5/6to6/6:6/6to6/7:6/7to6/8:6/8to6/9:6/9to6/10:6/10to7/10:7/10to8/10:8/10to9/10:9/10to10/10:,9,False,True
2827,624,883,259,15/13to15/14,3/7to2/7,15/13to15/14:15/14to14/14:14/14to13/14:13/14to12/14:12/14to11/14:11/14to10/14:10/14to9/14:9/14to8/14:8/14to7/14:7/14to6/14:6/14to5/14:5/14to4/14:4/14to3/14:3/14to3/13:3/13to3/12:3/12to3/11:3/11to3/10:3/10to3/9:3/9to3/8:3/8to3/7:3/7to2/7:,21,False,True
509,624,760,136,7/4to7/5,8/14to8/13,7/4to7/5:7/5to7/6:7/6to7/7:7/7to7/8:7/8to7/9:7/9to7/10:7/10to7/11:7/11to7/12:7/12to7/13:7/13to7/14:7/14to8/14:8/14to8/13:,12,False,True
474,625,766,141,12/6to11/6,12/15to13/15,12/6to11/6:11/6to11/7:11/7to11/8:11/8to11/9:11/9to11/10:11/10to11/11:11/11to11/12:11/12to11/13:11/13to11/14:11/14to11/15:11/15to12/15:12/15to13/15:,12,True,True
1796,625,688,63,left6to0/6,3/5to3/4,left6to0/6:0/6to0/5:0/5to1/5:1/5to2/5:2/5to3/5:3/5to3/4:,6,True,True
864,625,699,74,13/2to13/3,11/1to11/0,13/2to13/3:13/3to12/3:12/3to11/3:11/3to11/2:11/2to11/1:11/1to11/0:,6,True,True
1563,626,798,172,10/13to10/12,9/0to9/1,10/13to10/12:10/12to10/11:10/11to9/11:9/11to9/10:9/10to9/9:9/9to9/8:9/8to9/7:9/7to9/6:9/6to9/5:9/5to9/4:9/4to9/3:9/3to9/2:9/2to9/1:9/1to9/0:9/0to9/1:,15,True,True
815,626,734,108,5/6to4/6,3/0to4/0,5/6to4/6:4/6to3/6:3/6to3/5:3/5to3/4:3/4to3/3:3/3to3/2:3/2to3/1:3/1to3/0:3/0to4/0:,9,False,True
1162,626,947,321,1/2to1/1,14/3to14/4,1/2to1/1:1/1to2/1:2/1to3/1:3/1to4/1:4/1to5/1:5/1to6/1:6/1to7/1:7/1to8/1:8/1to9/1:9/1to10/1:10/1to10/2:10/2to10/3:10/3to11/3:11/3to12/3:12/3to13/3:13/3to14/3:14/3to14/4:,17,False,True
2221,626,887,261,1/6to2/6,15/3to15/2,1/6to2/6:2/6to3/6:3/6to4/6:4/6to5/6:5/6to6/6:6/6to7/6:7/6to8/6:8/6to9/6:9/6to10/6:10/6to10/5:10/5to10/4:10/4to10/3:10/3to11/3:11/3to12/3:12/3to13/3:13/3to14/3:14/3to15/3:15/3to15/2:,18,False,True
705,626,815,189,9/15to9/14,9/2to10/2,9/15to9/14:9/14to8/14:8/14to8/13:8/13to8/12:8/12to8/11:8/11to8/10:8/10to8/9:8/9to8/8:8/8to8/7:8/7to8/6:8/6to8/5:8/5to8/4:8/4to8/3:8/3to8/2:8/2to9/2:9/2to10/2:,16,True,True
1013,627,903,276,1/10to2/10,14/11to15/11,1/10to2/10:2/10to2/11:2/11to3/11:3/11to4/11:4/11to5/11:5/11to6/11:6/11to7/11:7/11to8/11:8/11to9/11:9/11to10/11:10/11to11/11:11/11to12/11:12/11to13/11:13/11to14/11:14/11to15/11:,15,True,True
110,627,1033,406,left0to0/0,15/15totop15,left0to0/0:0/0to1/0:1/0to2/0:2/0to3/0:3/0to4/0:4/0to5/0:5/0to6/0:6/0to7/0:7/0to8/0:8/0to9/0:9/0to10/0:10/0to10/1:10/1to10/2:10/2to10/3:10/3to10/4:10/4to10/5:10/5to10/6:10/6to10/7:10/7to10/8:10/8to10/9:10/9to10/10:10/10to10/11:10/11to10/12:10/12to10/13:10/13to10/14:10/14to10/15:10/15to11/15:11/15to12/15:12/15to13/15:13/15to14/15:14/15to15/15:15/15totop15:,32,False,True
2605,627,918,291,12/1to11/1,3/10to3/11,12/1to11/1:11/1to10/1:10/1to9/1:9/1to8/1:8/1to7/1:7/1to6/1:6/1to5/1:5/1to4/1:4/1to3/1:3/1to3/2:3/2to3/3:3/3to3/4:3/4to3/5:3/5to3/6:3/6to3/7:3/7to3/8:3/8to3/9:3/9to3/10:3/10to3/11:,19,True,True
3398,628,816,188,7/11to8/11,12/2to12/1,7/11to8/11:8/11to9/11:9/11to10/11:10/11to10/10:10/10to10/9:10/9to10/8:10/8to10/7:10/7to10/6:10/6to10/5:10/5to10/4:10/4to10/3:10/3to10/2:10/2to11/2:11/2to12/2:12/2to12/1:,15,False,True
2971,628,811,183,13/0to12/0,7/7to8/7,13/0to12/0:12/0to11/0:11/0to10/0:10/0to9/0:9/0to8/0:8/0to7/0:7/0to7/1:7/1to7/2:7/2to7/3:7/3to7/4:7/4to7/5:7/5to7/6:7/6to7/7:7/7to8/7:,14,True,True
309,629,1108,479,right0to15/0,0/15totop0,right0to15/0:15/0to14/0:14/0to13/0:13/0to12/0:12/0to11/0:11/0to11/1:11/1to10/1:10/1to9/1:9/1to8/1:8/1to7/1:7/1to6/1:6/1to5/1:5/1to4/1:4/1to3/1:3/1to2/1:2/1to1/1:1/1to0/1:0/1to0/2:0/2to0/3:0/3to0/4:0/4to0/5:0/5to0/6:0/6to0/7:0/7to0/8:0/8to0/9:0/9to0/10:0/10to0/11:0/11to0/12:0/12to0/13:0/13to0/14:0/14to0/15:0/15totop0:,32,True,True
763,629,747,118,9/8to8/8,3/6to3/5,9/8to8/8:8/8to7/8:7/8to6/8:6/8to5/8:5/8to4/8:4/8to3/8:3/8to3/7:3/7to3/6:3/6to3/5:,9,False,True
2924,629,807,178,11/4to11/5,4/4to4/3,11/4to11/5:11/5to10/5:10/5to9/5:9/5to8/5:8/5to7/5:7/5to6/5:6/5to5/5:5/5to4/5:4/5to4/4:4/4to4/3:,10,True,True
2977,629,888,259,3/1to3/2,13/8to13/7,3/1to3/2:3/2to4/2:4/2to5/2:5/2to6/2:6/2to7/2:7/2to8/2:8/2to9/2:9/2to10/2:10/2to10/3:10/3to10/4:10/4to10/5:10/5to10/6:10/6to10/7:10/7to10/8:10/8to11/8:11/8to12/8:12/8to13/8:13/8to13/7:,18,False,True
2163,629,722,93,3/0to3/1,3/7to2/7,3/0to3/1:3/1to3/2:3/2to3/3:3/3to3/4:3/4to3/5:3/5to3/6:3/6to3/7:3/7to2/7:,8,False,True
3157,629,693,64,1/0to2/0,4/1to4/0,1/0to2/0:2/0to2/1:2/1to3/1:3/1to4/1:4/1to4/0:,5,True,True
2431,629,711,82,7/14to6/14,9/13to9/14,7/14to6/14:6/14to6/13:6/13to7/13:7/13to8/13:8/13to9/13:9/13to9/14:,6,False,True
2140,629,757,128,11/3to10/3,6/4to6/5,11/3to10/3:10/3to9/3:9/3to8/3:8/3to7/3:7/3to6/3:6/3to6/4:6/4to6/5:,7,True,True
1619,630,692,62,7/1to7/2,8/4to8/5,7/1to7/2:7/2to7/3:7/3to7/4:7/4to8/4:8/4to8/5:,5,True,True
2229,630,821,191,1/4to1/5,9/9to9/10,1/4to1/5:1/5to1/6:1/6to1/7:1/7to1/8:1/8to1/9:1/9to2/9:2/9to3/9:3/9to4/9:4/9to5/9:5/9to6/9:6/9to7/9:7/9to8/9:8/9to9/9:9/9to9/10:,14,False,True
2291,630,785,155,3/6to4/6,11/4to11/5,3/6to4/6:4/6to5/6:5/6to6/6:6/6to7/6:7/6to8/6:8/6to9/6:9/6to10/6:10/6to10/5:10/5to11/5:11/5to11/4:11/4to11/5:,11,True,True
2889,630,819,189,12/0to11/0,5/7to4/7,12/0to11/0:11/0to10/0:10/0to9/0:9/0to8/0:8/0to7/0:7/0to6/0:6/0to5/0:5/0to5/1:5/1to5/2:5/2to5/3:5/3to5/4:5/4to5/5:5/5to5/6:5/6to5/7:5/7to4/7:,15,False,True
3376,630,858,228,10/6to10/7,2/15totop2,10/6to10/7:10/7to9/7:9/7to8/7:8/7to7/7:7/7to6/7:6/7to5/7:5/7to4/7:4/7to3/7:3/7to2/7:2/7to2/8:2/8to2/9:2/9to2/10:2/10to2/11:2/11to2/12:2/12to2/13:2/13to2/14:2/14to2/15:2/15totop2:,18,False,True
2302,630,684,54,bottom10to10/0,9/2to9/3,bottom10to10/0:10/0to10/1:10/1to10/2:10/2to9/2:9/2to9/3:,5,False,True
1183,630,778,148,left12to0/12,3/4to4/4,left12to0/12:0/12to0/11:0/11to0/10:0/10to0/9:0/9to0/8:0/8to0/7:0/7to0/6:0/6to0/5:0/5to0/4:0/4to1/4:1/4to2/4:2/4to3/4:3/4to4/4:,13,True,True
1373,632,921,289,13/1to12/1,0/0toleft0,13/1to12/1:12/1to11/1:11/1to10/1:10/1to9/1:9/1to8/1:8/1to7/1:7/1to6/1:6/1to5/1:5/1to4/1:4/1to3/1:3/1to2/1:2/1to1/1:1/1to0/1:0/1to0/0:0/0toleft0:,15,True,True
2017,632,869,237,4/15to5/15,11/4to11/3,4/15to5/15:5/15to6/15:6/15to7/15:7/15to8/15:8/15to9/15:9/15to10/15:10/15to10/14:10/14to10/13:10/13to10/12:10/12to10/11:10/11to10/10:10/10to10/9:10/9to10/8:10/8to10/7:10/7to10/6:10/6to10/5:10/5to10/4:10/4to11/4:11/4to11/3:,19,False,True
2518,632,992,360,12/5to12/6,3/5to3/4,12/5to12/6:12/6to11/6:11/6to10/6:10/6to9/6:9/6to8/6:8/6to7/6:7/6to6/6:6/6to5/6:5/6to4/6:4/6to3/6:3/6to3/5:3/5to3/4:,12,False,True
1548,632,830,198,top5to5/15,6/1to6/0,top5to5/15:5/15to5/14:5/14to5/13:5/13to5/12:5/12to5/11:5/11to5/10:5/10to5/9:5/9to5/8:5/8to5/7:5/7to5/6:5/6to5/5:5/5to5/4:5/4to5/3:5/3to5/2:5/2to5/1:5/1to6/1:6/1to6/0:,17,True,True
2784,632,964,332,4/2to5/2,14/14to15/14,4/2to5/2:5/2to6/2:6/2to7/2:7/2to8/2:8/2to9/2:9/2to10/2:10/2to10/3:10/3to10/4:10/4to10/5:10/5to10/6:10/6to10/7:10/7to10/8:10/8to10/9:10/9to10/10:10/10to10/11:10/11to10/12:10/12to10/13:10/13to10/14:10/14to11/14:11/14to12/14:12/14to13/14:13/14to14/14:14/14to15/14:,23,False,True
2443,633,968,335,0/0to0/1,12/7to13/7,0/0to0/1:0/1to1/1:1/1to2/1:2/1to3/1:3/1to4/1:4/1to5/1:5/1to6/1:6/1to7/1:7/1to8/1:8/1to9/1:9/1to10/1:10/1to10/2:10/2to10/3:10/3to10/4:10/4to10/5:10/5to10/6:10/6to10/7:10/7to11/7:11/7to12/7:12/7to13/7:,20,False,True
3153,633,756,123,right9to15/9,8/9to8/8,right9to15/9:15/9to14/9:14/9to13/9:13/9to12/9:12/9to11/9:11/9to10/9:10/9to9/9:9/9to8/9:8/9to8/8:,9,True,True
3399,633,871,238,10/4to10/3,2/11to2/12,10/4to10/3:10/3to9/3:9/3to8/3:8/3to7/3:7/3to6/3:6/3to5/3:5/3to4/3:4/3to3/3:3/3to2/3:2/3to2/4:2/4to2/5:2/5to2/6:2/6to2/7:2/7to2/8:2/8to2/9:2/9to2/10:2/10to2/11:2/11to2/12:,18,False,True
1491,633,715,82,10/15to11/15,11/10to12/10,10/15to11/15:11/15to11/14:11/14to11/13:11/13to11/12:11/12to11/11:11/11to11/10:11/10to12/10:,7,True,True
581,634,691,57,5/5to4/5,3/7to4/7,5/5to4/5:4/5to3/5:3/5to3/6:3/6to3/7:3/7to4/7:,5,True,True
132,634,1010,376,left0to0/0,15/15totop15,left0to0/0:0/0to0/1:0/1to0/2:0/2to0/3:0/3to0/4:0/4to0/5:0/5to0/6:0/6to0/7:0/7to0/8:0/8to0/9:0/9to0/10:0/10to0/11:0/11to0/12:0/12to0/13:0/13to0/14:0/14to1/14:1/14to2/14:2/14to3/14:3/14to4/14:4/14to5/14:5/14to6/14:6/14to7/14:7/14to8/14:8/14to9/14:9/14to10/14:10/14to10/15:10/15to11/15:11/15to12/15:12/15to13/15:13/15to14/15:14/15to15/15:15/15totop15:,32,True,True
3075,634,687,53,right4to15/4,15/0tobottom15,right4to15/4:15/4to15/3:15/3to15/2:15/2to15/1:15/1to15/0:15/0tobottom15:,6,False,True
1122,634,854,220,4/0to5/0,12/9to12/8,4/0to5/0:5/0to6/0:6/0to7/0:7/0to8/0:8/0to9/0:9/0to10/0:10/0to10/1:10/1to10/2:10/2to10/3:10/3to10/4:10/4to10/5:10/5to10/6:10/6to10/7:10/7to10/8:10/8to10/9:10/9to11/9:11/9to12/9:12/9to12/8:,18,False,True
2554,634,753,119,9/11to10/11,12/14to12/13,9/11to10/11:10/11to10/12:10/12to11/12:11/12to12/12:12/12to12/13:12/13to12/14:12/14to12/13:,7,True,True
1254,635,864,229,2/11to3/11,12/5to12/6,2/11to3/11:3/11to4/11:4/11to5/11:5/11to6/11:6/11to7/11:7/11to8/11:8/11to9/11:9/11to10/11:10/11to10/10:10/10to10/9:10/9to10/8:10/8to10/7:10/7to10/6:10/6to10/5:10/5to11/5:11/5to12/5:12/5to12/6:,17,False,True
3314,635,889,254,7/0to6/0,0/14toleft14,7/0to6/0:6/0to5/0:5/0to4/0:4/0to3/0:3/0to2/0:2/0to1/0:1/0to0/0:0/0to0/1:0/1to0/2:0/2to0/3:0/3to0/4:0/4to0/5:0/5to0/6:0/6to0/7:0/7to0/8:0/8to0/9:0/9to0/10:0/10to0/11:0/11to0/12:0/12to0/13:0/13to0/14:0/14toleft14:,22,True,True
407,635,994,359,4/4to5/4,10/5to10/6,4/4to5/4:5/4to6/4:6/4to7/4:7/4to8/4:8/4to9/4:9/4to10/4:10/4to10/5:10/5to10/6:,8,False,True
2624,635,920,285,3/1to3/0,12/12to13/12,3/1to3/0:3/0to4/0:4/0to5/0:5/0to6/0:6/0to7/0:7/0to8/0:8/0to9/0:9/0to10/0:10/0to10/1:10/1to10/2:10/2to10/3:10/3to10/4:10/4to10/5:10/5to10/6:10/6to10/7:10/7to10/8:10/8to10/9:10/9to10/10:10/10to10/11:10/11to10/12:10/12to11/12:11/12to12/12:12/12to13/12:,23,False,True
552,635,779,144,5/4to6/4,12/6to12/5,5/4to6/4:6/4to6/5:6/5to7/5:7/5to8/5:8/5to9/5:9/5to10/5:10/5to10/6:10/6to11/6:11/6to12/6:12/6to12/5:,10,True,True
60,635,1017,382,left15to0/15,15/0tobottom15,left15to0/15:0/15to0/14:0/14to0/13:0/13to0/12:0/12to0/11:0/11to0/10:0/10to0/9:0/9to0/8:0/8to0/7:0/7to0/6:0/6to0/5:0/5to0/4:0/4to0/3:0/3to0/2:0/2to1/2:1/2to2/2:2/2to3/2:3/2to4/2:4/2to5/2:5/2to6/2:6/2to7/2:7/2to8/2:8/2to9/2:9/2to10/2:10/2to10/1:10/1to11/1:11/1to11/0:11/0to12/0:12/0to13/0:13/0to14/0:14/0to15/0:15/0tobottom15:,32,True,True
2472,637,778,141,left14to0/14,4/8to4/9,left14to0/14:0/14to0/13:0/13to0/12:0/12to0/11:0/11to0/10:0/10to0/9:0/9to0/8:0/8to1/8:1/8to2/8:2/8to3/8:3/8to4/8:4/8to4/9:,12,True,True
2629,637,733,96,3/11to3/12,6/15to6/14,3/11to3/12:3/12to3/13:3/13to3/14:3/14to3/15:3/15to4/15:4/15to5/15:5/15to6/15:6/15to6/14:,8,True,True
766,637,685,48,13/13to12/13,11/12to11/11,13/13to12/13:12/13to11/13:11/13to11/12:11/12to11/11:,4,False,True
600,637,718,81,5/8to5/9,6/13to6/14,5/8to5/9:5/9to5/10:5/10to5/11:5/11to5/12:5/12to5/13:5/13to6/13:6/13to6/14:,7,False,True
2818,638,758,120,10/7to10/6,5/4to5/3,10/7to10/6:10/6to9/6:9/6to8/6:8/6to7/6:7/6to6/6:6/6to5/6:5/6to5/5:5/5to5/4:5/4to5/3:,9,True,True
2309,638,1040,402,3/4to3/5,10/9to9/9,3/4to3/5:3/5to3/6:3/6to3/7:3/7to4/7:4/7to5/7:5/7to6/7:6/7to7/7:7/7to8/7:8/7to9/7:9/7to10/7:10/7to10/8:10/8to10/9:10/9to9/9:,13,True,True
1911,638,833,195,6/11to6/12,15/10to15/9,6/11to6/12:6/12to7/12:7/12to8/12:8/12to9/12:9/12to10/12:10/12to10/11:10/11to10/10:10/10to11/10:11/10to12/10:12/10to13/10:13/10to14/10:14/10to15/10:15/10to15/9:,13,False,True
2421,638,869,231,14/8to13/8,4/14to4/15,14/8to13/8:13/8to12/8:12/8to11/8:11/8to10/8:10/8to9/8:9/8to8/8:8/8to7/8:7/8to6/8:6/8to5/8:5/8to4/8:4/8to4/9:4/9to4/10:4/10to4/11:4/11to4/12:4/12to4/13:4/13to4/14:4/14to4/15:,17,True,True
800,638,777,139,6/13to6/14,0/10toleft10,6/13to6/14:6/14to5/14:5/14to4/14:4/14to3/14:3/14to2/14:2/14to1/14:1/14to0/14:0/14to0/13:0/13to0/12:0/12to0/11:0/11to0/10:0/10toleft10:,12,False,True
505,638,674,36,11/7to10/7,9/7to9/6,11/7to10/7:10/7to9/7:9/7to9/6:,3,True,True
2570,638,726,88,3/11to3/12,1/9to1/8,3/11to3/12:3/12to2/12:2/12to1/12:1/12to1/11:1/11to1/10:1/10to1/9:1/9to1/8:,7,True,True
1001,638,807,169,3/10to4/10,10/14to10/15,3/10to4/10:4/10to4/11:4/11to4/12:4/12to4/13:4/13to5/13:5/13to6/13:6/13to7/13:7/13to8/13:8/13to9/13:9/13to10/13:10/13to10/14:10/14to10/15:,12,True,True
760,639,911,272,14/2to14/1,2/8to2/9,14/2to14/1:14/1to13/1:13/1to12/1:12/1to12/2:12/2to11/2:11/2to10/2:10/2to9/2:9/2to8/2:8/2to7/2:7/2to6/2:6/2to5/2:5/2to4/2:4/2to3/2:3/2to2/2:2/2to2/3:2/3to2/4:2/4to2/5:2/5to2/6:2/6to2/7:2/7to2/8:2/8to2/9:,21,True,True
126,640,1044,404,left0to0/0,15/15totop15,left0to0/0:0/0to1/0:1/0to2/0:2/0to3/0:3/0to4/0:4/0to5/0:5/0to6/0:6/0to7/0:7/0to8/0:8/0to9/0:9/0to10/0:10/0to10/1:10/1to10/2:10/2to10/3:10/3to10/4:10/4to10/5:10/5to10/6:10/6to10/7:10/7to10/8:10/8to10/9:10/9to10/10:10/10to10/11:10/11to10/12:10/12to10/13:10/13to10/14:10/14to10/15:10/15to11/15:11/15to12/15:12/15to13/15:13/15to14/15:14/15to15/15:15/15totop15:,32,False,True
2704,640,758,118,10/6to9/6,5/3to6/3,10/6to9/6:9/6to8/6:8/6to7/6:7/6to6/6:6/6to5/6:5/6to5/5:5/5to5/4:5/4to5/3:5/3to6/3:,9,False,True
415,640,839,199,11/0to11/1,6/2to5/2,11/0to11/1:11/1to10/1:10/1to9/1:9/1to8/1:8/1to7/1:7/1to6/1:6/1to6/2:6/2to5/2:,8,False,True
634,640,699,59,15/14to15/13,13/14to13/15,15/14to15/13:15/13to14/13:14/13to13/13:13/13to13/14:13/14to13/15:,5,True,True
1982,641,855,214,13/10to12/10,3/10to3/9,13/10to12/10:12/10to12/11:12/11to11/11:11/11to10/11:10/11to9/11:9/11to8/11:8/11to7/11:7/11to6/11:6/11to5/11:5/11to4/11:4/11to3/11:3/11to3/10:3/10to3/9:,13,True,True
2599,641,799,158,1/13to1/12,3/3to3/2,1/13to1/12:1/12to1/11:1/11to1/10:1/10to1/9:1/9to1/8:1/8to1/7:1/7to1/6:1/6to1/5:1/5to1/4:1/4to1/3:1/3to2/3:2/3to3/3:3/3to3/2:,13,True,True
241,641,1037,396,right15to15/15,0/0tobottom0,right15to15/15:15/15to14/15:14/15to13/15:13/15to12/15:12/15to11/15:11/15to10/15:10/15to9/15:9/15to8/15:8/15to7/15:7/15to6/15:6/15to5/15:5/15to4/15:4/15to3/15:3/15to2/15:2/15to1/15:1/15to0/15:0/15to0/14:0/14to0/13:0/13to0/12:0/12to0/11:0/11to0/10:0/10to0/9:0/9to0/8:0/8to0/7:0/7to0/6:0/6to0/5:0/5to0/4:0/4to0/3:0/3to0/2:0/2to0/1:0/1to0/0:0/0tobottom0:,32,False,True
1163,641,723,82,7/4to6/4,5/0to4/0,7/4to6/4:6/4to5/4:5/4to5/3:5/3to5/2:5/2to5/1:5/1to5/0:5/0to4/0:,7,True,True
2438,641,1015,374,14/14to13/14,0/1to1/1,14/14to13/14:13/14to12/14:12/14to11/14:11/14to10/14:10/14to9/14:9/14to8/14:8/14to7/14:7/14to6/14:6/14to5/14:5/14to4/14:4/14to3/14:3/14to2/14:2/14to1/14:1/14to0/14:0/14to0/13:0/13to0/12:0/12to0/11:0/11to0/10:0/10to0/9:0/9to0/8:0/8to0/7:0/7to0/6:0/6to0/5:0/5to0/4:0/4to0/3:0/3to0/2:0/2to0/1:0/1to1/1:,28,False,True
2437,641,823,182,2/3to3/3,12/6to12/5,2/3to3/3:3/3to4/3:4/3to5/3:5/3to6/3:6/3to7/3:7/3to8/3:8/3to9/3:9/3to10/3:10/3to10/4:10/4to10/5:10/5to10/6:10/6to11/6:11/6to12/6:12/6to12/5:,14,False,True
548,641,941,300,0/0to1/0,12/10to12/11,0/0to1/0:1/0to2/0:2/0to3/0:3/0to4/0:4/0to5/0:5/0to6/0:6/0to7/0:7/0to8/0:8/0to9/0:9/0to10/0:10/0to10/1:10/1to10/2:10/2to10/3:10/3to10/4:10/4to10/5:10/5to10/6:10/6to10/7:10/7to10/8:10/8to10/9:10/9to10/10:10/10to11/10:11/10to12/10:12/10to12/11:,23,False,True
3011,642,1118,476,3/3to3/4,10/4to10/5,3/3to3/4:3/4to4/4:4/4to5/4:5/4to6/4:6/4to7/4:7/4to8/4:8/4to9/4:9/4to10/4:10/4to10/5:,9,True,True
1834,642,888,246,7/14to8/14,13/1to14/1,7/14to8/14:8/14to8/13:8/13to8/12:8/12to8/11:8/11to8/10:8/10to8/9:8/9to8/8:8/8to8/7:8/7to8/6:8/6to8/5:8/5to8/4:8/4to8/3:8/3to8/2:8/2to9/2:9/2to10/2:10/2to10/1:10/1to11/1:11/1to12/1:12/1to13/1:13/1to14/1:,20,True,True
2520,644,771,127,6/4to5/4,9/0to9/1,6/4to5/4:5/4to5/3:5/3to5/2:5/2to5/1:5/1to5/0:5/0to6/0:6/0to7/0:7/0to8/0:8/0to9/0:9/0to9/1:,10,False,True
1292,644,852,208,7/9to7/10,10/11to9/11,7/9to7/10:7/10to8/10:8/10to9/10:9/10to10/10:10/10to10/11:10/11to9/11:,6,False,True
2948,644,749,105,6/10to5/10,0/11toleft11,6/10to5/10:5/10to4/10:4/10to3/10:3/10to2/10:2/10to1/10:1/10to0/10:0/10to0/11:0/11toleft11:,8,False,True
733,644,787,143,12/7to11/7,9/0tobottom9,12/7to11/7:11/7to10/7:10/7to10/6:10/6to10/5:10/5to10/4:10/4to10/3:10/3to10/2:10/2to10/1:10/1to10/0:10/0to9/0:9/0tobottom9:,11,False,True
1824,645,704,59,11/15to11/14,12/12to12/13,11/15to11/14:11/14to12/14:12/14to12/13:12/13to12/12:12/12to12/13:,5,True,True
1062,646,833,187,1/7to1/6,9/1to9/2,1/7to1/6:1/6to1/5:1/5to1/4:1/4to1/3:1/3to1/2:1/2to1/1:1/1to2/1:2/1to3/1:3/1to4/1:4/1to5/1:5/1to6/1:6/1to7/1:7/1to8/1:8/1to9/1:9/1to9/2:,15,True,True
435,647,1022,375,right5to15/5,2/2to3/2,right5to15/5:15/5to14/5:14/5to13/5:13/5to12/5:12/5to11/5:11/5to10/5:10/5to9/5:9/5to8/5:8/5to7/5:7/5to6/5:6/5to5/5:5/5to4/5:4/5to3/5:3/5to2/5:2/5to2/4:2/4to2/3:2/3to2/2:2/2to3/2:,18,True,True
1398,647,728,81,0/12to1/12,4/10to5/10,0/12to1/12:1/12to1/11:1/11to1/10:1/10to2/10:2/10to3/10:3/10to4/10:4/10to5/10:,7,False,True
2875,648,823,175,14/3to13/3,11/14to11/15,14/3to13/3:13/3to12/3:12/3to11/3:11/3to11/4:11/4to11/5:11/5to11/6:11/6to11/7:11/7to11/8:11/8to11/9:11/9to11/10:11/10to11/11:11/11to11/12:11/12to11/13:11/13to11/14:11/14to11/15:,15,False,True
2415,648,708,60,right10to15/10,15/14to15/15,right10to15/10:15/10to15/11:15/11to15/12:15/12to15/13:15/13to15/14:15/14to15/15:,6,False,True
2972,648,757,109,4/12to3/12,7/15to8/15,4/12to3/12:3/12to3/13:3/13to3/14:3/14to3/15:3/15to4/15:4/15to5/15:5/15to6/15:6/15to7/15:7/15to8/15:,9,True,True
2326,648,705,57,11/11to12/11,15/11toright11,11/11to12/11:12/11to13/11:13/11to14/11:14/11to15/11:15/11toright11:,5,True,True
616,648,799,151,2/9to1/9,8/6to8/5,2/9to1/9:1/9to1/8:1/8to1/7:1/7to1/6:1/6to2/6:2/6to3/6:3/6to4/6:4/6to5/6:5/6to6/6:6/6to7/6:7/6to8/6:8/6to8/5:,12,True,True
1676,648,813,165,5/3to5/2,15/1to15/2,5/3to5/2:5/2to6/2:6/2to7/2:7/2to8/2:8/2to9/2:9/2to10/2:10/2to10/1:10/1to11/1:11/1to12/1:12/1to13/1:13/1to14/1:14/1to15/1:15/1to15/2:,13,False,True
3101,649,725,76,7/9to8/9,10/11to9/11,7/9to8/9:8/9to8/10:8/10to8/11:8/11to9/11:9/11to10/11:10/11to9/11:,6,True,True
1125,649,1115,466,1/0to2/0,13/13to13/12,1/0to2/0:2/0to2/1:2/1to2/2:2/2to2/3:2/3to2/4:2/4to2/5:2/5to2/6:2/6to2/7:2/7to2/8:2/8to2/9:2/9to2/10:2/10to2/11:2/11to3/11:3/11to4/11:4/11to5/11:5/11to6/11:6/11to7/11:7/11to8/11:8/11to9/11:9/11to10/11:10/11to10/12:10/12to11/12:11/12to12/12:12/12to12/13:12/13to13/13:13/13to13/12:,26,True,True
1318,649,700,51,11/15to12/15,13/14to13/15,11/15to12/15:12/15to12/14:12/14to13/14:13/14to13/15:,4,True,True
392,649,1021,372,right0to15/0,0/15totop0,right0to15/0:15/0to14/0:14/0to13/0:13/0to12/0:12/0to11/0:11/0to10/0:10/0to9/0:9/0to8/0:8/0to7/0:7/0to6/0:6/0to5/0:5/0to4/0:4/0to3/0:3/0to2/0:2/0to1/0:1/0to0/0:0/0to0/1:0/1to0/2:0/2to0/3:0/3to0/4:0/4to0/5:0/5to0/6:0/6to0/7:0/7to0/8:0/8to0/9:0/9to0/10:0/10to0/11:0/11to0/12:0/12to0/13:0/13to0/14:0/14to0/15:0/15totop0:,32,False,True
2779,650,851,201,11/12to10/12,10/2to10/1,11/12to10/12:10/12to10/11:10/11to9/11:9/11to9/10:9/10to9/9:9/9to9/8:9/8to9/7:9/7to9/6:9/6to9/5:9/5to9/4:9/4to9/3:9/3to10/3:10/3to10/2:10/2to10/1:,14,True,True
868,650,919,269,0/12to0/13,10/6to11/6,0/12to0/13:0/13to0/12:0/12to0/11:0/11to0/10:0/10to0/9:0/9to0/8:0/8to1/8:1/8to2/8:2/8to3/8:3/8to4/8:4/8to5/8:5/8to6/8:6/8to7/8:7/8to8/8:8/8to9/8:9/8to10/8:10/8to10/7:10/7to10/6:10/6to11/6:,19,True,True
2245,650,822,172,2/10to3/10,11/7to11/6,2/10to3/10:3/10to3/9:3/9to3/8:3/8to4/8:4/8to5/8:5/8to6/8:6/8to7/8:7/8to8/8:8/8to9/8:9/8to10/8:10/8to10/7:10/7to11/7:11/7to11/6:,13,True,True
781,651,797,146,left2to0/2,8/0tobottom8,left2to0/2:0/2to0/1:0/1to0/0:0/0to1/0:1/0to2/0:2/0to3/0:3/0to4/0:4/0to5/0:5/0to6/0:6/0to7/0:7/0to8/0:8/0tobottom8:,12,False,True
2209,651,753,102,8/0to7/0,4/3to3/3,8/0to7/0:7/0to6/0:6/0to5/0:5/0to4/0:4/0to4/1:4/1to4/2:4/2to4/3:4/3to3/3:,8,False,True
71,652,1027,375,left15to0/15,15/0tobottom15,left15to0/15:0/15to0/14:0/14to0/13:0/13to0/12:0/12to0/11:0/11to0/10:0/10to0/9:0/9to0/8:0/8to0/7:0/7to0/6:0/6to0/5:0/5to0/4:0/4to0/3:0/3to0/2:0/2to0/1:0/1to0/0:0/0to1/0:1/0to2/0:2/0to3/0:3/0to4/0:4/0to5/0:5/0to6/0:6/0to7/0:7/0to8/0:8/0to9/0:9/0to10/0:10/0to11/0:11/0to12/0:12/0to13/0:13/0to14/0:14/0to15/0:15/0tobottom15:,32,True,True
710,652,796,144,8/5to7/5,7/15to6/15,8/5to7/5:7/5to7/6:7/6to7/7:7/7to7/8:7/8to7/9:7/9to7/10:7/10to7/11:7/11to7/12:7/12to7/13:7/13to7/14:7/14to7/15:7/15to6/15:,12,False,True
1531,652,974,322,6/5to6/6,11/14to12/14,6/5to6/6:6/6to7/6:7/6to8/6:8/6to9/6:9/6to10/6:10/6to10/7:10/7to10/8:10/8to10/9:10/9to10/10:10/10to10/11:10/11to10/12:10/12to10/13:10/13to10/14:10/14to11/14:11/14to12/14:,15,False,True
507,652,840,188,14/13to13/13,3/15totop3,14/13to13/13:13/13to12/13:12/13to11/13:11/13to10/13:10/13to9/13:9/13to8/13:8/13to7/13:7/13to6/13:6/13to5/13:5/13to4/13:4/13to3/13:3/13to3/14:3/14to3/15:3/15totop3:,14,True,True
133,652,1050,398,left0to0/0,15/15totop15,left0to0/0:0/0to0/1:0/1to0/2:0/2to0/3:0/3to0/4:0/4to0/5:0/5to0/6:0/6to0/7:0/7to0/8:0/8to0/9:0/9to0/10:0/10to0/11:0/11to0/12:0/12to0/13:0/13to0/14:0/14to1/14:1/14to2/14:2/14to3/14:3/14to4/14:4/14to5/14:5/14to6/14:6/14to7/14:7/14to8/14:8/14to9/14:9/14to10/14:10/14to10/15:10/15to11/15:11/15to12/15:12/15to13/15:13/15to14/15:14/15to15/15:15/15totop15:,32,True,True
3311,654,1037,383,11/11to11/10,0/4toleft4,11/11to11/10:11/10to10/10:10/10to9/10:9/10to8/10:8/10to7/10:7/10to6/10:6/10to5/10:5/10to4/10:4/10to3/10:3/10to2/10:2/10to1/10:1/10to0/10:0/10to0/9:0/9to0/8:0/8to0/7:0/7to0/6:0/6to0/5:0/5to0/4:0/4toleft4:,19,False,True
2885,654,898,244,7/6to8/6,13/9to13/8,7/6to8/6:8/6to9/6:9/6to10/6:10/6to10/7:10/7to10/8:10/8to10/9:10/9to11/9:11/9to12/9:12/9to13/9:13/9to13/8:,10,False,True
586,654,862,208,top6to6/15,10/3to11/3,top6to6/15:6/15to7/15:7/15to8/15:8/15to9/15:9/15to10/15:10/15to10/14:10/14to10/13:10/13to10/12:10/12to10/11:10/11to10/10:10/10to10/9:10/9to10/8:10/8to10/7:10/7to10/6:10/6to10/5:10/5to10/4:10/4to10/3:10/3to11/3:,18,False,True
1869,654,970,316,2/2to2/1,12/15totop12,2/2to2/1:2/1to2/2:2/2to2/3:2/3to2/4:2/4to2/5:2/5to2/6:2/6to2/7:2/7to2/8:2/8to2/9:2/9to2/10:2/10to2/11:2/11to2/12:2/12to2/13:2/13to2/14:2/14to3/14:3/14to4/14:4/14to5/14:5/14to6/14:6/14to7/14:7/14to8/14:8/14to9/14:9/14to10/14:10/14to10/15:10/15to11/15:11/15to12/15:12/15totop12:,26,True,True
1301,654,963,309,top2to2/15,13/3to14/3,top2to2/15:2/15to3/15:3/15to4/15:4/15to5/15:5/15to6/15:6/15to7/15:7/15to8/15:8/15to9/15:9/15to10/15:10/15to10/14:10/14to10/13:10/13to10/12:10/12to10/11:10/11to10/10:10/10to10/9:10/9to10/8:10/8to10/7:10/7to10/6:10/6to10/5:10/5to10/4:10/4to10/3:10/3to11/3:11/3to12/3:12/3to13/3:13/3to14/3:,25,False,True
1154,655,812,157,7/1to7/2,3/9to4/9,7/1to7/2:7/2to6/2:6/2to5/2:5/2to4/2:4/2to3/2:3/2to3/3:3/3to3/4:3/4to3/5:3/5to3/6:3/6to3/7:3/7to3/8:3/8to3/9:3/9to4/9:,13,False,True
2685,655,855,200,10/5to9/5,1/11to1/12,10/5to9/5:9/5to8/5:8/5to7/5:7/5to6/5:6/5to5/5:5/5to4/5:4/5to3/5:3/5to2/5:2/5to1/5:1/5to1/6:1/6to1/7:1/7to1/8:1/8to1/9:1/9to1/10:1/10to1/11:1/11to1/12:,16,True,True
325,655,1036,381,right0to15/0,0/15totop0,right0to15/0:15/0to14/0:14/0to13/0:13/0to12/0:12/0to11/0:11/0to10/0:10/0to9/0:9/0to8/0:8/0to7/0:7/0to6/0:6/0to5/0:5/0to4/0:4/0to3/0:3/0to2/0:2/0to1/0:1/0to0/0:0/0to0/1:0/1to0/2:0/2to0/3:0/3to0/4:0/4to0/5:0/5to0/6:0/6to0/7:0/7to0/8:0/8to0/9:0/9to0/10:0/10to0/11:0/11to0/12:0/12to0/13:0/13to0/14:0/14to0/15:0/15totop0:,32,True,True
2480,655,767,112,6/10to5/10,1/7to0/7,6/10to5/10:5/10to4/10:4/10to3/10:3/10to2/10:2/10to1/10:1/10to1/9:1/9to1/8:1/8to1/7:1/7to0/7:,9,False,True
2997,656,849,193,1/4to2/4,13/2to14/2,1/4to2/4:2/4to3/4:3/4to4/4:4/4to5/4:5/4to6/4:6/4to7/4:7/4to8/4:8/4to9/4:9/4to10/4:10/4to10/3:10/3to10/2:10/2to11/2:11/2to12/2:12/2to13/2:13/2to14/2:,15,False,True
2133,656,864,208,10/3to9/3,1/9to1/10,10/3to9/3:9/3to8/3:8/3to7/3:7/3to6/3:6/3to5/3:5/3to4/3:4/3to3/3:3/3to2/3:2/3to1/3:1/3to1/4:1/4to1/5:1/5to1/6:1/6to1/7:1/7to1/8:1/8to1/9:1/9to1/10:,16,False,True
351,657,1116,459,right0to15/0,0/15totop0,right0to15/0:15/0to14/0:14/0to13/0:13/0to12/0:12/0to11/0:11/0to11/1:11/1to10/1:10/1to9/1:9/1to8/1:8/1to7/1:7/1to6/1:6/1to5/1:5/1to4/1:4/1to3/1:3/1to2/1:2/1to1/1:1/1to0/1:0/1to0/2:0/2to0/3:0/3to0/4:0/4to0/5:0/5to0/6:0/6to0/7:0/7to0/8:0/8to0/9:0/9to0/10:0/10to0/11:0/11to0/12:0/12to0/13:0/13to0/14:0/14to0/15:0/15totop0:,32,True,True
2974,657,889,232,8/13to8/14,4/1to3/1,8/13to8/14:8/14to7/14:7/14to6/14:6/14to5/14:5/14to4/14:4/14to4/13:4/13to4/12:4/12to4/11:4/11to4/10:4/10to4/9:4/9to4/8:4/8to4/7:4/7to4/6:4/6to4/5:4/5to4/4:4/4to4/3:4/3to4/2:4/2to4/1:4/1to3/1:,19,True,True
171,658,1053,395,left0to0/0,15/15totop15,left0to0/0:0/0to1/0:1/0to2/0:2/0to3/0:3/0to4/0:4/0to5/0:5/0to6/0:6/0to7/0:7/0to8/0:8/0to9/0:9/0to10/0:10/0to10/1:10/1to10/2:10/2to10/3:10/3to10/4:10/4to10/5:10/5to10/6:10/6to10/7:10/7to10/8:10/8to10/9:10/9to10/10:10/10to10/11:10/11to10/12:10/12to10/13:10/13to10/14:10/14to10/15:10/15to11/15:11/15to12/15:12/15to13/15:13/15to14/15:14/15to15/15:15/15totop15:,32,False,True
1377,658,818,160,8/13to9/13,9/1to8/1,8/13to9/13:9/13to9/12:9/12to9/11:9/11to9/10:9/10to9/9:9/9to9/8:9/8to9/7:9/7to9/6:9/6to9/5:9/5to9/4:9/4to9/3:9/3to9/2:9/2to9/1:9/1to8/1:,14,False,True
1145,659,851,192,4/3to4/2,15/0tobottom15,4/3to4/2:4/2to5/2:5/2to6/2:6/2to7/2:7/2to8/2:8/2to9/2:9/2to10/2:10/2to10/1:10/1to11/1:11/1to11/0:11/0to12/0:12/0to13/0:13/0to14/0:14/0to15/0:15/0tobottom15:,15,True,True
158,659,1064,405,left0to0/0,15/15totop15,left0to0/0:0/0to1/0:1/0to2/0:2/0to3/0:3/0to4/0:4/0to5/0:5/0to6/0:6/0to7/0:7/0to8/0:8/0to9/0:9/0to10/0:10/0to10/1:10/1to10/2:10/2to10/3:10/3to10/4:10/4to10/5:10/5to10/6:10/6to10/7:10/7to10/8:10/8to10/9:10/9to10/10:10/10to10/11:10/11to10/12:10/12to10/13:10/13to10/14:10/14to10/15:10/15to11/15:11/15to12/15:12/15to13/15:13/15to14/15:14/15to15/15:15/15totop15:,32,False,True
847,659,770,111,13/1to12/1,11/7to11/8,13/1to12/1:12/1to11/1:11/1to11/2:11/2to11/3:11/3to11/4:11/4to11/5:11/5to11/6:11/6to11/7:11/7to11/8:,9,False,True
2592,659,790,131,4/3to3/3,8/0to9/0,4/3to3/3:3/3to3/2:3/2to3/1:3/1to3/0:3/0to4/0:4/0to5/0:5/0to6/0:6/0to7/0:7/0to8/0:8/0to9/0:,10,True,True
2821,660,739,79,4/7to4/8,8/8to8/7,4/7to4/8:4/8to5/8:5/8to6/8:6/8to7/8:7/8to8/8:8/8to8/7:,6,True,True
352,660,1155,495,right0to15/0,0/15totop0,right0to15/0:15/0to14/0:14/0to13/0:13/0to12/0:12/0to11/0:11/0to11/1:11/1to10/1:10/1to9/1:9/1to8/1:8/1to7/1:7/1to6/1:6/1to5/1:5/1to4/1:4/1to3/1:3/1to2/1:2/1to1/1:1/1to0/1:0/1to0/2:0/2to0/3:0/3to0/4:0/4to0/5:0/5to0/6:0/6to0/7:0/7to0/8:0/8to0/9:0/9to0/10:0/10to0/11:0/11to0/12:0/12to0/13:0/13to0/14:0/14to0/15:0/15totop0:,32,True,True
944,661,857,196,right7to15/7,5/9to6/9,right7to15/7:15/7to14/7:14/7to13/7:13/7to12/7:12/7to11/7:11/7to10/7:10/7to9/7:9/7to8/7:8/7to7/7:7/7to6/7:6/7to5/7:5/7to5/8:5/8to5/9:5/9to6/9:,14,False,True
2533,662,724,62,top9to9/15,9/11to10/11,top9to9/15:9/15to9/14:9/14to9/13:9/13to9/12:9/12to9/11:9/11to10/11:,6,False,True
3032,662,691,29,7/1to6/1,6/1to5/1,7/1to6/1:6/1to5/1:,2,False,True
1378,663,847,184,9/11to8/11,6/1to7/1,9/11to8/11:8/11to7/11:7/11to6/11:6/11to6/10:6/10to6/9:6/9to6/8:6/8to6/7:6/7to6/6:6/6to6/5:6/5to6/4:6/4to6/3:6/3to6/2:6/2to6/1:6/1to7/1:,14,False,True
306,663,1043,380,right0to15/0,0/15totop0,right0to15/0:15/0to14/0:14/0to13/0:13/0to12/0:12/0to11/0:11/0to10/0:10/0to9/0:9/0to8/0:8/0to7/0:7/0to6/0:6/0to5/0:5/0to4/0:4/0to3/0:3/0to2/0:2/0to1/0:1/0to0/0:0/0to0/1:0/1to0/2:0/2to0/3:0/3to0/4:0/4to0/5:0/5to0/6:0/6to0/7:0/7to0/8:0/8to0/9:0/9to0/10:0/10to0/11:0/11to0/12:0/12to0/13:0/13to0/14:0/14to0/15:0/15totop0:,32,True,True
2573,663,862,199,1/10to2/10,10/7to11/7,1/10to2/10:2/10to3/10:3/10to4/10:4/10to5/10:5/10to6/10:6/10to7/10:7/10to8/10:8/10to9/10:9/10to10/10:10/10to10/9:10/9to10/8:10/8to10/7:10/7to11/7:,13,False,True
1635,664,873,209,8/3to9/3,15/12to15/13,8/3to9/3:9/3to10/3:10/3to10/4:10/4to10/5:10/5to10/6:10/6to10/7:10/7to10/8:10/8to10/9:10/9to10/10:10/10to10/11:10/11to10/12:10/12to11/12:11/12to12/12:12/12to13/12:13/12to14/12:14/12to15/12:15/12to15/13:,17,False,True
197,664,1081,417,left0to0/0,15/15totop15,left0to0/0:0/0to1/0:1/0to2/0:2/0to3/0:3/0to4/0:4/0to5/0:5/0to6/0:6/0to7/0:7/0to8/0:8/0to9/0:9/0to10/0:10/0to10/1:10/1to10/2:10/2to10/3:10/3to10/4:10/4to10/5:10/5to10/6:10/6to10/7:10/7to10/8:10/8to10/9:10/9to10/10:10/10to10/11:10/11to10/12:10/12to10/13:10/13to10/14:10/14to10/15:10/15to11/15:11/15to12/15:12/15to13/15:13/15to14/15:14/15to15/15:15/15totop15:,32,False,True
1307,665,842,177,10/3to9/3,1/1to0/1,10/3to9/3:9/3to8/3:8/3to7/3:7/3to6/3:6/3to5/3:5/3to4/3:4/3to3/3:3/3to2/3:2/3to1/3:1/3to1/2:1/2to1/1:1/1to0/1:,12,False,True
1631,665,796,131,7/1to6/1,0/2to0/3,7/1to6/1:6/1to5/1:5/1to4/1:4/1to3/1:3/1to2/1:2/1to1/1:1/1to0/1:0/1to0/2:0/2to0/3:,9,True,True
2761,665,943,278,right1to15/1,1/1to1/0,right1to15/1:15/1to14/1:14/1to13/1:13/1to12/1:12/1to11/1:11/1to10/1:10/1to9/1:9/1to8/1:8/1to7/1:7/1to6/1:6/1to5/1:5/1to4/1:4/1to3/1:3/1to2/1:2/1to1/1:1/1to1/0:,16,False,True
1408,666,1187,521,1/7to2/7,12/13to12/12,1/7to2/7:2/7to3/7:3/7to4/7:4/7to5/7:5/7to6/7:6/7to7/7:7/7to8/7:8/7to9/7:9/7to10/7:10/7to10/8:10/8to10/9:10/9to10/10:10/10to10/11:10/11to10/12:10/12to10/13:10/13to11/13:11/13to12/13:12/13to12/12:,18,False,True
1040,666,815,149,13/13to12/13,8/7to9/7,13/13to12/13:12/13to11/13:11/13to10/13:10/13to9/13:9/13to8/13:8/13to8/12:8/12to8/11:8/11to8/10:8/10to8/9:8/9to8/8:8/8to8/7:8/7to9/7:,12,False,True
286,666,1036,370,right15to15/15,0/0tobottom0,right15to15/15:15/15to14/15:14/15to13/15:13/15to12/15:12/15to11/15:11/15to10/15:10/15to9/15:9/15to8/15:8/15to7/15:7/15to6/15:6/15to5/15:5/15to4/15:4/15to3/15:3/15to2/15:2/15to1/15:1/15to0/15:0/15to0/14:0/14to0/13:0/13to0/12:0/12to0/11:0/11to0/10:0/10to0/9:0/9to0/8:0/8to0/7:0/7to0/6:0/6to0/5:0/5to0/4:0/4to0/3:0/3to0/2:0/2to0/1:0/1to0/0:0/0tobottom0:,32,False,True
660,667,822,155,12/2to12/3,5/4to5/5,12/2to12/3:12/3to11/3:11/3to10/3:10/3to9/3:9/3to8/3:8/3to7/3:7/3to6/3:6/3to5/3:5/3to5/4:5/4to5/5:,10,True,True
2596,667,912,245,2/2to2/3,13/4to13/5,2/2to2/3:2/3to3/3:3/3to4/3:4/3to5/3:5/3to6/3:6/3to7/3:7/3to8/3:8/3to9/3:9/3to10/3:10/3to10/4:10/4to11/4:11/4to12/4:12/4to13/4:13/4to13/5:,14,False,True
1965,667,907,240,1/7to1/6,10/7to10/8,1/7to1/6:1/6to2/6:2/6to3/6:3/6to4/6:4/6to5/6:5/6to6/6:6/6to7/6:7/6to8/6:8/6to9/6:9/6to10/6:10/6to10/7:10/7to10/8:,12,True,True
871,667,796,129,6/9to5/9,0/10toleft10,6/9to5/9:5/9to4/9:4/9to3/9:3/9to2/9:2/9to1/9:1/9to0/9:0/9to0/10:0/10toleft10:,8,True,True
664,668,798,130,8/12to8/13,10/6to10/5,8/12to8/13:8/13to9/13:9/13to10/13:10/13to10/12:10/12to10/11:10/11to10/10:10/10to10/9:10/9to10/8:10/8to10/7:10/7to10/6:10/6to10/5:,11,False,True
2589,669,920,251,12/9to12/8,5/13to6/13,12/9to12/8:12/8to11/8:11/8to10/8:10/8to9/8:9/8to8/8:8/8to7/8:7/8to6/8:6/8to5/8:5/8to5/9:5/9to5/10:5/10to5/11:5/11to5/12:5/12to5/13:5/13to6/13:,14,False,True
1802,669,1035,366,8/5to8/6,13/8to13/7,8/5to8/6:8/6to8/7:8/7to9/7:9/7to10/7:10/7to10/8:10/8to11/8:11/8to12/8:12/8to13/8:13/8to13/7:,9,True,True
3267,669,772,103,11/11to10/11,7/13to7/14,11/11to10/11:10/11to9/11:9/11to8/11:8/11to7/11:7/11to7/12:7/12to7/13:7/13to7/14:,7,True,True
2267,670,826,156,2/3to3/3,11/1to11/0,2/3to3/3:3/3to4/3:4/3to5/3:5/3to6/3:6/3to7/3:7/3to8/3:8/3to9/3:9/3to10/3:10/3to10/2:10/2to11/2:11/2to11/1:11/1to11/0:,12,True,True
1165,670,751,81,9/14to8/14,4/14to4/15,9/14to8/14:8/14to7/14:7/14to6/14:6/14to5/14:5/14to4/14:4/14to4/15:,6,False,True
526,671,834,163,12/10to12/9,7/11to7/12,12/10to12/9:12/9to11/9:11/9to10/9:10/9to9/9:9/9to8/9:8/9to7/9:7/9to7/10:7/10to7/11:7/11to7/12:,9,False,True
442,671,828,157,14/11to13/11,5/13to5/14,14/11to13/11:13/11to12/11:12/11to11/11:11/11to10/11:10/11to9/11:9/11to8/11:8/11to7/11:7/11to6/11:6/11to5/11:5/11to5/12:5/12to5/13:5/13to5/14:,12,True,True
716,671,1082,411,5/8to5/7,12/11to12/10,5/8to5/7:5/7to6/7:6/7to7/7:7/7to8/7:8/7to9/7:9/7to10/7:10/7to10/8:10/8to10/9:10/9to10/10:10/10to10/11:10/11to11/11:11/11to12/11:12/11to12/10:,13,False,True
391,671,1057,386,right0to15/0,0/15totop0,right0to15/0:15/0to14/0:14/0to13/0:13/0to12/0:12/0to11/0:11/0to10/0:10/0to9/0:9/0to8/0:8/0to7/0:7/0to6/0:6/0to5/0:5/0to4/0:4/0to3/0:3/0to2/0:2/0to1/0:1/0to0/0:0/0to0/1:0/1to0/2:0/2to0/3:0/3to0/4:0/4to0/5:0/5to0/6:0/6to0/7:0/7to0/8:0/8to0/9:0/9to0/10:0/10to0/11:0/11to0/12:0/12to0/13:0/13to0/14:0/14to0/15:0/15totop0:,32,False,True
834,671,788,117,11/9to11/8,10/3to11/3,11/9to11/8:11/8to12/8:12/8to12/7:12/7to12/6:12/6to12/5:12/5to12/4:12/4to12/3:12/3to11/3:11/3to10/3:10/3to11/3:,10,True,True
2120,671,915,244,0/1to0/2,10/6to9/6,0/1to0/2:0/2to1/2:1/2to2/2:2/2to3/2:3/2to4/2:4/2to5/2:5/2to6/2:6/2to7/2:7/2to8/2:8/2to9/2:9/2to10/2:10/2to10/3:10/3to10/4:10/4to10/5:10/5to10/6:10/6to9/6:,16,False,True
2900,671,1042,371,8/3to8/4,15/7toright7,8/3to8/4:8/4to9/4:9/4to10/4:10/4to10/5:10/5to10/6:10/6to10/7:10/7to11/7:11/7to12/7:12/7to13/7:13/7to14/7:14/7to15/7:15/7toright7:,12,False,True
444,672,828,156,6/11to6/12,13/10to13/9,6/11to6/12:6/12to6/11:6/11to7/11:7/11to8/11:8/11to9/11:9/11to10/11:10/11to10/10:10/10to11/10:11/10to12/10:12/10to13/10:13/10to13/9:,11,True,True
232,672,1042,370,right15to15/15,0/0tobottom0,right15to15/15:15/15to14/15:14/15to13/15:13/15to12/15:12/15to11/15:11/15to10/15:10/15to9/15:9/15to8/15:8/15to7/15:7/15to6/15:6/15to5/15:5/15to4/15:4/15to3/15:3/15to2/15:2/15to1/15:1/15to0/15:0/15to0/14:0/14to0/13:0/13to0/12:0/12to0/11:0/11to0/10:0/10to0/9:0/9to0/8:0/8to0/7:0/7to0/6:0/6to0/5:0/5to0/4:0/4to0/3:0/3to0/2:0/2to0/1:0/1to0/0:0/0tobottom0:,32,True,True
2389,672,1090,418,right6to15/6,3/14to4/14,right6to15/6:15/6to14/6:14/6to13/6:13/6to12/6:12/6to11/6:11/6to10/6:10/6to9/6:9/6to8/6:8/6to7/6:7/6to6/6:6/6to5/6:5/6to4/6:4/6to3/6:3/6to3/7:3/7to3/8:3/8to3/9:3/9to3/10:3/10to3/11:3/11to3/12:3/12to3/13:3/13to3/14:3/14to4/14:,22,False,True
2802,672,891,219,2/1to2/2,9/9to10/9,2/1to2/2:2/2to2/3:2/3to2/4:2/4to2/5:2/5to2/6:2/6to2/7:2/7to2/8:2/8to2/9:2/9to3/9:3/9to4/9:4/9to5/9:5/9to6/9:6/9to7/9:7/9to8/9:8/9to9/9:9/9to10/9:,16,False,True
1598,672,758,86,13/12to13/13,9/13to8/13,13/12to13/13:13/13to12/13:12/13to11/13:11/13to10/13:10/13to9/13:9/13to8/13:,6,False,True
349,672,1169,497,right0to15/0,0/15totop0,right0to15/0:15/0to14/0:14/0to13/0:13/0to12/0:12/0to11/0:11/0to11/1:11/1to10/1:10/1to9/1:9/1to8/1:8/1to7/1:7/1to6/1:6/1to5/1:5/1to4/1:4/1to3/1:3/1to2/1:2/1to1/1:1/1to0/1:0/1to0/2:0/2to0/3:0/3to0/4:0/4to0/5:0/5to0/6:0/6to0/7:0/7to0/8:0/8to0/9:0/9to0/10:0/10to0/11:0/11to0/12:0/12to0/13:0/13to0/14:0/14to0/15:0/15totop0:,32,True,True
1344,672,783,111,5/11to5/10,1/13to1/14,5/11to5/10:5/10to4/10:4/10to3/10:3/10to2/10:2/10to1/10:1/10to1/11:1/11to1/12:1/12to1/13:1/13to1/14:,9,False,True
1039,672,787,115,12/13to12/12,14/7to15/7,12/13to12/12:12/12to12/11:12/11to12/10:12/10to12/9:12/9to12/8:12/8to12/7:12/7to13/7:13/7to14/7:14/7to15/7:,9,False,True
2166,673,837,164,7/7to6/7,9/15to10/15,7/7to6/7:6/7to6/8:6/8to6/9:6/9to6/10:6/10to6/11:6/11to6/12:6/12to6/13:6/13to6/14:6/14to6/15:6/15to7/15:7/15to8/15:8/15to9/15:9/15to10/15:,13,False,True
715,673,771,98,8/7to8/8,13/7to13/8,8/7to8/8:8/8to9/8:9/8to10/8:10/8to10/7:10/7to11/7:11/7to12/7:12/7to13/7:13/7to13/8:,8,False,True
1077,673,1088,415,12/7to12/6,3/15totop3,12/7to12/6:12/6to11/6:11/6to10/6:10/6to9/6:9/6to8/6:8/6to7/6:7/6to6/6:6/6to5/6:5/6to4/6:4/6to3/6:3/6to3/7:3/7to3/8:3/8to3/9:3/9to3/10:3/10to3/11:3/11to3/12:3/12to3/13:3/13to3/14:3/14to3/15:3/15totop3:,20,True,True
3293,674,824,150,6/8to6/9,11/6to12/6,6/8to6/9:6/9to7/9:7/9to8/9:8/9to9/9:9/9to10/9:10/9to10/8:10/8to10/7:10/7to10/6:10/6to11/6:11/6to12/6:,10,False,True
294,674,1073,399,right15to15/15,0/0tobottom0,right15to15/15:15/15to14/15:14/15to13/15:13/15to12/15:12/15to11/15:11/15to10/15:10/15to9/15:9/15to8/15:8/15to7/15:7/15to6/15:6/15to5/15:5/15to4/15:4/15to3/15:3/15to2/15:2/15to1/15:1/15to0/15:0/15to0/14:0/14to0/13:0/13to0/12:0/12to0/11:0/11to0/10:0/10to0/9:0/9to0/8:0/8to0/7:0/7to0/6:0/6to0/5:0/5to0/4:0/4to0/3:0/3to0/2:0/2to0/1:0/1to0/0:0/0tobottom0:,32,True,True
2670,674,1228,554,0/3to0/4,13/10to14/10,0/3to0/4:0/4to0/5:0/5to0/6:0/6to0/7:0/7to0/8:0/8to1/8:1/8to2/8:2/8to3/8:3/8to4/8:4/8to5/8:5/8to6/8:6/8to7/8:7/8to8/8:8/8to9/8:9/8to10/8:10/8to10/9:10/9to11/9:11/9to12/9:12/9to12/10:12/10to13/10:13/10to14/10:,21,True,True
16,674,1070,396,left15to0/15,15/0tobottom15,left15to0/15:0/15to1/15:1/15to2/15:2/15to3/15:3/15to4/15:4/15to5/15:5/15to6/15:6/15to7/15:7/15to8/15:8/15to9/15:9/15to10/15:10/15to10/14:10/14to10/13:10/13to10/12:10/12to10/11:10/11to10/10:10/10to10/9:10/9to10/8:10/8to10/7:10/7to10/6:10/6to10/5:10/5to10/4:10/4to10/3:10/3to10/2:10/2to10/1:10/1to10/0:10/0to11/0:11/0to12/0:12/0to13/0:13/0to14/0:14/0to15/0:15/0tobottom15:,32,False,True
685,674,770,96,3/9to2/9,1/14to1/15,3/9to2/9:2/9to1/9:1/9to1/10:1/10to1/11:1/11to1/12:1/12to1/13:1/13to1/14:1/14to1/15:,8,True,True
3302,674,782,108,4/13to5/13,10/13to11/13,4/13to5/13:5/13to6/13:6/13to7/13:7/13to8/13:8/13to9/13:9/13to10/13:10/13to11/13:,7,True,True
3053,676,787,111,6/3to5/3,3/8to2/8,6/3to5/3:5/3to4/3:4/3to3/3:3/3to3/4:3/4to3/5:3/5to3/6:3/6to3/7:3/7to3/8:3/8to2/8:,9,True,True
3056,676,997,321,2/14to2/13,14/0tobottom14,2/14to2/13:2/13to2/12:2/12to2/11:2/11to2/10:2/10to2/9:2/9to2/8:2/8to2/7:2/7to2/6:2/6to2/5:2/5to2/4:2/4to2/3:2/3to2/2:2/2to2/1:2/1to2/0:2/0to3/0:3/0to4/0:4/0to5/0:5/0to6/0:6/0to7/0:7/0to8/0:8/0to9/0:9/0to10/0:10/0to11/0:11/0to12/0:12/0to13/0:13/0to14/0:14/0tobottom14:,27,True,True
1110,676,1018,342,15/4to14/4,5/10to5/11,15/4to14/4:14/4to13/4:13/4to12/4:12/4to11/4:11/4to10/4:10/4to9/4:9/4to8/4:8/4to7/4:7/4to6/4:6/4to5/4:5/4to5/5:5/5to5/6:5/6to5/7:5/7to5/8:5/8to5/9:5/9to5/10:5/10to5/11:,17,False,True
757,677,841,164,0/15to0/14,2/6to3/6,0/15to0/14:0/14to0/13:0/13to0/12:0/12to0/11:0/11to0/10:0/10to0/9:0/9to0/8:0/8to0/7:0/7to0/6:0/6to1/6:1/6to2/6:2/6to3/6:,12,True,True
1388,677,821,144,2/4to2/5,6/10to7/10,2/4to2/5:2/5to2/6:2/6to2/7:2/7to2/8:2/8to2/9:2/9to2/10:2/10to3/10:3/10to4/10:4/10to5/10:5/10to6/10:6/10to7/10:,11,True,True
2968,677,783,106,4/14to5/14,6/8to6/7,4/14to5/14:5/14to5/13:5/13to5/12:5/12to5/11:5/11to5/10:5/10to5/9:5/9to5/8:5/8to6/8:6/8to6/7:,9,True,True
947,678,1133,455,2/2to2/1,12/11to13/11,2/2to2/1:2/1to2/2:2/2to2/3:2/3to2/4:2/4to2/5:2/5to2/6:2/6to2/7:2/7to2/8:2/8to2/9:2/9to2/10:2/10to3/10:3/10to4/10:4/10to5/10:5/10to6/10:6/10to7/10:7/10to8/10:8/10to9/10:9/10to10/10:10/10to10/11:10/11to11/11:11/11to12/11:12/11to13/11:,22,True,True
2881,678,1001,323,15/9to15/10,6/5to6/4,15/9to15/10:15/10to14/10:14/10to13/10:13/10to12/10:12/10to11/10:11/10to10/10:10/10to9/10:9/10to8/10:8/10to7/10:7/10to6/10:6/10to6/9:6/9to6/8:6/8to6/7:6/7to6/6:6/6to6/5:6/5to6/4:,16,True,True
2057,678,821,143,left10to0/10,5/5to5/4,left10to0/10:0/10to0/9:0/9to0/8:0/8to0/7:0/7to0/6:0/6to0/5:0/5to1/5:1/5to2/5:2/5to3/5:3/5to4/5:4/5to5/5:5/5to5/4:,12,False,True
3016,678,889,211,10/15to10/14,15/5to15/4,10/15to10/14:10/14to10/13:10/13to10/12:10/12to10/11:10/11to10/10:10/10to10/9:10/9to10/8:10/8to10/7:10/7to10/6:10/6to10/5:10/5to11/5:11/5to12/5:12/5to13/5:13/5to14/5:14/5to15/5:15/5to15/4:,16,False,True
468,678,987,309,12/7to12/8,4/14to4/15,12/7to12/8:12/8to11/8:11/8to10/8:10/8to9/8:9/8to8/8:8/8to7/8:7/8to6/8:6/8to5/8:5/8to4/8:4/8to4/9:4/9to4/10:4/10to4/11:4/11to4/12:4/12to4/13:4/13to4/14:4/14to4/15:,16,False,True
423,678,1154,476,5/4to6/4,13/7to14/7,5/4to6/4:6/4to7/4:7/4to8/4:8/4to9/4:9/4to10/4:10/4to10/5:10/5to10/6:10/6to10/7:10/7to11/7:11/7to12/7:12/7to13/7:13/7to14/7:,12,False,True
2775,678,735,57,13/9to13/10,14/12to14/13,13/9to13/10:13/10to13/11:13/11to13/12:13/12to14/12:14/12to14/13:,5,False,True
3202,678,877,199,10/7to10/6,1/1to2/1,10/7to10/6:10/6to9/6:9/6to8/6:8/6to7/6:7/6to6/6:6/6to5/6:5/6to4/6:4/6to3/6:3/6to2/6:2/6to1/6:1/6to1/5:1/5to1/4:1/4to1/3:1/3to1/2:1/2to1/1:1/1to2/1:,16,False,True
1896,679,808,129,13/11to13/10,13/0tobottom13,13/11to13/10:13/10to13/9:13/9to13/8:13/8to13/7:13/7to13/6:13/6to13/5:13/5to13/4:13/4to13/3:13/3to13/2:13/2to13/1:13/1to13/0:13/0tobottom13:,12,False,True
3344,679,758,79,6/12to6/13,2/13to2/14,6/12to6/13:6/13to5/13:5/13to4/13:4/13to3/13:3/13to2/13:2/13to2/14:,6,False,True
2535,679,818,139,12/13to11/13,6/9to6/8,12/13to11/13:11/13to10/13:10/13to9/13:9/13to8/13:8/13to7/13:7/13to6/13:6/13to6/12:6/12to6/11:6/11to6/10:6/10to6/9:6/9to6/8:,11,False,True
1651,679,729,50,8/2to7/2,6/3to5/3,8/2to7/2:7/2to6/2:6/2to6/3:6/3to5/3:,4,False,True
865,680,706,26,5/13to6/13,6/13to7/13,5/13to6/13:6/13to7/13:,2,True,True
1638,680,878,198,3/15to4/15,14/11to15/11,3/15to4/15:4/15to4/14:4/14to4/13:4/13to4/12:4/12to5/12:5/12to6/12:6/12to7/12:7/12to8/12:8/12to9/12:9/12to10/12:10/12to10/11:10/11to11/11:11/11to12/11:12/11to13/11:13/11to14/11:14/11to15/11:,16,True,True
2713,681,942,261,bottom11to11/0,1/10to1/11,bottom11to11/0:11/0to10/0:10/0to9/0:9/0to8/0:8/0to7/0:7/0to6/0:6/0to5/0:5/0to4/0:4/0to3/0:3/0to2/0:2/0to1/0:1/0to1/1:1/1to1/2:1/2to1/3:1/3to1/4:1/4to1/5:1/5to1/6:1/6to1/7:1/7to1/8:1/8to1/9:1/9to1/10:1/10to1/11:,22,False,True
1539,681,972,291,left6to0/6,12/1to13/1,left6to0/6:0/6to0/5:0/5to0/4:0/4to0/3:0/3to1/3:1/3to2/3:2/3to3/3:3/3to4/3:4/3to5/3:5/3to6/3:6/3to7/3:7/3to8/3:8/3to9/3:9/3to10/3:10/3to10/2:10/2to11/2:11/2to12/2:12/2to12/1:12/1to13/1:,19,True,True
2335,681,829,148,6/7to7/7,10/14to11/14,6/7to7/7:7/7to7/8:7/8to7/9:7/9to7/10:7/10to7/11:7/11to7/12:7/12to7/13:7/13to7/14:7/14to8/14:8/14to9/14:9/14to10/14:10/14to11/14:,12,True,True
3052,682,927,245,11/11to11/10,4/11to3/11,11/11to11/10:11/10to10/10:10/10to9/10:9/10to8/10:8/10to7/10:7/10to6/10:6/10to5/10:5/10to4/10:4/10to4/11:4/11to3/11:,10,False,True
1910,682,974,292,left4to0/4,11/13to12/13,left4to0/4:0/4to0/5:0/5to0/6:0/6to0/7:0/7to0/8:0/8to0/9:0/9to0/10:0/10to0/11:0/11to1/11:1/11to2/11:2/11to3/11:3/11to4/11:4/11to5/11:5/11to6/11:6/11to7/11:7/11to8/11:8/11to9/11:9/11to10/11:10/11to10/12:10/12to11/12:11/12to11/13:11/13to12/13:,22,True,True
1856,684,858,174,5/3to5/4,3/15totop3,5/3to5/4:5/4to4/4:4/4to3/4:3/4to3/5:3/5to3/6:3/6to3/7:3/7to3/8:3/8to3/9:3/9to3/10:3/10to3/11:3/11to3/12:3/12to3/13:3/13to3/14:3/14to3/15:3/15totop3:,15,False,True
287,684,1075,391,right15to15/15,0/0tobottom0,right15to15/15:15/15to14/15:14/15to13/15:13/15to12/15:12/15to11/15:11/15to10/15:10/15to9/15:9/15to8/15:8/15to7/15:7/15to6/15:6/15to5/15:5/15to4/15:4/15to3/15:3/15to2/15:2/15to1/15:1/15to0/15:0/15to0/14:0/14to0/13:0/13to0/12:0/12to0/11:0/11to0/10:0/10to0/9:0/9to0/8:0/8to0/7:0/7to0/6:0/6to0/5:0/5to0/4:0/4to0/3:0/3to0/2:0/2to0/1:0/1to0/0:0/0tobottom0:,32,False,True
2687,685,865,180,15/3to15/2,8/8to8/9,15/3to15/2:15/2to14/2:14/2to13/2:13/2to12/2:12/2to11/2:11/2to10/2:10/2to9/2:9/2to8/2:8/2to8/3:8/3to8/4:8/4to8/5:8/5to8/6:8/6to8/7:8/7to8/8:8/8to8/9:,15,False,True
53,685,1072,387,left15to0/15,15/0tobottom15,left15to0/15:0/15to1/15:1/15to2/15:2/15to3/15:3/15to4/15:4/15to5/15:5/15to6/15:6/15to7/15:7/15to8/15:8/15to9/15:9/15to10/15:10/15to10/14:10/14to10/13:10/13to10/12:10/12to10/11:10/11to10/10:10/10to10/9:10/9to10/8:10/8to10/7:10/7to10/6:10/6to10/5:10/5to10/4:10/4to10/3:10/3to10/2:10/2to10/1:10/1to10/0:10/0to11/0:11/0to12/0:12/0to13/0:13/0to14/0:14/0to15/0:15/0tobottom15:,32,False,True
307,686,1161,475,right0to15/0,0/15totop0,right0to15/0:15/0to14/0:14/0to13/0:13/0to12/0:12/0to11/0:11/0to11/1:11/1to10/1:10/1to9/1:9/1to8/1:8/1to7/1:7/1to6/1:6/1to5/1:5/1to4/1:4/1to3/1:3/1to2/1:2/1to1/1:1/1to0/1:0/1to0/2:0/2to0/3:0/3to0/4:0/4to0/5:0/5to0/6:0/6to0/7:0/7to0/8:0/8to0/9:0/9to0/10:0/10to0/11:0/11to0/12:0/12to0/13:0/13to0/14:0/14to0/15:0/15totop0:,32,True,True
2946,686,903,217,13/4to12/4,3/5to3/6,13/4to12/4:12/4to11/4:11/4to10/4:10/4to9/4:9/4to8/4:8/4to7/4:7/4to6/4:6/4to5/4:5/4to4/4:4/4to3/4:3/4to3/5:3/5to3/6:,12,False,True
1537,687,828,141,2/3to3/3,10/2to10/1,2/3to3/3:3/3to4/3:4/3to5/3:5/3to6/3:6/3to7/3:7/3to8/3:8/3to9/3:9/3to10/3:10/3to10/2:10/2to10/1:,10,False,True
2725,687,981,294,left4to0/4,13/4to14/4,left4to0/4:0/4to0/3:0/3to1/3:1/3to2/3:2/3to3/3:3/3to4/3:4/3to5/3:5/3to6/3:6/3to7/3:7/3to8/3:8/3to9/3:9/3to10/3:10/3to11/3:11/3to12/3:12/3to12/4:12/4to13/4:13/4to14/4:,17,True,True
2376,687,904,217,2/15to3/15,12/10to12/9,2/15to3/15:3/15to3/14:3/14to3/13:3/13to3/12:3/12to4/12:4/12to5/12:5/12to6/12:6/12to7/12:7/12to8/12:8/12to9/12:9/12to10/12:10/12to10/11:10/11to11/11:11/11to12/11:12/11to12/10:12/10to12/9:,16,True,True
1610,688,719,31,11/15to12/15,13/15totop13,11/15to12/15:12/15to13/15:13/15totop13:,3,False,True
293,689,1101,412,right15to15/15,0/0tobottom0,right15to15/15:15/15to14/15:14/15to13/15:13/15to12/15:12/15to11/15:11/15to10/15:10/15to9/15:9/15to8/15:8/15to7/15:7/15to6/15:6/15to5/15:5/15to4/15:4/15to3/15:3/15to2/15:2/15to1/15:1/15to0/15:0/15to0/14:0/14to0/13:0/13to0/12:0/12to0/11:0/11to0/10:0/10to0/9:0/9to0/8:0/8to0/7:0/7to0/6:0/6to0/5:0/5to0/4:0/4to0/3:0/3to0/2:0/2to0/1:0/1to0/0:0/0tobottom0:,32,True,True
3238,689,884,195,5/9to6/9,15/6toright6,5/9to6/9:6/9to7/9:7/9to8/9:8/9to9/9:9/9to10/9:10/9to10/8:10/8to10/7:10/7to10/6:10/6to11/6:11/6to12/6:12/6to13/6:13/6to14/6:14/6to15/6:15/6toright6:,14,False,True
249,689,1120,431,right15to15/15,0/0tobottom0,right15to15/15:15/15to14/15:14/15to13/15:13/15to12/15:12/15to11/15:11/15to10/15:10/15to9/15:9/15to8/15:8/15to7/15:7/15to6/15:6/15to5/15:5/15to4/15:4/15to3/15:3/15to2/15:2/15to1/15:1/15to0/15:0/15to0/14:0/14to0/13:0/13to0/12:0/12to0/11:0/11to0/10:0/10to0/9:0/9to0/8:0/8to0/7:0/7to0/6:0/6to0/5:0/5to0/4:0/4to0/3:0/3to0/2:0/2to0/1:0/1to0/0:0/0tobottom0:,32,False,True
2679,689,872,183,3/2to3/1,13/4to13/5,3/2to3/1:3/1to3/2:3/2to4/2:4/2to5/2:5/2to6/2:6/2to7/2:7/2to8/2:8/2to9/2:9/2to10/2:10/2to10/3:10/3to11/3:11/3to12/3:12/3to12/4:12/4to13/4:13/4to13/5:,15,True,True
783,689,927,238,9/1to9/2,14/8to15/8,9/1to9/2:9/2to9/3:9/3to9/4:9/4to9/5:9/5to9/6:9/6to9/7:9/7to9/8:9/8to10/8:10/8to11/8:11/8to12/8:12/8to13/8:13/8to14/8:14/8to15/8:,13,True,True
1732,689,804,115,9/11to8/11,3/9to4/9,9/11to8/11:8/11to7/11:7/11to6/11:6/11to5/11:5/11to4/11:4/11to3/11:3/11to3/10:3/10to3/9:3/9to4/9:,9,False,True
2401,689,852,163,13/15to14/15,15/4to15/5,13/15to14/15:14/15to14/14:14/14to14/13:14/13to14/12:14/12to14/11:14/11to14/10:14/10to14/9:14/9to14/8:14/8to14/7:14/7to14/6:14/6to14/5:14/5to14/4:14/4to15/4:15/4to15/5:,14,True,True
250,690,1122,432,right15to15/15,0/0tobottom0,right15to15/15:15/15to14/15:14/15to13/15:13/15to12/15:12/15to11/15:11/15to10/15:10/15to9/15:9/15to8/15:8/15to7/15:7/15to6/15:6/15to5/15:5/15to4/15:4/15to3/15:3/15to2/15:2/15to1/15:1/15to0/15:0/15to0/14:0/14to0/13:0/13to0/12:0/12to0/11:0/11to0/10:0/10to0/9:0/9to0/8:0/8to0/7:0/7to0/6:0/6to0/5:0/5to0/4:0/4to0/3:0/3to0/2:0/2to0/1:0/1to0/0:0/0tobottom0:,32,False,True
2549,690,1073,383,11/10to11/9,0/9to0/8,11/10to11/9:11/9to11/10:11/10to10/10:10/10to9/10:9/10to8/10:8/10to7/10:7/10to6/10:6/10to5/10:5/10to4/10:4/10to3/10:3/10to2/10:2/10to1/10:1/10to0/10:0/10to0/9:0/9to0/8:,15,True,True
3289,691,1115,424,15/0to15/1,0/7to0/8,15/0to15/1:15/1to14/1:14/1to13/1:13/1to12/1:12/1to11/1:11/1to10/1:10/1to9/1:9/1to8/1:8/1to7/1:7/1to6/1:6/1to5/1:5/1to4/1:4/1to3/1:3/1to2/1:2/1to1/1:1/1to0/1:0/1to0/2:0/2to0/3:0/3to0/4:0/4to0/5:0/5to0/6:0/6to0/7:0/7to0/8:,23,False,True
1739,691,811,120,13/2to12/2,7/3to8/3,13/2to12/2:12/2to11/2:11/2to10/2:10/2to9/2:9/2to8/2:8/2to7/2:7/2to7/3:7/3to8/3:,8,True,True
1974,692,801,109,10/15to10/14,15/12toright12,10/15to10/14:10/14to10/13:10/13to10/12:10/12to11/12:11/12to12/12:12/12to13/12:13/12to14/12:14/12to15/12:15/12toright12:,9,False,True
2085,692,890,198,9/4to9/3,10/14to11/14,9/4to9/3:9/3to10/3:10/3to10/4:10/4to10/5:10/5to10/6:10/6to10/7:10/7to10/8:10/8to10/9:10/9to10/10:10/10to10/11:10/11to10/12:10/12to10/13:10/13to10/14:10/14to11/14:,14,False,True
3329,692,904,212,4/11to5/11,15/9to15/10,4/11to5/11:5/11to6/11:6/11to7/11:7/11to8/11:8/11to9/11:9/11to10/11:10/11to10/10:10/10to10/9:10/9to11/9:11/9to12/9:12/9to13/9:13/9to14/9:14/9to15/9:15/9to15/10:,14,False,True
2034,693,1011,318,13/4to12/4,2/8to1/8,13/4to12/4:12/4to11/4:11/4to10/4:10/4to9/4:9/4to8/4:8/4to7/4:7/4to6/4:6/4to5/4:5/4to4/4:4/4to3/4:3/4to2/4:2/4to2/5:2/5to2/6:2/6to2/7:2/7to2/8:2/8to1/8:,16,False,True
2448,693,849,156,9/1to9/2,5/9to5/10,9/1to9/2:9/2to8/2:8/2to7/2:7/2to6/2:6/2to5/2:5/2to5/3:5/3to5/4:5/4to5/5:5/5to5/6:5/6to5/7:5/7to5/8:5/8to5/9:5/9to5/10:,13,False,True
1700,693,821,128,11/11to11/10,15/5toright5,11/11to11/10:11/10to11/9:11/9to11/8:11/8to11/7:11/7to11/6:11/6to11/5:11/5to12/5:12/5to13/5:13/5to14/5:14/5to15/5:15/5toright5:,11,False,True
242,693,1123,430,right15to15/15,0/0tobottom0,right15to15/15:15/15to14/15:14/15to13/15:13/15to12/15:12/15to11/15:11/15to11/14:11/14to10/14:10/14to9/14:9/14to8/14:8/14to7/14:7/14to6/14:6/14to5/14:5/14to4/14:4/14to3/14:3/14to2/14:2/14to1/14:1/14to0/14:0/14to0/13:0/13to0/12:0/12to0/11:0/11to0/10:0/10to0/9:0/9to0/8:0/8to0/7:0/7to0/6:0/6to0/5:0/5to0/4:0/4to0/3:0/3to0/2:0/2to0/1:0/1to0/0:0/0tobottom0:,32,True,True
1045,693,977,284,top9to9/15,0/2to0/1,top9to9/15:9/15to8/15:8/15to7/15:7/15to6/15:6/15to5/15:5/15to4/15:4/15to3/15:3/15to2/15:2/15to1/15:1/15to0/15:0/15to0/14:0/14to0/13:0/13to0/12:0/12to0/11:0/11to0/10:0/10to0/9:0/9to0/8:0/8to0/7:0/7to0/6:0/6to0/5:0/5to0/4:0/4to0/3:0/3to0/2:0/2to0/1:,24,True,True
161,694,1111,417,left0to0/0,15/15totop15,left0to0/0:0/0to0/1:0/1to0/2:0/2to0/3:0/3to0/4:0/4to0/5:0/5to0/6:0/6to0/7:0/7to0/8:0/8to0/9:0/9to0/10:0/10to0/11:0/11to0/12:0/12to0/13:0/13to0/14:0/14to1/14:1/14to2/14:2/14to3/14:3/14to4/14:4/14to5/14:5/14to6/14:6/14to7/14:7/14to8/14:8/14to9/14:9/14to10/14:10/14to10/15:10/15to11/15:11/15to12/15:12/15to13/15:13/15to14/15:14/15to15/15:15/15totop15:,32,True,True
1155,694,1003,309,0/15to0/14,12/5to12/6,0/15to0/14:0/14to1/14:1/14to2/14:2/14to3/14:3/14to4/14:4/14to5/14:5/14to6/14:6/14to7/14:7/14to8/14:8/14to9/14:9/14to10/14:10/14to10/13:10/13to10/12:10/12to10/11:10/11to10/10:10/10to10/9:10/9to10/8:10/8to10/7:10/7to10/6:10/6to10/5:10/5to11/5:11/5to12/5:12/5to12/6:,23,False,True
876,695,781,86,12/11to11/11,9/14to8/14,12/11to11/11:11/11to10/11:10/11to10/12:10/12to10/13:10/13to10/14:10/14to9/14:9/14to8/14:,7,False,True
3189,695,784,89,7/10to7/11,6/7to6/6,7/10to7/11:7/11to6/11:6/11to6/10:6/10to6/9:6/9to6/8:6/8to6/7:6/7to6/6:,7,True,True
1993,695,852,157,4/4to5/4,13/1to14/1,4/4to5/4:5/4to5/3:5/3to6/3:6/3to7/3:7/3to8/3:8/3to9/3:9/3to10/3:10/3to10/2:10/2to11/2:11/2to12/2:12/2to12/1:12/1to13/1:13/1to14/1:,13,True,True
1566,695,791,96,10/6to10/7,6/6to6/5,10/6to10/7:10/7to9/7:9/7to8/7:8/7to7/7:7/7to6/7:6/7to6/6:6/6to6/5:,7,True,True
740,695,787,92,9/8to9/7,8/12to8/13,9/8to9/7:9/7to8/7:8/7to8/8:8/8to8/9:8/9to8/10:8/10to8/11:8/11to8/12:8/12to8/13:,8,False,True
946,695,787,92,12/5to12/6,13/11to14/11,12/5to12/6:12/6to12/7:12/7to12/8:12/8to12/9:12/9to12/10:12/10to12/11:12/11to13/11:13/11to14/11:,8,False,True
2052,696,817,121,2/15to1/15,2/8to3/8,2/15to1/15:1/15to1/14:1/14to1/13:1/13to1/12:1/12to1/11:1/11to1/10:1/10to1/9:1/9to1/8:1/8to2/8:2/8to3/8:,10,True,True
3004,696,901,205,7/2to8/2,10/11to11/11,7/2to8/2:8/2to9/2:9/2to10/2:10/2to10/3:10/3to10/4:10/4to10/5:10/5to10/6:10/6to10/7:10/7to10/8:10/8to10/9:10/9to10/10:10/10to10/11:10/11to11/11:,13,False,True
659,696,777,81,5/9to4/9,1/10to1/11,5/9to4/9:4/9to3/9:3/9to2/9:2/9to1/9:1/9to1/10:1/10to1/11:,6,False,True
755,697,949,252,1/11to2/11,13/7to13/6,1/11to2/11:2/11to3/11:3/11to4/11:4/11to5/11:5/11to6/11:6/11to7/11:7/11to8/11:8/11to9/11:9/11to10/11:10/11to10/10:10/10to10/9:10/9to10/8:10/8to10/7:10/7to11/7:11/7to12/7:12/7to13/7:13/7to13/6:,17,False,True
573,697,830,133,1/10to1/9,2/0tobottom2,1/10to1/9:1/9to1/8:1/8to1/7:1/7to1/6:1/6to1/5:1/5to1/4:1/4to1/3:1/3to1/2:1/2to1/1:1/1to1/0:1/0to2/0:2/0tobottom2:,12,True,True
792,697,739,42,right5to15/5,13/5to13/4,right5to15/5:15/5to14/5:14/5to13/5:13/5to13/4:,4,False,True
2388,698,901,203,2/6to3/6,14/4to15/4,2/6to3/6:3/6to4/6:4/6to5/6:5/6to6/6:6/6to7/6:7/6to8/6:8/6to9/6:9/6to10/6:10/6to10/5:10/5to10/4:10/4to11/4:11/4to12/4:12/4to13/4:13/4to14/4:14/4to15/4:,15,False,True
1319,698,1188,490,2/8to2/7,12/8to13/8,2/8to2/7:2/7to3/7:3/7to4/7:4/7to5/7:5/7to6/7:6/7to7/7:7/7to8/7:8/7to9/7:9/7to10/7:10/7to10/8:10/8to11/8:11/8to12/8:12/8to13/8:,13,False,True
793,698,1010,312,2/3to3/3,12/9to12/10,2/3to3/3:3/3to4/3:4/3to5/3:5/3to6/3:6/3to7/3:7/3to8/3:8/3to9/3:9/3to10/3:10/3to10/4:10/4to10/5:10/5to10/6:10/6to10/7:10/7to10/8:10/8to10/9:10/9to11/9:11/9to12/9:12/9to12/10:,17,False,True
3008,698,1136,438,14/4to13/4,0/9to1/9,14/4to13/4:13/4to12/4:12/4to11/4:11/4to10/4:10/4to9/4:9/4to8/4:8/4to7/4:7/4to6/4:6/4to5/4:5/4to4/4:4/4to3/4:3/4to2/4:2/4to1/4:1/4to0/4:0/4to0/5:0/5to0/6:0/6to0/7:0/7to0/8:0/8to0/9:0/9to1/9:,20,True,True
1164,698,1234,536,1/8to1/7,15/8toright8,1/8to1/7:1/7to2/7:2/7to3/7:3/7to4/7:4/7to5/7:5/7to6/7:6/7to7/7:7/7to8/7:8/7to9/7:9/7to10/7:10/7to10/8:10/8to11/8:11/8to12/8:12/8to13/8:13/8to14/8:14/8to15/8:15/8toright8:,17,False,True
1160,699,1009,310,15/7to15/8,5/3to6/3,15/7to15/8:15/8to14/8:14/8to13/8:13/8to12/8:12/8to11/8:11/8to10/8:10/8to9/8:9/8to8/8:8/8to7/8:7/8to6/8:6/8to5/8:5/8to5/7:5/7to5/6:5/6to5/5:5/5to5/4:5/4to5/3:5/3to6/3:,17,True,True
948,699,924,225,1/6to2/6,14/5to15/5,1/6to2/6:2/6to2/5:2/5to3/5:3/5to4/5:4/5to5/5:5/5to6/5:6/5to7/5:7/5to8/5:8/5to9/5:9/5to10/5:10/5to11/5:11/5to12/5:12/5to13/5:13/5to14/5:14/5to15/5:,15,True,True
396,699,1074,375,right0to15/0,0/15totop0,right0to15/0:15/0to14/0:14/0to13/0:13/0to12/0:12/0to11/0:11/0to10/0:10/0to9/0:9/0to8/0:8/0to7/0:7/0to6/0:6/0to5/0:5/0to4/0:4/0to3/0:3/0to2/0:2/0to1/0:1/0to0/0:0/0to0/1:0/1to0/2:0/2to0/3:0/3to0/4:0/4to0/5:0/5to0/6:0/6to0/7:0/7to0/8:0/8to0/9:0/9to0/10:0/10to0/11:0/11to0/12:0/12to0/13:0/13to0/14:0/14to0/15:0/15totop0:,32,False,True
851,699,893,194,4/11to4/12,0/1toleft1,4/11to4/12:4/12to3/12:3/12to2/12:2/12to1/12:1/12to0/12:0/12to0/11:0/11to0/10:0/10to0/9:0/9to0/8:0/8to0/7:0/7to0/6:0/6to0/5:0/5to0/4:0/4to0/3:0/3to0/2:0/2to0/1:0/1toleft1:,17,False,True
2507,701,854,153,5/14to6/14,8/5to8/6,5/14to6/14:6/14to6/13:6/13to6/12:6/12to6/11:6/11to6/10:6/10to6/9:6/9to6/8:6/8to6/7:6/7to6/6:6/6to6/5:6/5to7/5:7/5to8/5:8/5to8/6:,13,False,True
1411,701,853,152,bottom6to6/0,11/6to12/6,bottom6to6/0:6/0to7/0:7/0to8/0:8/0to9/0:9/0to10/0:10/0to10/1:10/1to10/2:10/2to10/3:10/3to10/4:10/4to10/5:10/5to10/6:10/6to11/6:11/6to12/6:,13,False,True
2958,701,912,211,10/3to11/3,15/15toright15,10/3to11/3:11/3to11/4:11/4to11/5:11/5to11/6:11/6to11/7:11/7to11/8:11/8to11/9:11/9to11/10:11/10to11/11:11/11to11/12:11/12to11/13:11/13to11/14:11/14to11/15:11/15to12/15:12/15to13/15:13/15to14/15:14/15to15/15:15/15toright15:,18,False,True
2700,702,868,166,14/13to13/13,15/3to15/2,14/13to13/13:13/13to13/12:13/12to13/11:13/11to13/10:13/10to13/9:13/9to13/8:13/8to13/7:13/7to13/6:13/6to13/5:13/5to13/4:13/4to13/3:13/3to14/3:14/3to15/3:15/3to15/2:,14,False,True
1312,702,795,93,right7to15/7,11/6to11/5,right7to15/7:15/7to14/7:14/7to13/7:13/7to12/7:12/7to11/7:11/7to11/6:11/6to11/5:,7,False,True
1729,703,831,128,5/9to4/9,1/14to1/15,5/9to4/9:4/9to3/9:3/9to2/9:2/9to1/9:1/9to1/10:1/10to1/11:1/11to1/12:1/12to1/13:1/13to1/14:1/14to1/15:,10,True,True
1405,703,899,196,8/15to9/15,10/1to10/0,8/15to9/15:9/15to10/15:10/15to10/14:10/14to10/13:10/13to10/12:10/12to10/11:10/11to10/10:10/10to10/9:10/9to10/8:10/8to10/7:10/7to10/6:10/6to10/5:10/5to10/4:10/4to10/3:10/3to10/2:10/2to10/1:10/1to10/0:,17,False,True
1446,704,886,182,4/10to5/10,13/5to13/4,4/10to5/10:5/10to6/10:6/10to7/10:7/10to8/10:8/10to9/10:9/10to10/10:10/10to10/9:10/9to10/8:10/8to10/7:10/7to10/6:10/6to10/5:10/5to11/5:11/5to12/5:12/5to13/5:13/5to13/4:,15,False,True
1659,704,1069,365,1/11to1/10,15/13toright13,1/11to1/10:1/10to2/10:2/10to3/10:3/10to4/10:4/10to5/10:5/10to6/10:6/10to7/10:7/10to8/10:8/10to9/10:9/10to10/10:10/10to10/11:10/11to10/12:10/12to10/13:10/13to11/13:11/13to12/13:12/13to13/13:13/13to14/13:14/13to15/13:15/13toright13:,19,False,True
2474,704,863,159,5/12to5/13,10/8to11/8,5/12to5/13:5/13to5/12:5/12to5/11:5/11to5/10:5/10to5/9:5/9to5/8:5/8to6/8:6/8to7/8:7/8to8/8:8/8to9/8:9/8to10/8:10/8to11/8:,12,True,True
1015,704,871,167,11/13to11/12,10/1to9/1,11/13to11/12:11/12to10/12:10/12to10/11:10/11to10/10:10/10to10/9:10/9to10/8:10/8to10/7:10/7to10/6:10/6to10/5:10/5to10/4:10/4to10/3:10/3to10/2:10/2to10/1:10/1to9/1:,14,False,True
2292,705,823,118,bottom3to3/0,5/7to5/6,bottom3to3/0:3/0to3/1:3/1to3/2:3/2to3/3:3/3to3/4:3/4to3/5:3/5to3/6:3/6to3/7:3/7to4/7:4/7to5/7:5/7to5/6:,11,False,True
1534,705,797,92,4/10to3/10,4/15to5/15,4/10to3/10:3/10to3/11:3/11to3/12:3/12to3/13:3/13to3/14:3/14to3/15:3/15to4/15:4/15to5/15:,8,True,True
1820,705,810,105,5/9to5/10,1/9to1/8,5/9to5/10:5/10to4/10:4/10to3/10:3/10to2/10:2/10to1/10:1/10to1/9:1/9to1/8:,7,True,True
1681,705,1032,327,left0to0/0,11/13to11/12,left0to0/0:0/0to1/0:1/0to2/0:2/0to3/0:3/0to4/0:4/0to5/0:5/0to6/0:6/0to7/0:7/0to8/0:8/0to9/0:9/0to10/0:10/0to10/1:10/1to10/2:10/2to10/3:10/3to10/4:10/4to10/5:10/5to10/6:10/6to10/7:10/7to10/8:10/8to10/9:10/9to10/10:10/10to10/11:10/11to10/12:10/12to10/13:10/13to11/13:11/13to11/12:,26,False,True
1703,706,760,54,5/12to5/13,6/15totop6,5/12to5/13:5/13to5/14:5/14to5/15:5/15to6/15:6/15totop6:,5,False,True
1472,706,787,81,5/7to4/7,4/12to5/12,5/7to4/7:4/7to4/8:4/8to4/9:4/9to4/10:4/10to4/11:4/11to4/12:4/12to5/12:,7,False,True
3360,706,834,128,5/0to5/1,6/9to7/9,5/0to5/1:5/1to5/2:5/2to5/3:5/3to5/4:5/4to5/5:5/5to5/6:5/6to5/7:5/7to5/8:5/8to5/9:5/9to6/9:6/9to7/9:,11,False,True
2982,706,800,94,8/12to8/13,4/15totop4,8/12to8/13:8/13to7/13:7/13to6/13:6/13to5/13:5/13to4/13:4/13to4/14:4/14to4/15:4/15totop4:,8,False,True
3230,706,779,73,1/3to1/4,2/7to2/8,1/3to1/4:1/4to1/5:1/5to1/6:1/6to1/7:1/7to2/7:2/7to2/8:,6,True,True
2048,706,817,111,12/1to12/0,8/2to7/2,12/1to12/0:12/0to11/0:11/0to10/0:10/0to9/0:9/0to8/0:8/0to8/1:8/1to8/2:8/2to7/2:,8,False,True
1658,707,888,181,7/10to7/9,14/4to14/3,7/10to7/9:7/9to7/8:7/8to7/7:7/7to7/6:7/6to8/6:8/6to9/6:9/6to10/6:10/6to10/5:10/5to11/5:11/5to12/5:12/5to12/4:12/4to13/4:13/4to14/4:14/4to14/3:,14,True,True
569,707,856,149,4/2to4/1,2/10to2/11,4/2to4/1:4/1to3/1:3/1to2/1:2/1to2/2:2/2to2/3:2/3to2/4:2/4to2/5:2/5to2/6:2/6to2/7:2/7to2/8:2/8to2/9:2/9to2/10:2/10to2/11:,13,True,True
2800,707,943,236,5/0to5/1,10/2to11/2,5/0to5/1:5/1to6/1:6/1to7/1:7/1to8/1:8/1to9/1:9/1to10/1:10/1to10/2:10/2to11/2:,8,False,True
2159,708,835,127,12/0to11/0,9/6to8/6,12/0to11/0:11/0to10/0:10/0to10/1:10/1to10/2:10/2to10/3:10/3to10/4:10/4to10/5:10/5to10/6:10/6to9/6:9/6to8/6:,10,False,True
2167,709,791,82,14/6to13/6,13/11to13/12,14/6to13/6:13/6to13/7:13/7to13/8:13/8to13/9:13/9to13/10:13/10to13/11:13/11to13/12:,7,False,True
183,709,1105,396,left0to0/0,15/15totop15,left0to0/0:0/0to1/0:1/0to2/0:2/0to3/0:3/0to4/0:4/0to5/0:5/0to6/0:6/0to7/0:7/0to8/0:8/0to9/0:9/0to10/0:10/0to10/1:10/1to10/2:10/2to10/3:10/3to10/4:10/4to10/5:10/5to10/6:10/6to10/7:10/7to10/8:10/8to10/9:10/9to10/10:10/10to10/11:10/11to10/12:10/12to10/13:10/13to10/14:10/14to10/15:10/15to11/15:11/15to12/15:12/15to13/15:13/15to14/15:14/15to15/15:15/15totop15:,32,False,True
193,709,1113,404,left0to0/0,15/15totop15,left0to0/0:0/0to1/0:1/0to2/0:2/0to3/0:3/0to4/0:4/0to5/0:5/0to6/0:6/0to7/0:7/0to8/0:8/0to9/0:9/0to10/0:10/0to10/1:10/1to10/2:10/2to10/3:10/3to10/4:10/4to10/5:10/5to10/6:10/6to10/7:10/7to10/8:10/8to10/9:10/9to10/10:10/10to10/11:10/11to10/12:10/12to10/13:10/13to10/14:10/14to10/15:10/15to11/15:11/15to12/15:12/15to13/15:13/15to14/15:14/15to15/15:15/15totop15:,32,False,True
2887,711,804,93,5/13to5/12,7/10to7/11,5/13to5/12:5/12to5/11:5/11to5/10:5/10to6/10:6/10to7/10:7/10to7/11:,6,False,True
1320,711,831,120,8/12to8/11,4/8to3/8,8/12to8/11:8/11to7/11:7/11to6/11:6/11to5/11:5/11to4/11:4/11to4/10:4/10to4/9:4/9to4/8:4/8to3/8:,9,False,True
2251,711,772,61,2/5to3/5,4/3to5/3,2/5to3/5:3/5to3/4:3/4to3/3:3/3to4/3:4/3to5/3:,5,False,True
97,711,1090,379,left15to0/15,15/0tobottom15,left15to0/15:0/15to1/15:1/15to2/15:2/15to3/15:3/15to4/15:4/15to5/15:5/15to6/15:6/15to7/15:7/15to8/15:8/15to9/15:9/15to10/15:10/15to10/14:10/14to10/13:10/13to10/12:10/12to10/11:10/11to10/10:10/10to10/9:10/9to10/8:10/8to10/7:10/7to10/6:10/6to10/5:10/5to10/4:10/4to10/3:10/3to10/2:10/2to10/1:10/1to10/0:10/0to11/0:11/0to12/0:12/0to13/0:13/0to14/0:14/0to15/0:15/0tobottom15:,32,False,True
2022,712,900,188,6/2to5/2,8/13to9/13,6/2to5/2:5/2to5/3:5/3to5/4:5/4to5/5:5/5to5/6:5/6to5/7:5/7to5/8:5/8to5/9:5/9to5/10:5/10to5/11:5/11to5/12:5/12to5/13:5/13to6/13:6/13to7/13:7/13to8/13:8/13to9/13:,16,False,True
938,712,826,114,1/14to1/13,1/5to1/4,1/14to1/13:1/13to1/12:1/12to1/11:1/11to1/10:1/10to1/9:1/9to1/8:1/8to1/7:1/7to1/6:1/6to1/5:1/5to1/4:,10,True,True
2173,712,1109,397,14/1to13/1,5/15to4/15,14/1to13/1:13/1to12/1:12/1to11/1:11/1to10/1:10/1to9/1:9/1to8/1:8/1to7/1:7/1to6/1:6/1to5/1:5/1to5/2:5/2to5/3:5/3to5/4:5/4to5/5:5/5to5/6:5/6to5/7:5/7to5/8:5/8to5/9:5/9to5/10:5/10to5/11:5/11to5/12:5/12to5/13:5/13to5/14:5/14to5/15:5/15to4/15:,24,False,True
2027,713,974,261,9/9to9/10,10/12to10/13,9/9to9/10:9/10to10/10:10/10to10/11:10/11to10/12:10/12to10/13:,5,False,True
1649,713,876,163,right9to15/9,8/4to8/3,right9to15/9:15/9to14/9:14/9to13/9:13/9to12/9:12/9to11/9:11/9to10/9:10/9to9/9:9/9to8/9:8/9to8/8:8/8to8/7:8/7to8/6:8/6to8/5:8/5to8/4:8/4to8/3:,14,False,True
1075,713,865,152,0/10to1/10,6/6to7/6,0/10to1/10:1/10to1/9:1/9to1/8:1/8to1/7:1/7to1/6:1/6to2/6:2/6to3/6:3/6to4/6:4/6to5/6:5/6to6/6:6/6to7/6:,11,False,True
727,714,834,120,7/12to7/11,1/12to1/13,7/12to7/11:7/11to6/11:6/11to5/11:5/11to4/11:4/11to3/11:3/11to2/11:2/11to1/11:1/11to1/12:1/12to1/13:,9,True,True
2207,714,858,144,15/6to15/7,10/11to10/12,15/6to15/7:15/7to14/7:14/7to13/7:13/7to12/7:12/7to11/7:11/7to10/7:10/7to10/8:10/8to10/9:10/9to10/10:10/10to10/11:10/11to10/12:,11,False,True
34,714,1088,374,left15to0/15,15/0tobottom15,left15to0/15:0/15to1/15:1/15to2/15:2/15to3/15:3/15to4/15:4/15to5/15:5/15to6/15:6/15to7/15:7/15to8/15:8/15to9/15:9/15to10/15:10/15to10/14:10/14to10/13:10/13to10/12:10/12to10/11:10/11to10/10:10/10to10/9:10/9to10/8:10/8to10/7:10/7to10/6:10/6to10/5:10/5to10/4:10/4to10/3:10/3to10/2:10/2to10/1:10/1to10/0:10/0to11/0:11/0to12/0:12/0to13/0:13/0to14/0:14/0to15/0:15/0tobottom15:,32,False,True
2703,715,860,145,8/9to7/9,6/0to5/0,8/9to7/9:7/9to6/9:6/9to6/8:6/8to6/7:6/7to6/6:6/6to6/5:6/5to6/4:6/4to6/3:6/3to6/2:6/2to6/1:6/1to6/0:6/0to5/0:,12,False,True
1946,715,890,175,5/4to5/3,14/1to14/0,5/4to5/3:5/3to5/2:5/2to6/2:6/2to7/2:7/2to8/2:8/2to9/2:9/2to10/2:10/2to10/1:10/1to11/1:11/1to12/1:12/1to13/1:13/1to14/1:14/1to14/0:,13,True,True
914,715,789,74,14/14to13/14,11/12to11/11,14/14to13/14:13/14to12/14:12/14to11/14:11/14to11/13:11/13to11/12:11/12to11/11:,6,True,True
1321,715,845,130,0/10to0/9,4/6to5/6,0/10to0/9:0/9to0/8:0/8to0/7:0/7to0/6:0/6to1/6:1/6to2/6:2/6to3/6:3/6to4/6:4/6to5/6:,9,True,True
1662,716,1062,346,15/5to15/4,4/7to4/8,15/5to15/4:15/4to14/4:14/4to13/4:13/4to12/4:12/4to11/4:11/4to10/4:10/4to9/4:9/4to8/4:8/4to7/4:7/4to6/4:6/4to5/4:5/4to4/4:4/4to4/5:4/5to4/6:4/6to4/7:4/7to4/8:,16,True,True
2765,717,1165,448,2/5to2/6,10/10to9/10,2/5to2/6:2/6to2/7:2/7to2/8:2/8to3/8:3/8to4/8:4/8to5/8:5/8to6/8:6/8to7/8:7/8to8/8:8/8to9/8:9/8to10/8:10/8to10/9:10/9to10/10:10/10to9/10:,14,True,True
254,717,1125,408,right15to15/15,0/0tobottom0,right15to15/15:15/15to14/15:14/15to13/15:13/15to12/15:12/15to11/15:11/15to10/15:10/15to9/15:9/15to8/15:8/15to7/15:7/15to6/15:6/15to5/15:5/15to4/15:4/15to3/15:3/15to2/15:2/15to1/15:1/15to0/15:0/15to0/14:0/14to0/13:0/13to0/12:0/12to0/11:0/11to0/10:0/10to0/9:0/9to0/8:0/8to0/7:0/7to0/6:0/6to0/5:0/5to0/4:0/4to0/3:0/3to0/2:0/2to0/1:0/1to0/0:0/0tobottom0:,32,True,True
445,717,983,266,10/12to9/12,0/7to1/7,10/12to9/12:9/12to8/12:8/12to7/12:7/12to6/12:6/12to5/12:5/12to4/12:4/12to3/12:3/12to2/12:2/12to1/12:1/12to0/12:0/12to0/11:0/11to0/10:0/10to0/9:0/9to0/8:0/8to0/7:0/7to1/7:,16,False,True
2956,717,980,263,right6to15/6,8/5to7/5,right6to15/6:15/6to14/6:14/6to13/6:13/6to12/6:12/6to11/6:11/6to10/6:10/6to9/6:9/6to8/6:8/6to8/5:8/5to7/5:,10,False,True
2130,717,892,175,10/1to9/1,1/4to1/5,10/1to9/1:9/1to8/1:8/1to7/1:7/1to6/1:6/1to5/1:5/1to4/1:4/1to3/1:3/1to2/1:2/1to1/1:1/1to1/2:1/2to1/3:1/3to1/4:1/4to1/5:,13,True,True
679,718,851,133,left1to0/1,4/6to5/6,left1to0/1:0/1to0/2:0/2to0/3:0/3to0/4:0/4to0/5:0/5to0/6:0/6to1/6:1/6to2/6:2/6to3/6:3/6to4/6:4/6to5/6:,11,True,True
789,718,919,201,11/14to11/13,14/0tobottom14,11/14to11/13:11/13to11/12:11/12to11/11:11/11to11/10:11/10to11/9:11/9to11/8:11/8to11/7:11/7to11/6:11/6to11/5:11/5to11/4:11/4to11/3:11/3to11/2:11/2to11/1:11/1to11/0:11/0to12/0:12/0to13/0:13/0to14/0:14/0tobottom14:,18,True,True
55,718,1109,391,left15to0/15,15/0tobottom15,left15to0/15:0/15to0/14:0/14to0/13:0/13to0/12:0/12to0/11:0/11to0/10:0/10to0/9:0/9to0/8:0/8to0/7:0/7to0/6:0/6to0/5:0/5to0/4:0/4to0/3:0/3to0/2:0/2to0/1:0/1to0/0:0/0to1/0:1/0to2/0:2/0to3/0:3/0to4/0:4/0to5/0:5/0to6/0:6/0to7/0:7/0to8/0:8/0to9/0:9/0to10/0:10/0to11/0:11/0to12/0:12/0to13/0:13/0to14/0:14/0to15/0:15/0tobottom15:,32,True,True
2901,718,951,233,bottom14to14/0,6/10to6/11,bottom14to14/0:14/0to13/0:13/0to12/0:12/0to11/0:11/0to10/0:10/0to9/0:9/0to8/0:8/0to7/0:7/0to6/0:6/0to6/1:6/1to6/2:6/2to6/3:6/3to6/4:6/4to6/5:6/5to6/6:6/6to6/7:6/7to6/8:6/8to6/9:6/9to6/10:6/10to6/11:,20,False,True
862,719,1067,348,13/7to13/6,3/11to3/12,13/7to13/6:13/6to12/6:12/6to11/6:11/6to10/6:10/6to9/6:9/6to8/6:8/6to7/6:7/6to6/6:6/6to5/6:5/6to4/6:4/6to3/6:3/6to3/7:3/7to3/8:3/8to3/9:3/9to3/10:3/10to3/11:3/11to3/12:,17,True,True
2288,719,833,114,10/8to10/7,11/0tobottom11,10/8to10/7:10/7to10/6:10/6to10/5:10/5to10/4:10/4to10/3:10/3to10/2:10/2to10/1:10/1to10/0:10/0to11/0:11/0tobottom11:,10,False,True
2241,719,1003,284,9/1to9/2,15/15totop15,9/1to9/2:9/2to10/2:10/2to10/3:10/3to10/4:10/4to10/5:10/5to10/6:10/6to10/7:10/7to10/8:10/8to10/9:10/9to10/10:10/10to10/11:10/11to10/12:10/12to10/13:10/13to10/14:10/14to10/15:10/15to11/15:11/15to12/15:12/15to13/15:13/15to14/15:14/15to15/15:15/15totop15:,21,False,True
3123,720,1209,489,2/2to2/3,11/10to11/9,2/2to2/3:2/3to2/4:2/4to2/5:2/5to2/6:2/6to2/7:2/7to2/8:2/8to3/8:3/8to4/8:4/8to5/8:5/8to6/8:6/8to7/8:7/8to8/8:8/8to9/8:9/8to10/8:10/8to10/9:10/9to11/9:11/9to11/10:11/10to11/9:,18,True,True
2692,720,918,198,11/7to10/7,1/7to1/6,11/7to10/7:10/7to9/7:9/7to8/7:8/7to7/7:7/7to6/7:6/7to5/7:5/7to4/7:4/7to3/7:3/7to2/7:2/7to1/7:1/7to1/6:,11,False,True
963,720,906,186,15/14to15/15,12/5to12/4,15/14to15/15:15/15to14/15:14/15to13/15:13/15to12/15:12/15to12/14:12/14to12/13:12/13to12/12:12/12to12/11:12/11to12/10:12/10to12/9:12/9to12/8:12/8to12/7:12/7to12/6:12/6to12/5:12/5to12/4:,15,False,True
2479,720,955,235,1/12to1/13,13/14to14/14,1/12to1/13:1/13to2/13:2/13to3/13:3/13to4/13:4/13to5/13:5/13to6/13:6/13to7/13:7/13to8/13:8/13to9/13:9/13to10/13:10/13to10/14:10/14to11/14:11/14to12/14:12/14to13/14:13/14to14/14:,15,True,True
3210,720,953,233,4/11to4/12,11/2to11/3,4/11to4/12:4/12to4/11:4/11to4/10:4/10to4/9:4/9to4/8:4/8to4/7:4/7to4/6:4/6to4/5:4/5to4/4:4/4to4/3:4/3to5/3:5/3to6/3:6/3to7/3:7/3to8/3:8/3to9/3:9/3to10/3:10/3to10/2:10/2to11/2:11/2to11/3:,19,True,True
1454,721,927,206,13/7to12/7,5/8to4/8,13/7to12/7:12/7to11/7:11/7to10/7:10/7to9/7:9/7to8/7:8/7to7/7:7/7to6/7:6/7to5/7:5/7to5/8:5/8to4/8:,10,True,True
797,721,831,110,9/14to8/14,8/7to8/6,9/14to8/14:8/14to8/13:8/13to8/12:8/12to8/11:8/11to8/10:8/10to8/9:8/9to8/8:8/8to8/7:8/7to8/6:,9,False,True
1863,722,1196,474,2/6to2/7,14/9to14/8,2/6to2/7:2/7to2/8:2/8to3/8:3/8to4/8:4/8to5/8:5/8to6/8:6/8to7/8:7/8to8/8:8/8to9/8:9/8to10/8:10/8to10/9:10/9to11/9:11/9to12/9:12/9to13/9:13/9to14/9:14/9to14/8:,16,True,True
3243,722,928,206,6/7to6/8,12/1to13/1,6/7to6/8:6/8to7/8:7/8to8/8:8/8to9/8:9/8to10/8:10/8to10/7:10/7to10/6:10/6to10/5:10/5to10/4:10/4to10/3:10/3to10/2:10/2to10/1:10/1to11/1:11/1to12/1:12/1to13/1:,15,False,True
1277,722,934,212,10/3to10/4,1/0to2/0,10/3to10/4:10/4to9/4:9/4to8/4:8/4to7/4:7/4to6/4:6/4to5/4:5/4to4/4:4/4to3/4:3/4to2/4:2/4to1/4:1/4to1/3:1/3to1/2:1/2to1/1:1/1to1/0:1/0to2/0:,15,False,True
2215,723,847,124,4/11to4/10,8/7to9/7,4/11to4/10:4/10to4/9:4/9to4/8:4/8to4/7:4/7to5/7:5/7to6/7:6/7to7/7:7/7to8/7:8/7to9/7:,9,True,True
2242,723,853,130,4/13to4/14,12/14to13/14,4/13to4/14:4/14to5/14:5/14to6/14:6/14to7/14:7/14to8/14:8/14to9/14:9/14to10/14:10/14to11/14:11/14to12/14:12/14to13/14:,10,False,True
459,723,1071,348,11/8to10/8,0/13toleft13,11/8to10/8:10/8to9/8:9/8to8/8:8/8to7/8:7/8to6/8:6/8to5/8:5/8to4/8:4/8to3/8:3/8to2/8:2/8to1/8:1/8to0/8:0/8to0/9:0/9to0/10:0/10to0/11:0/11to0/12:0/12to0/13:0/13toleft13:,17,True,True
1943,724,876,152,top4to4/15,4/3to4/2,top4to4/15:4/15to4/14:4/14to4/13:4/13to4/12:4/12to4/11:4/11to4/10:4/10to4/9:4/9to4/8:4/8to4/7:4/7to4/6:4/6to4/5:4/5to4/4:4/4to4/3:4/3to4/2:,14,True,True
1600,724,877,153,8/6to8/5,13/1to14/1,8/6to8/5:8/5to9/5:9/5to10/5:10/5to10/4:10/4to10/3:10/3to10/2:10/2to10/1:10/1to11/1:11/1to12/1:12/1to13/1:13/1to14/1:,11,False,True
1152,724,910,186,6/7to6/8,1/1to1/0,6/7to6/8:6/8to5/8:5/8to4/8:4/8to3/8:3/8to2/8:2/8to1/8:1/8to1/7:1/7to1/6:1/6to1/5:1/5to1/4:1/4to1/3:1/3to1/2:1/2to1/1:1/1to1/0:,14,True,True
1650,724,838,114,4/6to4/7,4/15to5/15,4/6to4/7:4/7to4/8:4/8to4/9:4/9to4/10:4/10to4/11:4/11to4/12:4/12to4/13:4/13to4/14:4/14to4/15:4/15to5/15:,10,True,True
18,724,1112,388,left15to0/15,15/0tobottom15,left15to0/15:0/15to0/14:0/14to0/13:0/13to0/12:0/12to0/11:0/11to0/10:0/10to0/9:0/9to0/8:0/8to0/7:0/7to0/6:0/6to0/5:0/5to0/4:0/4to0/3:0/3to0/2:0/2to0/1:0/1to0/0:0/0to1/0:1/0to2/0:2/0to3/0:3/0to4/0:4/0to5/0:5/0to6/0:6/0to7/0:7/0to8/0:8/0to9/0:9/0to10/0:10/0to11/0:11/0to12/0:12/0to13/0:13/0to14/0:14/0to15/0:15/0tobottom15:,32,True,True
1458,725,852,127,0/0to0/1,4/3to5/3,0/0to0/1:0/1to0/2:0/2to0/3:0/3to1/3:1/3to2/3:2/3to3/3:3/3to4/3:4/3to5/3:,8,True,True
2494,725,897,172,10/12to10/11,8/1to8/0,10/12to10/11:10/11to9/11:9/11to8/11:8/11to8/10:8/10to8/9:8/9to8/8:8/8to8/7:8/7to8/6:8/6to8/5:8/5to8/4:8/4to8/3:8/3to8/2:8/2to8/1:8/1to8/0:,14,True,True
237,726,1115,389,right15to15/15,0/0tobottom0,right15to15/15:15/15to14/15:14/15to13/15:13/15to12/15:12/15to11/15:11/15to10/15:10/15to9/15:9/15to8/15:8/15to7/15:7/15to6/15:6/15to5/15:5/15to4/15:4/15to3/15:3/15to2/15:2/15to1/15:1/15to0/15:0/15to0/14:0/14to0/13:0/13to0/12:0/12to0/11:0/11to0/10:0/10to0/9:0/9to0/8:0/8to0/7:0/7to0/6:0/6to0/5:0/5to0/4:0/4to0/3:0/3to0/2:0/2to0/1:0/1to0/0:0/0tobottom0:,32,False,True
1426,726,821,95,8/1to7/1,2/1to2/0,8/1to7/1:7/1to6/1:6/1to5/1:5/1to4/1:4/1to3/1:3/1to2/1:2/1to2/0:,7,True,True
3207,727,919,192,11/4to11/5,7/5to7/4,11/4to11/5:11/5to10/5:10/5to9/5:9/5to8/5:8/5to7/5:7/5to7/4:,6,False,True
3099,727,869,142,13/14to13/15,9/9to9/8,13/14to13/15:13/15to12/15:12/15to11/15:11/15to10/15:10/15to10/14:10/14to10/13:10/13to10/12:10/12to10/11:10/11to10/10:10/10to10/9:10/9to9/9:9/9to9/8:,12,False,True
2417,728,825,97,4/6to4/5,1/2to0/2,4/6to4/5:4/5to3/5:3/5to2/5:2/5to1/5:1/5to1/4:1/4to1/3:1/3to1/2:1/2to0/2:,8,False,True
1696,728,912,184,left5to0/5,2/14to3/14,left5to0/5:0/5to0/6:0/6to0/7:0/7to0/8:0/8to0/9:0/9to0/10:0/10to0/11:0/11to0/12:0/12to0/13:0/13to0/14:0/14to1/14:1/14to2/14:2/14to3/14:,13,False,True
414,729,985,256,13/7to12/7,3/5to4/5,13/7to12/7:12/7to11/7:11/7to10/7:10/7to9/7:9/7to8/7:8/7to7/7:7/7to6/7:6/7to5/7:5/7to4/7:4/7to3/7:3/7to3/6:3/6to3/5:3/5to4/5:,13,False,True
3347,729,856,127,1/7to2/7,5/12to6/12,1/7to2/7:2/7to2/8:2/8to2/9:2/9to2/10:2/10to2/11:2/11to2/12:2/12to3/12:3/12to4/12:4/12to5/12:5/12to6/12:,10,True,True
2882,730,850,120,10/8to9/8,5/4to5/3,10/8to9/8:9/8to8/8:8/8to7/8:7/8to6/8:6/8to5/8:5/8to5/7:5/7to5/6:5/6to5/5:5/5to5/4:5/4to5/3:,10,False,True
2089,730,921,191,15/2to14/2,10/12to9/12,15/2to14/2:14/2to13/2:13/2to12/2:12/2to11/2:11/2to10/2:10/2to10/3:10/3to10/4:10/4to10/5:10/5to10/6:10/6to10/7:10/7to10/8:10/8to10/9:10/9to10/10:10/10to10/11:10/11to10/12:10/12to9/12:,16,False,True
3324,730,974,244,1/7to1/6,12/2to13/2,1/7to1/6:1/6to1/5:1/5to1/4:1/4to1/3:1/3to1/2:1/2to2/2:2/2to3/2:3/2to4/2:4/2to5/2:5/2to6/2:6/2to7/2:7/2to8/2:8/2to9/2:9/2to10/2:10/2to11/2:11/2to12/2:12/2to13/2:,17,True,True
728,730,1161,431,11/3to11/4,1/14to1/15,11/3to11/4:11/4to10/4:10/4to9/4:9/4to8/4:8/4to7/4:7/4to6/4:6/4to5/4:5/4to4/4:4/4to3/4:3/4to2/4:2/4to1/4:1/4to1/5:1/5to1/6:1/6to1/7:1/7to1/8:1/8to1/9:1/9to1/10:1/10to1/11:1/11to1/12:1/12to1/13:1/13to1/14:1/14to1/15:,22,False,True
888,730,848,118,7/14to7/13,9/8to9/9,7/14to7/13:7/13to7/12:7/12to7/11:7/11to7/10:7/10to7/9:7/9to7/8:7/8to8/8:8/8to9/8:9/8to9/9:,9,False,True
328,731,1113,382,right0to15/0,0/15totop0,right0to15/0:15/0to14/0:14/0to13/0:13/0to12/0:12/0to11/0:11/0to10/0:10/0to9/0:9/0to8/0:8/0to7/0:7/0to6/0:6/0to5/0:5/0to4/0:4/0to3/0:3/0to2/0:2/0to1/0:1/0to0/0:0/0to0/1:0/1to0/2:0/2to0/3:0/3to0/4:0/4to0/5:0/5to0/6:0/6to0/7:0/7to0/8:0/8to0/9:0/9to0/10:0/10to0/11:0/11to0/12:0/12to0/13:0/13to0/14:0/14to0/15:0/15totop0:,32,True,True
3172,731,847,116,5/9to5/8,8/4to8/5,5/9to5/8:5/8to5/7:5/7to5/6:5/6to5/5:5/5to5/4:5/4to6/4:6/4to7/4:7/4to8/4:8/4to8/5:,9,True,True
1918,731,790,59,6/13to6/12,6/9to5/9,6/13to6/12:6/12to6/11:6/11to6/10:6/10to6/9:6/9to5/9:,5,False,True
2279,731,854,123,10/5to9/5,7/10to6/10,10/5to9/5:9/5to8/5:8/5to7/5:7/5to7/6:7/6to7/7:7/7to7/8:7/8to7/9:7/9to7/10:7/10to6/10:,9,False,True
2102,732,843,111,8/10to7/10,4/15totop4,8/10to7/10:7/10to6/10:6/10to5/10:5/10to4/10:4/10to4/11:4/11to4/12:4/12to4/13:4/13to4/14:4/14to4/15:4/15totop4:,10,True,True
1758,732,967,235,0/7to0/6,11/1to12/1,0/7to0/6:0/6to0/5:0/5to0/4:0/4to0/3:0/3to0/2:0/2to1/2:1/2to2/2:2/2to3/2:3/2to4/2:4/2to5/2:5/2to6/2:6/2to7/2:7/2to8/2:8/2to9/2:9/2to10/2:10/2to10/1:10/1to11/1:11/1to12/1:,18,True,True
978,732,770,38,13/13to13/12,14/12to15/12,13/13to13/12:13/12to14/12:14/12to15/12:,3,False,True
1868,733,806,73,1/6to0/6,0/2to0/1,1/6to0/6:0/6to0/5:0/5to0/4:0/4to0/3:0/3to0/2:0/2to0/1:,6,True,True
470,733,800,67,3/11to2/11,4/10to4/9,3/11to2/11:2/11to2/10:2/10to3/10:3/10to4/10:4/10to4/9:,5,True,True
2652,733,1015,282,14/10to13/10,7/13to8/13,14/10to13/10:13/10to12/10:12/10to11/10:11/10to10/10:10/10to9/10:9/10to8/10:8/10to7/10:7/10to7/11:7/11to7/12:7/12to7/13:7/13to8/13:,11,False,True
2297,734,840,106,9/12to9/11,8/5to9/5,9/12to9/11:9/11to8/11:8/11to8/10:8/10to8/9:8/9to8/8:8/8to8/7:8/7to8/6:8/6to8/5:8/5to9/5:,9,True,True
1852,734,804,70,5/12to5/11,3/13to3/14,5/12to5/11:5/11to4/11:4/11to3/11:3/11to3/12:3/12to3/13:3/13to3/14:,6,False,True
2336,734,805,71,2/11to1/11,0/8toleft8,2/11to1/11:1/11to0/11:0/11to0/10:0/10to0/9:0/9to0/8:0/8toleft8:,6,True,True
1071,734,901,167,2/14to3/14,13/13to13/12,2/14to3/14:3/14to4/14:4/14to5/14:5/14to6/14:6/14to7/14:7/14to8/14:8/14to9/14:9/14to10/14:10/14to10/13:10/13to11/13:11/13to12/13:12/13to13/13:13/13to13/12:,13,True,True
236,735,1118,383,right15to15/15,0/0tobottom0,right15to15/15:15/15to14/15:14/15to13/15:13/15to12/15:12/15to11/15:11/15to10/15:10/15to9/15:9/15to8/15:8/15to7/15:7/15to6/15:6/15to5/15:5/15to4/15:4/15to3/15:3/15to2/15:2/15to1/15:1/15to0/15:0/15to0/14:0/14to0/13:0/13to0/12:0/12to0/11:0/11to0/10:0/10to0/9:0/9to0/8:0/8to0/7:0/7to0/6:0/6to0/5:0/5to0/4:0/4to0/3:0/3to0/2:0/2to0/1:0/1to0/0:0/0tobottom0:,32,False,True
1985,735,842,107,bottom9to9/0,8/7to9/7,bottom9to9/0:9/0to8/0:8/0to8/1:8/1to8/2:8/2to8/3:8/3to8/4:8/4to8/5:8/5to8/6:8/6to8/7:8/7to9/7:,10,False,True
2522,735,824,89,4/5to4/6,7/8to7/9,4/5to4/6:4/6to4/7:4/7to4/8:4/8to5/8:5/8to6/8:6/8to7/8:7/8to7/9:,7,False,True
2187,735,1158,423,right10to15/10,1/4to2/4,right10to15/10:15/10to14/10:14/10to13/10:13/10to12/10:12/10to11/10:11/10to10/10:10/10to9/10:9/10to8/10:8/10to7/10:7/10to6/10:6/10to5/10:5/10to4/10:4/10to3/10:3/10to2/10:2/10to1/10:1/10to1/9:1/9to1/8:1/8to1/7:1/7to1/6:1/6to1/5:1/5to1/4:1/4to2/4:,22,True,True
859,735,783,48,14/0to14/1,12/1to12/2,14/0to14/1:14/1to13/1:13/1to12/1:12/1to12/2:,4,False,True
214,735,1127,392,right15to15/15,0/0tobottom0,right15to15/15:15/15to14/15:14/15to13/15:13/15to12/15:12/15to11/15:11/15to10/15:10/15to9/15:9/15to8/15:8/15to7/15:7/15to6/15:6/15to5/15:5/15to4/15:4/15to3/15:3/15to2/15:2/15to1/15:1/15to0/15:0/15to0/14:0/14to0/13:0/13to0/12:0/12to0/11:0/11to0/10:0/10to0/9:0/9to0/8:0/8to0/7:0/7to0/6:0/6to0/5:0/5to0/4:0/4to0/3:0/3to0/2:0/2to0/1:0/1to0/0:0/0tobottom0:,32,False,True
1000,735,872,137,7/6to8/6,11/0tobottom11,7/6to8/6:8/6to8/5:8/5to8/4:8/4to8/3:8/3to8/2:8/2to9/2:9/2to10/2:10/2to10/1:10/1to11/1:11/1to11/0:11/0tobottom11:,11,True,True
322,735,1228,493,right0to15/0,0/15totop0,right0to15/0:15/0to14/0:14/0to13/0:13/0to12/0:12/0to11/0:11/0to11/1:11/1to10/1:10/1to9/1:9/1to8/1:8/1to7/1:7/1to6/1:6/1to5/1:5/1to4/1:4/1to3/1:3/1to2/1:2/1to1/1:1/1to0/1:0/1to0/2:0/2to0/3:0/3to0/4:0/4to0/5:0/5to0/6:0/6to0/7:0/7to0/8:0/8to0/9:0/9to0/10:0/10to0/11:0/11to0/12:0/12to0/13:0/13to0/14:0/14to0/15:0/15totop0:,32,True,True
2953,736,815,79,9/1to8/1,8/6to9/6,9/1to8/1:8/1to8/2:8/2to8/3:8/3to8/4:8/4to8/5:8/5to8/6:8/6to9/6:,7,True,True
2614,736,847,111,9/7to10/7,10/3to10/2,9/7to10/7:10/7to11/7:11/7to11/6:11/6to11/5:11/5to10/5:10/5to10/4:10/4to10/3:10/3to10/2:,8,True,True
1016,737,750,13,3/12to2/12,3/12to2/12,3/12to2/12:,1,False,True
1698,737,850,113,7/6to6/6,3/8to2/8,7/6to6/6:6/6to5/6:5/6to4/6:4/6to3/6:3/6to3/7:3/7to3/8:3/8to2/8:,7,False,True
243,737,1131,394,right15to15/15,0/0tobottom0,right15to15/15:15/15to14/15:14/15to13/15:13/15to12/15:12/15to11/15:11/15to10/15:10/15to9/15:9/15to8/15:8/15to7/15:7/15to6/15:6/15to5/15:5/15to4/15:4/15to3/15:3/15to2/15:2/15to1/15:1/15to0/15:0/15to0/14:0/14to0/13:0/13to0/12:0/12to0/11:0/11to0/10:0/10to0/9:0/9to0/8:0/8to0/7:0/7to0/6:0/6to0/5:0/5to0/4:0/4to0/3:0/3to0/2:0/2to0/1:0/1to0/0:0/0tobottom0:,32,True,True
215,737,1134,397,right15to15/15,0/0tobottom0,right15to15/15:15/15to14/15:14/15to13/15:13/15to12/15:12/15to11/15:11/15to10/15:10/15to9/15:9/15to8/15:8/15to7/15:7/15to6/15:6/15to5/15:5/15to4/15:4/15to3/15:3/15to2/15:2/15to1/15:1/15to0/15:0/15to0/14:0/14to0/13:0/13to0/12:0/12to0/11:0/11to0/10:0/10to0/9:0/9to0/8:0/8to0/7:0/7to0/6:0/6to0/5:0/5to0/4:0/4to0/3:0/3to0/2:0/2to0/1:0/1to0/0:0/0tobottom0:,32,True,True
2188,737,1004,267,12/4to12/5,7/2to7/1,12/4to12/5:12/5to11/5:11/5to10/5:10/5to9/5:9/5to8/5:8/5to7/5:7/5to7/4:7/4to7/3:7/3to7/2:7/2to7/1:,10,True,True
2666,737,821,84,4/10to4/9,3/5to4/5,4/10to4/9:4/9to3/9:3/9to3/8:3/8to3/7:3/7to3/6:3/6to3/5:3/5to4/5:,7,True,True
642,738,1014,276,11/6to11/5,5/6to5/7,11/6to11/5:11/5to10/5:10/5to9/5:9/5to8/5:8/5to7/5:7/5to6/5:6/5to5/5:5/5to5/6:5/6to5/7:,9,True,True
3093,738,813,75,4/10to4/11,3/15totop3,4/10to4/11:4/11to3/11:3/11to3/12:3/12to3/13:3/13to3/14:3/14to3/15:3/15totop3:,7,True,True
1115,739,841,102,4/5to4/6,2/2to3/2,4/5to4/6:4/6to3/6:3/6to2/6:2/6to2/5:2/5to2/4:2/4to2/3:2/3to2/2:2/2to3/2:,8,False,True
3106,739,907,168,2/4to1/4,6/11to6/10,2/4to1/4:1/4to1/5:1/5to1/6:1/6to1/7:1/7to1/8:1/8to1/9:1/9to1/10:1/10to1/11:1/11to2/11:2/11to3/11:3/11to4/11:4/11to5/11:5/11to6/11:6/11to6/10:,14,False,True
3033,739,1002,263,12/14to11/14,1/8to0/8,12/14to11/14:11/14to10/14:10/14to9/14:9/14to8/14:8/14to7/14:7/14to6/14:6/14to5/14:5/14to4/14:4/14to3/14:3/14to2/14:2/14to1/14:1/14to1/13:1/13to1/12:1/12to1/11:1/11to1/10:1/10to1/9:1/9to1/8:1/8to0/8:,18,True,True
2329,739,834,95,12/9to11/9,13/13to13/14,12/9to11/9:11/9to11/10:11/10to11/11:11/11to11/12:11/12to11/13:11/13to12/13:12/13to13/13:13/13to13/14:,8,True,True
2639,739,964,225,13/13to13/14,6/8to6/7,13/13to13/14:13/14to12/14:12/14to11/14:11/14to10/14:10/14to9/14:9/14to8/14:8/14to7/14:7/14to6/14:6/14to6/13:6/13to6/12:6/12to6/11:6/11to6/10:6/10to6/9:6/9to6/8:6/8to6/7:,15,False,True
297,739,1148,409,right15to15/15,0/0tobottom0,right15to15/15:15/15to14/15:14/15to13/15:13/15to12/15:12/15to11/15:11/15to10/15:10/15to9/15:9/15to8/15:8/15to7/15:7/15to6/15:6/15to5/15:5/15to4/15:4/15to3/15:3/15to2/15:2/15to1/15:1/15to0/15:0/15to0/14:0/14to0/13:0/13to0/12:0/12to0/11:0/11to0/10:0/10to0/9:0/9to0/8:0/8to0/7:0/7to0/6:0/6to0/5:0/5to0/4:0/4to0/3:0/3to0/2:0/2to0/1:0/1to0/0:0/0tobottom0:,32,True,True
1487,740,960,220,5/11to6/11,12/3to12/4,5/11to6/11:6/11to6/10:6/10to6/9:6/9to6/8:6/8to6/7:6/7to6/6:6/6to6/5:6/5to6/4:6/4to6/3:6/3to7/3:7/3to8/3:8/3to9/3:9/3to10/3:10/3to11/3:11/3to12/3:12/3to12/4:,16,True,True
661,740,959,219,3/8to3/7,12/2to13/2,3/8to3/7:3/7to4/7:4/7to5/7:5/7to6/7:6/7to7/7:7/7to8/7:8/7to9/7:9/7to10/7:10/7to10/6:10/6to10/5:10/5to10/4:10/4to10/3:10/3to10/2:10/2to11/2:11/2to12/2:12/2to13/2:,16,False,True
625,740,883,143,1/4to2/4,3/13to3/12,1/4to2/4:2/4to2/5:2/5to2/6:2/6to2/7:2/7to2/8:2/8to2/9:2/9to2/10:2/10to2/11:2/11to2/12:2/12to2/13:2/13to3/13:3/13to3/12:,12,True,True
2042,741,877,136,1/0to2/0,3/8to4/8,1/0to2/0:2/0to2/1:2/1to2/2:2/2to2/3:2/3to2/4:2/4to2/5:2/5to2/6:2/6to2/7:2/7to2/8:2/8to3/8:3/8to4/8:,11,True,True
179,741,1118,377,left0to0/0,15/15totop15,left0to0/0:0/0to0/1:0/1to0/2:0/2to0/3:0/3to0/4:0/4to0/5:0/5to0/6:0/6to0/7:0/7to0/8:0/8to0/9:0/9to0/10:0/10to0/11:0/11to0/12:0/12to0/13:0/13to1/13:1/13to2/13:2/13to3/13:3/13to4/13:4/13to5/13:5/13to6/13:6/13to7/13:7/13to8/13:8/13to9/13:9/13to10/13:10/13to10/14:10/14to11/14:11/14to11/15:11/15to12/15:12/15to13/15:13/15to14/15:14/15to15/15:15/15totop15:,32,True,True
3155,742,840,98,7/14to6/14,8/10to9/10,7/14to6/14:6/14to6/13:6/13to6/12:6/12to6/11:6/11to6/10:6/10to7/10:7/10to8/10:8/10to9/10:,8,False,True
3190,742,1066,324,15/7to14/7,1/11to2/11,15/7to14/7:14/7to13/7:13/7to12/7:12/7to11/7:11/7to10/7:10/7to9/7:9/7to8/7:8/7to7/7:7/7to6/7:6/7to5/7:5/7to4/7:4/7to3/7:3/7to2/7:2/7to1/7:1/7to1/8:1/8to1/9:1/9to1/10:1/10to1/11:1/11to2/11:,19,True,True
510,744,822,78,2/15to2/14,3/11to3/10,2/15to2/14:2/14to2/13:2/13to2/12:2/12to2/11:2/11to3/11:3/11to3/10:,6,True,True
3097,744,919,175,14/1to13/1,11/12to11/13,14/1to13/1:13/1to12/1:12/1to11/1:11/1to11/2:11/2to11/3:11/3to11/4:11/4to11/5:11/5to11/6:11/6to11/7:11/7to11/8:11/8to11/9:11/9to11/10:11/10to11/11:11/11to11/12:11/12to11/13:,15,True,True
955,745,839,94,9/9to9/8,6/11to6/12,9/9to9/8:9/8to8/8:8/8to7/8:7/8to6/8:6/8to6/9:6/9to6/10:6/10to6/11:6/11to6/12:,8,False,True
318,746,1128,382,right0to15/0,0/15totop0,right0to15/0:15/0to14/0:14/0to13/0:13/0to12/0:12/0to11/0:11/0to10/0:10/0to9/0:9/0to8/0:8/0to7/0:7/0to6/0:6/0to5/0:5/0to4/0:4/0to3/0:3/0to2/0:2/0to1/0:1/0to0/0:0/0to0/1:0/1to0/2:0/2to0/3:0/3to0/4:0/4to0/5:0/5to0/6:0/6to0/7:0/7to0/8:0/8to0/9:0/9to0/10:0/10to0/11:0/11to0/12:0/12to0/13:0/13to0/14:0/14to0/15:0/15totop0:,32,False,True
385,746,1134,388,right0to15/0,0/15totop0,right0to15/0:15/0to14/0:14/0to13/0:13/0to12/0:12/0to11/0:11/0to10/0:10/0to9/0:9/0to8/0:8/0to7/0:7/0to6/0:6/0to5/0:5/0to4/0:4/0to3/0:3/0to2/0:2/0to1/0:1/0to0/0:0/0to0/1:0/1to0/2:0/2to0/3:0/3to0/4:0/4to0/5:0/5to0/6:0/6to0/7:0/7to0/8:0/8to0/9:0/9to0/10:0/10to0/11:0/11to0/12:0/12to0/13:0/13to0/14:0/14to0/15:0/15totop0:,32,False,True
1226,746,893,147,6/4to5/4,3/12to2/12,6/4to5/4:5/4to4/4:4/4to3/4:3/4to3/5:3/5to3/6:3/6to3/7:3/7to3/8:3/8to3/9:3/9to3/10:3/10to3/11:3/11to3/12:3/12to2/12:,12,False,True
2280,747,863,116,1/2to1/3,5/5to5/6,1/2to1/3:1/3to1/4:1/4to1/5:1/5to2/5:2/5to3/5:3/5to4/5:4/5to5/5:5/5to5/6:,8,True,True
2732,747,973,226,2/11to2/12,11/6to12/6,2/11to2/12:2/12to3/12:3/12to4/12:4/12to5/12:5/12to6/12:6/12to7/12:7/12to8/12:8/12to9/12:9/12to10/12:10/12to10/11:10/11to10/10:10/10to10/9:10/9to10/8:10/8to10/7:10/7to10/6:10/6to11/6:11/6to12/6:,17,False,True
1533,747,920,173,9/8to10/8,14/0to15/0,9/8to10/8:10/8to10/7:10/7to10/6:10/6to10/5:10/5to10/4:10/4to10/3:10/3to10/2:10/2to10/1:10/1to10/0:10/0to11/0:11/0to12/0:12/0to13/0:13/0to14/0:14/0to15/0:,14,False,True
2062,747,880,133,1/15to2/15,11/15to11/14,1/15to2/15:2/15to3/15:3/15to4/15:4/15to5/15:5/15to6/15:6/15to7/15:7/15to8/15:8/15to9/15:9/15to10/15:10/15to11/15:11/15to11/14:,11,True,True
3082,747,831,84,4/11to4/12,7/14to8/14,4/11to4/12:4/12to4/13:4/13to4/14:4/14to5/14:5/14to6/14:6/14to7/14:7/14to8/14:,7,False,True
1837,747,941,194,12/14to11/14,8/6to9/6,12/14to11/14:11/14to10/14:10/14to9/14:9/14to8/14:8/14to8/13:8/13to8/12:8/12to8/11:8/11to8/10:8/10to8/9:8/9to8/8:8/8to8/7:8/7to8/6:8/6to9/6:,13,True,True
332,748,1254,506,right0to15/0,0/15totop0,right0to15/0:15/0to14/0:14/0to13/0:13/0to12/0:12/0to11/0:11/0to11/1:11/1to10/1:10/1to9/1:9/1to8/1:8/1to7/1:7/1to6/1:6/1to5/1:5/1to4/1:4/1to3/1:3/1to2/1:2/1to1/1:1/1to0/1:0/1to0/2:0/2to0/3:0/3to0/4:0/4to0/5:0/5to0/6:0/6to0/7:0/7to0/8:0/8to0/9:0/9to0/10:0/10to0/11:0/11to0/12:0/12to0/13:0/13to0/14:0/14to0/15:0/15totop0:,32,True,True
2868,749,1226,477,1/2to1/1,11/7to12/7,1/2to1/1:1/1to1/2:1/2to1/3:1/3to1/4:1/4to1/5:1/5to2/5:2/5to3/5:3/5to4/5:4/5to5/5:5/5to6/5:6/5to7/5:7/5to8/5:8/5to9/5:9/5to10/5:10/5to10/6:10/6to11/6:11/6to11/7:11/7to12/7:,18,True,True
1214,749,885,136,6/14to6/15,12/12to13/12,6/14to6/15:6/15to7/15:7/15to8/15:8/15to9/15:9/15to10/15:10/15to10/14:10/14to10/13:10/13to10/12:10/12to11/12:11/12to12/12:12/12to13/12:,11,False,True
2252,749,841,92,1/7to1/8,5/9to6/9,1/7to1/8:1/8to1/9:1/9to2/9:2/9to3/9:3/9to4/9:4/9to5/9:5/9to6/9:,7,True,True
1849,750,1017,267,5/3to5/2,14/10to15/10,5/3to5/2:5/2to6/2:6/2to7/2:7/2to8/2:8/2to9/2:9/2to10/2:10/2to10/3:10/3to10/4:10/4to10/5:10/5to10/6:10/6to10/7:10/7to10/8:10/8to10/9:10/9to10/10:10/10to11/10:11/10to12/10:12/10to13/10:13/10to14/10:14/10to15/10:,19,False,True
1617,750,836,86,1/10to1/11,3/15totop3,1/10to1/11:1/11to1/12:1/12to1/13:1/13to1/14:1/14to1/15:1/15to2/15:2/15to3/15:3/15totop3:,8,False,True
2809,750,862,112,11/14to10/14,4/14to3/14,11/14to10/14:10/14to9/14:9/14to8/14:8/14to7/14:7/14to6/14:6/14to5/14:5/14to4/14:4/14to3/14:,8,True,True
1947,750,914,164,2/4to1/4,0/15totop0,2/4to1/4:1/4to0/4:0/4to0/5:0/5to0/6:0/6to0/7:0/7to0/8:0/8to0/9:0/9to0/10:0/10to0/11:0/11to0/12:0/12to0/13:0/13to0/14:0/14to0/15:0/15totop0:,14,False,True
3020,751,962,211,2/8to3/8,11/3to12/3,2/8to3/8:3/8to3/7:3/7to3/6:3/6to3/5:3/5to4/5:4/5to5/5:5/5to6/5:6/5to7/5:7/5to8/5:8/5to9/5:9/5to10/5:10/5to10/4:10/4to11/4:11/4to11/3:11/3to12/3:,15,True,True
2116,751,800,49,13/3to13/2,14/1to15/1,13/3to13/2:13/2to13/1:13/1to14/1:14/1to15/1:,4,True,True
1987,751,797,46,9/6to9/5,9/3to8/3,9/6to9/5:9/5to9/4:9/4to9/3:9/3to8/3:,4,True,True
185,751,1145,394,left0to0/0,15/15totop15,left0to0/0:0/0to0/1:0/1to0/2:0/2to0/3:0/3to0/4:0/4to0/5:0/5to0/6:0/6to0/7:0/7to0/8:0/8to0/9:0/9to0/10:0/10to0/11:0/11to0/12:0/12to0/13:0/13to1/13:1/13to2/13:2/13to3/13:3/13to4/13:4/13to5/13:5/13to6/13:6/13to7/13:7/13to8/13:8/13to9/13:9/13to10/13:10/13to10/14:10/14to11/14:11/14to11/15:11/15to12/15:12/15to13/15:13/15to14/15:14/15to15/15:15/15totop15:,32,True,True
3025,751,845,94,4/13to3/13,3/7to3/6,4/13to3/13:3/13to3/12:3/12to3/11:3/11to3/10:3/10to3/9:3/9to3/8:3/8to3/7:3/7to3/6:,8,True,True
722,752,998,246,12/5to12/4,0/4toleft4,12/5to12/4:12/4to12/3:12/3to11/3:11/3to10/3:10/3to9/3:9/3to8/3:8/3to7/3:7/3to6/3:6/3to5/3:5/3to4/3:4/3to3/3:3/3to2/3:2/3to1/3:1/3to0/3:0/3to0/4:0/4toleft4:,16,True,True
2577,752,1049,297,5/2to6/2,15/13toright13,5/2to6/2:6/2to7/2:7/2to8/2:8/2to9/2:9/2to10/2:10/2to10/3:10/3to10/4:10/4to10/5:10/5to10/6:10/6to10/7:10/7to10/8:10/8to10/9:10/9to10/10:10/10to10/11:10/11to10/12:10/12to10/13:10/13to11/13:11/13to12/13:12/13to13/13:13/13to14/13:14/13to15/13:15/13toright13:,22,False,True
3142,753,893,140,3/12to3/11,11/10to12/10,3/12to3/11:3/11to4/11:4/11to5/11:5/11to6/11:6/11to7/11:7/11to8/11:8/11to9/11:9/11to10/11:10/11to10/10:10/10to11/10:11/10to12/10:,11,False,True
1866,753,1095,342,right5to15/5,5/4to6/4,right5to15/5:15/5to14/5:14/5to13/5:13/5to12/5:12/5to11/5:11/5to10/5:10/5to9/5:9/5to8/5:8/5to7/5:7/5to6/5:6/5to5/5:5/5to5/4:5/4to6/4:,13,False,True
1410,753,862,109,bottom7to7/0,3/4to4/4,bottom7to7/0:7/0to6/0:6/0to5/0:5/0to4/0:4/0to3/0:3/0to3/1:3/1to3/2:3/2to3/3:3/3to3/4:3/4to4/4:,10,False,True
849,753,1144,391,2/11to2/10,14/14to14/13,2/11to2/10:2/10to3/10:3/10to4/10:4/10to5/10:5/10to6/10:6/10to7/10:7/10to8/10:8/10to9/10:9/10to10/10:10/10to10/11:10/11to10/12:10/12to10/13:10/13to10/14:10/14to11/14:11/14to12/14:12/14to13/14:13/14to14/14:14/14to14/13:,18,False,True
3,754,1129,375,left15to0/15,15/0tobottom15,left15to0/15:0/15to1/15:1/15to2/15:2/15to3/15:3/15to4/15:4/15to5/15:5/15to6/15:6/15to7/15:7/15to8/15:8/15to9/15:9/15to10/15:10/15to10/14:10/14to10/13:10/13to10/12:10/12to10/11:10/11to10/10:10/10to10/9:10/9to10/8:10/8to10/7:10/7to10/6:10/6to10/5:10/5to10/4:10/4to10/3:10/3to10/2:10/2to10/1:10/1to10/0:10/0to11/0:11/0to12/0:12/0to13/0:13/0to14/0:14/0to15/0:15/0tobottom15:,32,False,True
2313,755,881,126,2/6to3/6,7/3to7/2,2/6to3/6:3/6to3/5:3/5to3/4:3/4to3/3:3/3to4/3:4/3to5/3:5/3to6/3:6/3to7/3:7/3to7/2:,9,True,True
1699,755,992,237,9/12to10/12,15/0to15/1,9/12to10/12:10/12to10/11:10/11to10/10:10/10to10/9:10/9to10/8:10/8to10/7:10/7to10/6:10/6to10/5:10/5to10/4:10/4to10/3:10/3to10/2:10/2to10/1:10/1to10/0:10/0to11/0:11/0to12/0:12/0to13/0:13/0to14/0:14/0to15/0:15/0to15/1:,19,False,True
1954,755,1007,252,14/6to14/7,4/7to3/7,14/6to14/7:14/7to13/7:13/7to12/7:12/7to11/7:11/7to10/7:10/7to9/7:9/7to8/7:8/7to7/7:7/7to6/7:6/7to5/7:5/7to4/7:4/7to3/7:,12,False,True
1483,755,999,244,14/0to13/0,6/1to6/2,14/0to13/0:13/0to12/0:12/0to11/0:11/0to11/1:11/1to10/1:10/1to9/1:9/1to8/1:8/1to7/1:7/1to6/1:6/1to6/2:,10,True,True
828,755,955,200,8/2to9/2,15/6toright6,8/2to9/2:9/2to9/3:9/3to9/4:9/4to9/5:9/5to10/5:10/5to10/6:10/6to11/6:11/6to12/6:12/6to13/6:13/6to14/6:14/6to15/6:15/6toright6:,12,True,True
565,755,1124,369,1/6to1/5,13/11to13/10,1/6to1/5:1/5to2/5:2/5to3/5:3/5to4/5:4/5to5/5:5/5to6/5:6/5to7/5:7/5to8/5:8/5to9/5:9/5to10/5:10/5to10/6:10/6to10/7:10/7to10/8:10/8to10/9:10/9to10/10:10/10to10/11:10/11to11/11:11/11to12/11:12/11to13/11:13/11to13/10:,20,False,True
1962,756,893,137,0/13to0/12,0/2to0/1,0/13to0/12:0/12to0/11:0/11to0/10:0/10to0/9:0/9to0/8:0/8to0/7:0/7to0/6:0/6to0/5:0/5to0/4:0/4to0/3:0/3to0/2:0/2to0/1:,12,True,True
378,756,1262,506,right0to15/0,0/15totop0,right0to15/0:15/0to14/0:14/0to13/0:13/0to12/0:12/0to11/0:11/0to11/1:11/1to10/1:10/1to9/1:9/1to8/1:8/1to7/1:7/1to6/1:6/1to5/1:5/1to4/1:4/1to3/1:3/1to2/1:2/1to1/1:1/1to0/1:0/1to0/2:0/2to0/3:0/3to0/4:0/4to0/5:0/5to0/6:0/6to0/7:0/7to0/8:0/8to0/9:0/9to0/10:0/10to0/11:0/11to0/12:0/12to0/13:0/13to0/14:0/14to0/15:0/15totop0:,32,True,True
817,757,1013,256,9/11to8/11,1/1to1/0,9/11to8/11:8/11to7/11:7/11to6/11:6/11to5/11:5/11to4/11:4/11to3/11:3/11to2/11:2/11to1/11:1/11to1/10:1/10to1/9:1/9to1/8:1/8to1/7:1/7to1/6:1/6to1/5:1/5to1/4:1/4to1/3:1/3to1/2:1/2to1/1:1/1to1/0:,19,True,True
641,757,835,78,right11to15/11,12/13to11/13,right11to15/11:15/11to14/11:14/11to13/11:13/11to12/11:12/11to12/12:12/12to12/13:12/13to11/13:,7,True,True
2845,757,829,72,8/4to8/3,9/1to9/2,8/4to8/3:8/3to8/2:8/2to8/1:8/1to9/1:9/1to9/2:,5,True,True
598,757,839,82,7/1to7/0,5/3to5/4,7/1to7/0:7/0to6/0:6/0to5/0:5/0to5/1:5/1to5/2:5/2to5/3:5/3to5/4:,7,True,True
2749,758,1017,259,top0to0/15,6/0tobottom6,top0to0/15:0/15to0/14:0/14to0/13:0/13to0/12:0/12to0/11:0/11to0/10:0/10to0/9:0/9to0/8:0/8to0/7:0/7to0/6:0/6to0/5:0/5to0/4:0/4to0/3:0/3to0/2:0/2to0/1:0/1to0/0:0/0to1/0:1/0to2/0:2/0to3/0:3/0to4/0:4/0to5/0:5/0to6/0:6/0tobottom6:,23,False,True
3090,758,996,238,1/7to1/8,14/4to14/5,1/7to1/8:1/8to1/7:1/7to1/6:1/6to2/6:2/6to3/6:3/6to4/6:4/6to5/6:5/6to6/6:6/6to7/6:7/6to8/6:8/6to9/6:9/6to10/6:10/6to10/5:10/5to11/5:11/5to12/5:12/5to12/4:12/4to13/4:13/4to14/4:14/4to14/5:,19,True,True
968,758,846,88,6/5to5/5,4/1to4/0,6/5to5/5:5/5to4/5:4/5to4/4:4/4to4/3:4/3to4/2:4/2to4/1:4/1to4/0:,7,False,True
2807,758,887,129,5/9to6/9,7/1to7/2,5/9to6/9:6/9to6/8:6/8to6/7:6/7to6/6:6/6to6/5:6/5to6/4:6/4to6/3:6/3to6/2:6/2to6/1:6/1to7/1:7/1to7/2:,11,False,True
843,758,966,208,top4to4/15,7/2to7/3,top4to4/15:4/15to4/14:4/14to4/13:4/13to4/12:4/12to4/11:4/11to4/10:4/10to4/9:4/9to4/8:4/8to4/7:4/7to4/6:4/6to4/5:4/5to4/4:4/4to4/3:4/3to4/2:4/2to5/2:5/2to6/2:6/2to7/2:7/2to7/3:,18,True,True
3242,758,903,145,9/10to8/10,3/14to3/15,9/10to8/10:8/10to7/10:7/10to6/10:6/10to5/10:5/10to4/10:4/10to3/10:3/10to3/11:3/11to3/12:3/12to3/13:3/13to3/14:3/14to3/15:,11,False,True
3287,759,784,25,0/7to1/7,1/7to1/6,0/7to1/7:1/7to1/6:,2,True,True
1730,759,871,112,bottom8to8/0,10/3to10/4,bottom8to8/0:8/0to8/1:8/1to8/2:8/2to9/2:9/2to10/2:10/2to10/3:10/3to10/4:,7,True,True
2671,760,1199,439,15/5to14/5,2/12to1/12,15/5to14/5:14/5to13/5:13/5to12/5:12/5to11/5:11/5to10/5:10/5to9/5:9/5to8/5:8/5to7/5:7/5to6/5:6/5to5/5:5/5to4/5:4/5to3/5:3/5to2/5:2/5to2/6:2/6to2/7:2/7to2/8:2/8to2/9:2/9to2/10:2/10to2/11:2/11to2/12:2/12to1/12:,21,False,True
1223,760,854,94,0/13to1/13,1/7to0/7,0/13to1/13:1/13to1/12:1/12to1/11:1/11to1/10:1/10to1/9:1/9to1/8:1/8to1/7:1/7to0/7:,8,False,True
954,760,981,221,5/1to5/2,13/8to14/8,5/1to5/2:5/2to6/2:6/2to7/2:7/2to8/2:8/2to9/2:9/2to10/2:10/2to10/3:10/3to10/4:10/4to10/5:10/5to10/6:10/6to10/7:10/7to10/8:10/8to11/8:11/8to12/8:12/8to13/8:13/8to14/8:,16,False,True
1697,760,990,230,11/11to10/11,2/4to3/4,11/11to10/11:10/11to9/11:9/11to8/11:8/11to7/11:7/11to6/11:6/11to5/11:5/11to4/11:4/11to3/11:3/11to2/11:2/11to2/10:2/10to2/9:2/9to2/8:2/8to2/7:2/7to2/6:2/6to2/5:2/5to2/4:2/4to3/4:,17,True,True
389,760,1146,386,right0to15/0,0/15totop0,right0to15/0:15/0to14/0:14/0to13/0:13/0to12/0:12/0to11/0:11/0to10/0:10/0to9/0:9/0to8/0:8/0to7/0:7/0to6/0:6/0to5/0:5/0to4/0:4/0to3/0:3/0to2/0:2/0to1/0:1/0to0/0:0/0to0/1:0/1to0/2:0/2to0/3:0/3to0/4:0/4to0/5:0/5to0/6:0/6to0/7:0/7to0/8:0/8to0/9:0/9to0/10:0/10to0/11:0/11to0/12:0/12to0/13:0/13to0/14:0/14to0/15:0/15totop0:,32,True,True
2699,761,903,142,13/0to13/1,15/10toright10,13/0to13/1:13/1to13/2:13/2to13/3:13/3to13/4:13/4to13/5:13/5to13/6:13/6to13/7:13/7to13/8:13/8to13/9:13/9to13/10:13/10to14/10:14/10to15/10:15/10toright10:,13,True,True
3073,761,945,184,3/5to3/6,12/3to12/2,3/5to3/6:3/6to3/5:3/5to4/5:4/5to5/5:5/5to6/5:6/5to7/5:7/5to8/5:8/5to9/5:9/5to10/5:10/5to10/4:10/4to11/4:11/4to11/3:11/3to12/3:12/3to12/2:,14,True,True
2841,761,934,173,15/1to15/2,11/10to10/10,15/1to15/2:15/2to14/2:14/2to13/2:13/2to12/2:12/2to11/2:11/2to11/3:11/3to11/4:11/4to11/5:11/5to11/6:11/6to11/7:11/7to11/8:11/8to11/9:11/9to11/10:11/10to10/10:,14,True,True
282,761,1158,397,right15to15/15,0/0tobottom0,right15to15/15:15/15to14/15:14/15to13/15:13/15to12/15:12/15to11/15:11/15to11/14:11/14to10/14:10/14to9/14:9/14to8/14:8/14to7/14:7/14to6/14:6/14to5/14:5/14to4/14:4/14to3/14:3/14to2/14:2/14to1/14:1/14to0/14:0/14to0/13:0/13to0/12:0/12to0/11:0/11to0/10:0/10to0/9:0/9to0/8:0/8to0/7:0/7to0/6:0/6to0/5:0/5to0/4:0/4to0/3:0/3to0/2:0/2to0/1:0/1to0/0:0/0tobottom0:,32,True,True
2056,762,956,194,right2to15/2,6/6to7/6,right2to15/2:15/2to14/2:14/2to13/2:13/2to12/2:12/2to11/2:11/2to10/2:10/2to9/2:9/2to8/2:8/2to7/2:7/2to6/2:6/2to6/3:6/3to6/4:6/4to6/5:6/5to6/6:6/6to7/6:,15,False,True
3373,762,885,123,top10to10/15,6/10to6/9,top10to10/15:10/15to9/15:9/15to8/15:8/15to7/15:7/15to6/15:6/15to6/14:6/14to6/13:6/13to6/12:6/12to6/11:6/11to6/10:6/10to6/9:,11,False,True
580,763,1013,250,top3to3/15,10/3to11/3,top3to3/15:3/15to3/14:3/14to3/13:3/13to3/12:3/12to3/11:3/11to3/10:3/10to3/9:3/9to3/8:3/8to3/7:3/7to3/6:3/6to3/5:3/5to3/4:3/4to3/3:3/3to4/3:4/3to5/3:5/3to6/3:6/3to7/3:7/3to8/3:8/3to9/3:9/3to10/3:10/3to11/3:,21,True,True
2748,763,1182,419,14/7to14/6,0/2to0/1,14/7to14/6:14/6to13/6:13/6to12/6:12/6to11/6:11/6to10/6:10/6to9/6:9/6to8/6:8/6to7/6:7/6to6/6:6/6to5/6:5/6to4/6:4/6to3/6:3/6to2/6:2/6to1/6:1/6to0/6:0/6to0/5:0/5to0/4:0/4to0/3:0/3to0/2:0/2to0/1:,20,True,True
1977,763,1067,304,13/12to13/13,3/0to4/0,13/12to13/13:13/13to12/13:12/13to11/13:11/13to10/13:10/13to9/13:9/13to8/13:8/13to7/13:7/13to6/13:6/13to5/13:5/13to4/13:4/13to3/13:3/13to3/12:3/12to3/11:3/11to3/10:3/10to3/9:3/9to3/8:3/8to3/7:3/7to3/6:3/6to3/5:3/5to3/4:3/4to3/3:3/3to3/2:3/2to3/1:3/1to3/0:3/0to4/0:,25,False,True
72,763,1138,375,left15to0/15,15/0tobottom15,left15to0/15:0/15to0/14:0/14to0/13:0/13to0/12:0/12to0/11:0/11to0/10:0/10to0/9:0/9to0/8:0/8to0/7:0/7to0/6:0/6to0/5:0/5to0/4:0/4to0/3:0/3to0/2:0/2to0/1:0/1to0/0:0/0to1/0:1/0to2/0:2/0to3/0:3/0to4/0:4/0to5/0:5/0to6/0:6/0to7/0:7/0to8/0:8/0to9/0:9/0to10/0:10/0to11/0:11/0to12/0:12/0to13/0:13/0to14/0:14/0to15/0:15/0tobottom15:,32,True,True
2293,763,958,195,8/11to7/11,1/3to0/3,8/11to7/11:7/11to6/11:6/11to5/11:5/11to4/11:4/11to3/11:3/11to2/11:2/11to1/11:1/11to1/10:1/10to1/9:1/9to1/8:1/8to1/7:1/7to1/6:1/6to1/5:1/5to1/4:1/4to1/3:1/3to0/3:,16,False,True
966,763,856,93,12/0to12/1,13/6to14/6,12/0to12/1:12/1to12/2:12/2to12/3:12/3to12/4:12/4to12/5:12/5to12/6:12/6to13/6:13/6to14/6:,8,False,True
922,764,826,62,4/5to4/6,6/7to7/7,4/5to4/6:4/6to4/7:4/7to5/7:5/7to6/7:6/7to7/7:,5,True,True
15,764,1153,389,left15to0/15,15/0tobottom15,left15to0/15:0/15to0/14:0/14to0/13:0/13to0/12:0/12to0/11:0/11to0/10:0/10to0/9:0/9to0/8:0/8to0/7:0/7to0/6:0/6to0/5:0/5to0/4:0/4to0/3:0/3to0/2:0/2to1/2:1/2to2/2:2/2to3/2:3/2to4/2:4/2to5/2:5/2to6/2:6/2to7/2:7/2to8/2:8/2to9/2:9/2to10/2:10/2to10/1:10/1to11/1:11/1to11/0:11/0to12/0:12/0to13/0:13/0to14/0:14/0to15/0:15/0tobottom15:,32,True,True
1407,765,908,143,top10to10/15,8/6to8/5,top10to10/15:10/15to9/15:9/15to8/15:8/15to8/14:8/14to8/13:8/13to8/12:8/12to8/11:8/11to8/10:8/10to8/9:8/9to8/8:8/8to8/7:8/7to8/6:8/6to8/5:,13,False,True
1565,765,884,119,14/14to13/14,7/14to6/14,14/14to13/14:13/14to12/14:12/14to11/14:11/14to10/14:10/14to9/14:9/14to8/14:8/14to7/14:7/14to6/14:,8,True,True
1886,765,904,139,5/8to6/8,11/10to12/10,5/8to6/8:6/8to7/8:7/8to8/8:8/8to9/8:9/8to10/8:10/8to10/9:10/9to11/9:11/9to11/10:11/10to12/10:,9,True,True
3285,766,883,117,10/7to10/6,14/3to15/3,10/7to10/6:10/6to10/5:10/5to11/5:11/5to12/5:12/5to12/4:12/4to12/3:12/3to13/3:13/3to14/3:14/3to15/3:,9,True,True
732,766,972,206,4/13to5/13,10/3to9/3,4/13to5/13:5/13to5/12:5/12to5/11:5/11to5/10:5/10to5/9:5/9to5/8:5/8to5/7:5/7to5/6:5/6to5/5:5/5to6/5:6/5to7/5:7/5to8/5:8/5to9/5:9/5to10/5:10/5to10/4:10/4to10/3:10/3to9/3:,17,True,True
866,767,988,221,bottom14to14/0,4/6to4/7,bottom14to14/0:14/0to13/0:13/0to12/0:12/0to11/0:11/0to10/0:10/0to9/0:9/0to8/0:8/0to7/0:7/0to6/0:6/0to5/0:5/0to4/0:4/0to4/1:4/1to4/2:4/2to4/3:4/3to4/4:4/4to4/5:4/5to4/6:4/6to4/7:,18,True,True
3111,767,832,65,4/6to4/5,5/3to6/3,4/6to4/5:4/5to4/4:4/4to4/3:4/3to5/3:5/3to6/3:,5,True,True
1452,767,884,117,7/12to7/11,3/14to4/14,7/12to7/11:7/11to6/11:6/11to5/11:5/11to4/11:4/11to3/11:3/11to3/12:3/12to3/13:3/13to3/14:3/14to4/14:,9,True,True
1065,767,968,201,12/8to11/8,7/5to7/4,12/8to11/8:11/8to10/8:10/8to9/8:9/8to8/8:8/8to7/8:7/8to7/7:7/7to7/6:7/6to7/5:7/5to7/4:,9,True,True
2814,767,804,37,5/7to5/6,5/5to6/5,5/7to5/6:5/6to5/5:5/5to6/5:,3,True,True
2579,768,993,225,2/3to3/3,15/1toright1,2/3to3/3:3/3to4/3:4/3to5/3:5/3to6/3:6/3to7/3:7/3to8/3:8/3to9/3:9/3to10/3:10/3to10/2:10/2to10/1:10/1to11/1:11/1to12/1:12/1to13/1:13/1to14/1:14/1to15/1:15/1toright1:,16,False,True
7,768,1140,372,left15to0/15,15/0tobottom15,left15to0/15:0/15to1/15:1/15to2/15:2/15to3/15:3/15to4/15:4/15to5/15:5/15to6/15:6/15to7/15:7/15to8/15:8/15to9/15:9/15to10/15:10/15to10/14:10/14to10/13:10/13to10/12:10/12to10/11:10/11to10/10:10/10to10/9:10/9to10/8:10/8to10/7:10/7to10/6:10/6to10/5:10/5to10/4:10/4to10/3:10/3to10/2:10/2to10/1:10/1to10/0:10/0to11/0:11/0to12/0:12/0to13/0:13/0to14/0:14/0to15/0:15/0tobottom15:,32,False,True
1413,770,1089,319,11/6to11/5,7/14to8/14,11/6to11/5:11/5to10/5:10/5to9/5:9/5to8/5:8/5to7/5:7/5to7/6:7/6to7/7:7/7to7/8:7/8to7/9:7/9to7/10:7/10to7/11:7/11to7/12:7/12to7/13:7/13to7/14:7/14to8/14:,15,False,True
2960,771,811,40,bottom9to9/0,8/1to8/2,bottom9to9/0:9/0to8/0:8/0to8/1:8/1to8/2:,4,True,True
3168,771,907,136,0/6to0/7,7/7to7/6,0/6to0/7:0/7to1/7:1/7to2/7:2/7to3/7:3/7to4/7:4/7to5/7:5/7to6/7:6/7to7/7:7/7to7/6:,9,False,True
3087,771,836,65,8/9to9/9,10/10to11/10,8/9to9/9:9/9to10/9:10/9to10/10:10/10to11/10:,4,False,True
2986,772,809,37,right3to15/3,14/4to15/4,right3to15/3:15/3to14/3:14/3to14/4:14/4to15/4:,4,False,True
76,772,1166,394,left15to0/15,15/0tobottom15,left15to0/15:0/15to0/14:0/14to0/13:0/13to0/12:0/12to0/11:0/11to0/10:0/10to0/9:0/9to0/8:0/8to0/7:0/7to0/6:0/6to0/5:0/5to0/4:0/4to0/3:0/3to0/2:0/2to1/2:1/2to2/2:2/2to3/2:3/2to4/2:4/2to5/2:5/2to6/2:6/2to7/2:7/2to8/2:8/2to9/2:9/2to10/2:10/2to10/1:10/1to11/1:11/1to11/0:11/0to12/0:12/0to13/0:13/0to14/0:14/0to15/0:15/0tobottom15:,32,True,True
2983,772,807,35,1/6to1/7,1/8to1/9,1/6to1/7:1/7to1/8:1/8to1/9:,3,False,True
1222,772,1121,349,bottom0to0/0,13/8to14/8,bottom0to0/0:0/0to0/1:0/1to0/2:0/2to0/3:0/3to0/4:0/4to0/5:0/5to0/6:0/6to0/7:0/7to0/8:0/8to1/8:1/8to2/8:2/8to3/8:3/8to4/8:4/8to5/8:5/8to6/8:6/8to7/8:7/8to8/8:8/8to9/8:9/8to10/8:10/8to11/8:11/8to12/8:12/8to13/8:13/8to14/8:,23,True,True
1903,773,844,71,7/5to7/4,8/1to9/1,7/5to7/4:7/4to7/3:7/3to7/2:7/2to7/1:7/1to8/1:8/1to9/1:,6,True,True
1459,773,941,168,2/9to2/8,10/6to10/5,2/9to2/8:2/8to3/8:3/8to4/8:4/8to5/8:5/8to6/8:6/8to7/8:7/8to8/8:8/8to9/8:9/8to10/8:10/8to10/7:10/7to10/6:10/6to10/5:,12,True,True
362,773,1264,491,right0to15/0,0/15totop0,right0to15/0:15/0to14/0:14/0to13/0:13/0to12/0:12/0to11/0:11/0to11/1:11/1to10/1:10/1to9/1:9/1to8/1:8/1to7/1:7/1to6/1:6/1to5/1:5/1to4/1:4/1to3/1:3/1to2/1:2/1to1/1:1/1to0/1:0/1to0/2:0/2to0/3:0/3to0/4:0/4to0/5:0/5to0/6:0/6to0/7:0/7to0/8:0/8to0/9:0/9to0/10:0/10to0/11:0/11to0/12:0/12to0/13:0/13to0/14:0/14to0/15:0/15totop0:,32,True,True
2726,774,1016,242,top7to7/15,11/1to11/2,top7to7/15:7/15to7/14:7/14to7/13:7/13to7/12:7/12to7/11:7/11to7/10:7/10to7/9:7/9to7/8:7/8to7/7:7/7to7/6:7/6to7/5:7/5to7/4:7/4to7/3:7/3to8/3:8/3to9/3:9/3to10/3:10/3to10/2:10/2to11/2:11/2to11/1:11/1to11/2:,20,True,True
1376,774,984,210,bottom12to12/0,2/6to3/6,bottom12to12/0:12/0to11/0:11/0to10/0:10/0to9/0:9/0to8/0:8/0to7/0:7/0to6/0:6/0to5/0:5/0to4/0:4/0to3/0:3/0to2/0:2/0to2/1:2/1to2/2:2/2to2/3:2/3to2/4:2/4to2/5:2/5to2/6:2/6to3/6:,18,False,True
2323,774,1109,335,15/8to14/8,1/13to1/14,15/8to14/8:14/8to13/8:13/8to12/8:12/8to11/8:11/8to10/8:10/8to9/8:9/8to8/8:8/8to7/8:7/8to6/8:6/8to5/8:5/8to4/8:4/8to3/8:3/8to2/8:2/8to1/8:1/8to1/9:1/9to1/10:1/10to1/11:1/11to1/12:1/12to1/13:1/13to1/14:,20,False,True
1770,774,1003,229,6/15to7/15,15/7to15/6,6/15to7/15:7/15to8/15:8/15to9/15:9/15to10/15:10/15to10/14:10/14to10/13:10/13to10/12:10/12to10/11:10/11to10/10:10/10to10/9:10/9to10/8:10/8to10/7:10/7to11/7:11/7to12/7:12/7to13/7:13/7to14/7:14/7to15/7:15/7to15/6:,18,False,True
2432,775,896,121,15/13to15/14,12/9to12/8,15/13to15/14:15/14to14/14:14/14to13/14:13/14to12/14:12/14to12/13:12/13to12/12:12/12to12/11:12/11to12/10:12/10to12/9:12/9to12/8:,10,False,True
2683,776,1103,327,14/3to13/3,5/12to5/13,14/3to13/3:13/3to12/3:12/3to11/3:11/3to11/4:11/4to10/4:10/4to9/4:9/4to8/4:8/4to7/4:7/4to6/4:6/4to5/4:5/4to5/5:5/5to5/6:5/6to5/7:5/7to5/8:5/8to5/9:5/9to5/10:5/10to5/11:5/11to5/12:5/12to5/13:,19,True,True
1559,776,1253,477,1/6to1/5,14/8to14/7,1/6to1/5:1/5to2/5:2/5to3/5:3/5to4/5:4/5to5/5:5/5to6/5:6/5to7/5:7/5to8/5:8/5to9/5:9/5to10/5:10/5to10/6:10/6to10/7:10/7to10/8:10/8to11/8:11/8to12/8:12/8to13/8:13/8to14/8:14/8to14/7:,18,False,True
3184,777,1051,274,13/5to13/6,5/8to5/9,13/5to13/6:13/6to12/6:12/6to11/6:11/6to11/7:11/7to10/7:10/7to9/7:9/7to8/7:8/7to7/7:7/7to6/7:6/7to5/7:5/7to5/8:5/8to5/9:,12,True,True
288,777,1200,423,right15to15/15,0/0tobottom0,right15to15/15:15/15to14/15:14/15to13/15:13/15to12/15:12/15to11/15:11/15to11/14:11/14to10/14:10/14to9/14:9/14to8/14:8/14to7/14:7/14to6/14:6/14to5/14:5/14to4/14:4/14to3/14:3/14to2/14:2/14to1/14:1/14to0/14:0/14to0/13:0/13to0/12:0/12to0/11:0/11to0/10:0/10to0/9:0/9to0/8:0/8to0/7:0/7to0/6:0/6to0/5:0/5to0/4:0/4to0/3:0/3to0/2:0/2to0/1:0/1to0/0:0/0tobottom0:,32,True,True
1081,777,1062,285,left3to0/3,10/13to10/14,left3to0/3:0/3to1/3:1/3to2/3:2/3to3/3:3/3to4/3:4/3to5/3:5/3to6/3:6/3to7/3:7/3to8/3:8/3to9/3:9/3to10/3:10/3to10/4:10/4to10/5:10/5to10/6:10/6to10/7:10/7to10/8:10/8to10/9:10/9to10/10:10/10to10/11:10/11to10/12:10/12to10/13:10/13to10/14:,22,False,True
3269,777,813,36,8/8to9/8,9/9to9/10,8/8to9/8:9/8to9/9:9/9to9/10:,3,True,True
420,778,1085,307,2/13to3/13,14/2to15/2,2/13to3/13:3/13to3/12:3/12to3/11:3/11to3/10:3/10to3/9:3/9to3/8:3/8to3/7:3/7to3/6:3/6to3/5:3/5to3/4:3/4to3/3:3/3to3/2:3/2to4/2:4/2to5/2:5/2to6/2:6/2to7/2:7/2to8/2:8/2to9/2:9/2to10/2:10/2to11/2:11/2to12/2:12/2to13/2:13/2to14/2:14/2to15/2:,24,True,True
1104,778,878,100,13/12to12/12,15/9to15/10,13/12to12/12:12/12to12/11:12/11to12/10:12/10to12/9:12/9to13/9:13/9to14/9:14/9to15/9:15/9to15/10:,8,True,True
1599,778,922,144,15/6to14/6,12/14to12/15,15/6to14/6:14/6to13/6:13/6to12/6:12/6to12/7:12/7to12/8:12/8to12/9:12/9to12/10:12/10to12/11:12/11to12/12:12/12to12/13:12/13to12/14:12/14to12/15:,12,False,True
2772,778,847,69,12/2to12/1,10/3to11/3,12/2to12/1:12/1to11/1:11/1to10/1:10/1to10/2:10/2to10/3:10/3to11/3:,6,False,True
3193,778,862,84,7/6to7/5,6/1to6/0,7/6to7/5:7/5to6/5:6/5to6/4:6/4to6/3:6/3to6/2:6/2to6/1:6/1to6/0:,7,False,True
2301,779,992,213,8/8to7/8,0/3to0/2,8/8to7/8:7/8to6/8:6/8to5/8:5/8to4/8:4/8to3/8:3/8to2/8:2/8to1/8:1/8to0/8:0/8to0/7:0/7to0/6:0/6to0/5:0/5to0/4:0/4to0/3:0/3to0/2:,14,True,True
2852,779,916,137,11/12to10/12,8/5to8/4,11/12to10/12:10/12to9/12:9/12to8/12:8/12to8/11:8/11to8/10:8/10to8/9:8/9to8/8:8/8to8/7:8/7to8/6:8/6to8/5:8/5to8/4:,11,False,True
1804,779,930,151,15/12to14/12,6/13to6/14,15/12to14/12:14/12to13/12:13/12to12/12:12/12to11/12:11/12to10/12:10/12to9/12:9/12to8/12:8/12to7/12:7/12to6/12:6/12to6/13:6/13to6/14:,11,True,True
186,779,1176,397,left0to0/0,15/15totop15,left0to0/0:0/0to1/0:1/0to2/0:2/0to3/0:3/0to4/0:4/0to5/0:5/0to6/0:6/0to7/0:7/0to8/0:8/0to9/0:9/0to10/0:10/0to10/1:10/1to10/2:10/2to10/3:10/3to10/4:10/4to10/5:10/5to10/6:10/6to10/7:10/7to10/8:10/8to10/9:10/9to10/10:10/10to10/11:10/11to10/12:10/12to10/13:10/13to10/14:10/14to10/15:10/15to11/15:11/15to12/15:12/15to13/15:13/15to14/15:14/15to15/15:15/15totop15:,32,False,True
2580,779,1011,232,12/3to12/2,8/15to9/15,12/3to12/2:12/2to11/2:11/2to10/2:10/2to9/2:9/2to8/2:8/2to8/3:8/3to8/4:8/4to8/5:8/5to8/6:8/6to8/7:8/7to8/8:8/8to8/9:8/9to8/10:8/10to8/11:8/11to8/12:8/12to8/13:8/13to8/14:8/14to8/15:8/15to9/15:,19,False,True
2224,779,957,178,15/10to15/9,6/6to6/5,15/10to15/9:15/9to14/9:14/9to13/9:13/9to12/9:12/9to11/9:11/9to10/9:10/9to9/9:9/9to8/9:8/9to7/9:7/9to6/9:6/9to6/8:6/8to6/7:6/7to6/6:6/6to6/5:,14,False,True
1026,779,1010,231,1/13to1/12,8/3to8/2,1/13to1/12:1/12to1/11:1/11to1/10:1/10to1/9:1/9to1/8:1/8to1/7:1/7to1/6:1/6to1/5:1/5to1/4:1/4to1/3:1/3to2/3:2/3to3/3:3/3to4/3:4/3to5/3:5/3to6/3:6/3to7/3:7/3to8/3:8/3to8/2:,18,False,True
3131,780,897,117,6/15to7/15,10/11to10/10,6/15to7/15:7/15to8/15:8/15to9/15:9/15to10/15:10/15to10/14:10/14to10/13:10/13to10/12:10/12to10/11:10/11to10/10:,9,False,True
331,782,1153,371,right0to15/0,0/15totop0,right0to15/0:15/0to14/0:14/0to13/0:13/0to12/0:12/0to11/0:11/0to10/0:10/0to9/0:9/0to8/0:8/0to7/0:7/0to6/0:6/0to5/0:5/0to4/0:4/0to3/0:3/0to2/0:2/0to1/0:1/0to0/0:0/0to0/1:0/1to0/2:0/2to0/3:0/3to0/4:0/4to0/5:0/5to0/6:0/6to0/7:0/7to0/8:0/8to0/9:0/9to0/10:0/10to0/11:0/11to0/12:0/12to0/13:0/13to0/14:0/14to0/15:0/15totop0:,32,True,True
1460,782,818,36,15/12to14/12,13/12to12/12,15/12to14/12:14/12to13/12:13/12to12/12:,3,False,True
62,782,1168,386,left15to0/15,15/0tobottom15,left15to0/15:0/15to1/15:1/15to2/15:2/15to3/15:3/15to4/15:4/15to5/15:5/15to6/15:6/15to7/15:7/15to8/15:8/15to9/15:9/15to10/15:10/15to10/14:10/14to10/13:10/13to10/12:10/12to10/11:10/11to10/10:10/10to10/9:10/9to10/8:10/8to10/7:10/7to10/6:10/6to10/5:10/5to10/4:10/4to10/3:10/3to10/2:10/2to10/1:10/1to10/0:10/0to11/0:11/0to12/0:12/0to13/0:13/0to14/0:14/0to15/0:15/0tobottom15:,32,False,True
1900,783,992,209,12/6to11/6,7/5to8/5,12/6to11/6:11/6to11/5:11/5to10/5:10/5to9/5:9/5to8/5:8/5to7/5:7/5to8/5:,7,True,True
545,783,860,77,11/14to11/15,9/13to9/12,11/14to11/15:11/15to10/15:10/15to10/14:10/14to9/14:9/14to9/13:9/13to9/12:,6,True,True
3362,783,954,171,15/8to15/7,10/0to9/0,15/8to15/7:15/7to14/7:14/7to13/7:13/7to12/7:12/7to12/6:12/6to12/5:12/5to12/4:12/4to12/3:12/3to12/2:12/2to12/1:12/1to12/0:12/0to11/0:11/0to10/0:10/0to9/0:,14,True,True
170,784,1191,407,left0to0/0,15/15totop15,left0to0/0:0/0to1/0:1/0to2/0:2/0to3/0:3/0to4/0:4/0to5/0:5/0to6/0:6/0to7/0:7/0to8/0:8/0to9/0:9/0to10/0:10/0to10/1:10/1to10/2:10/2to10/3:10/3to10/4:10/4to10/5:10/5to10/6:10/6to10/7:10/7to10/8:10/8to10/9:10/9to10/10:10/10to10/11:10/11to10/12:10/12to10/13:10/13to10/14:10/14to10/15:10/15to11/15:11/15to12/15:12/15to13/15:13/15to14/15:14/15to15/15:15/15totop15:,32,False,True
1482,784,927,143,7/9to6/9,2/15totop2,7/9to6/9:6/9to5/9:5/9to4/9:4/9to3/9:3/9to2/9:2/9to2/10:2/10to2/11:2/11to2/12:2/12to2/13:2/13to2/14:2/14to2/15:2/15totop2:,12,True,True
596,784,973,189,1/0to1/1,15/1toright1,1/0to1/1:1/1to2/1:2/1to3/1:3/1to4/1:4/1to5/1:5/1to6/1:6/1to7/1:7/1to8/1:8/1to9/1:9/1to10/1:10/1to11/1:11/1to12/1:12/1to13/1:13/1to14/1:14/1to15/1:15/1toright1:,16,True,True
1593,784,930,146,15/11to14/11,12/3to12/2,15/11to14/11:14/11to13/11:13/11to12/11:12/11to12/10:12/10to12/9:12/9to12/8:12/8to12/7:12/7to12/6:12/6to12/5:12/5to12/4:12/4to12/3:12/3to12/2:,12,False,True
2838,784,891,107,15/1to15/0,12/4to12/5,15/1to15/0:15/0to14/0:14/0to13/0:13/0to12/0:12/0to12/1:12/1to12/2:12/2to12/3:12/3to12/4:12/4to12/5:,9,False,True
977,784,963,179,14/0to13/0,10/10to11/10,14/0to13/0:13/0to12/0:12/0to11/0:11/0to11/1:11/1to11/2:11/2to11/3:11/3to11/4:11/4to11/5:11/5to11/6:11/6to11/7:11/7to11/8:11/8to11/9:11/9to11/10:11/10to10/10:10/10to11/10:,15,True,True
931,786,862,76,5/0to5/1,1/1to1/2,5/0to5/1:5/1to4/1:4/1to3/1:3/1to2/1:2/1to1/1:1/1to1/2:,6,True,True
1602,786,1174,388,12/11to12/10,2/7to3/7,12/11to12/10:12/10to11/10:11/10to10/10:10/10to9/10:9/10to8/10:8/10to7/10:7/10to6/10:6/10to5/10:5/10to4/10:4/10to3/10:3/10to2/10:2/10to2/9:2/9to2/8:2/8to2/7:2/7to3/7:,15,False,True
1637,786,892,106,6/9to5/9,7/14to7/13,6/9to5/9:5/9to5/10:5/10to5/11:5/11to5/12:5/12to5/13:5/13to5/14:5/14to6/14:6/14to7/14:7/14to7/13:,9,False,True
327,786,1171,385,right0to15/0,0/15totop0,right0to15/0:15/0to14/0:14/0to13/0:13/0to12/0:12/0to11/0:11/0to10/0:10/0to9/0:9/0to8/0:8/0to7/0:7/0to6/0:6/0to5/0:5/0to4/0:4/0to3/0:3/0to2/0:2/0to1/0:1/0to0/0:0/0to0/1:0/1to0/2:0/2to0/3:0/3to0/4:0/4to0/5:0/5to0/6:0/6to0/7:0/7to0/8:0/8to0/9:0/9to0/10:0/10to0/11:0/11to0/12:0/12to0/13:0/13to0/14:0/14to0/15:0/15totop0:,32,False,True
2780,786,959,173,12/6to12/7,7/7to7/6,12/6to12/7:12/7to11/7:11/7to10/7:10/7to9/7:9/7to8/7:8/7to7/7:7/7to7/6:,7,True,True
2467,787,876,89,9/9to10/9,10/12to11/12,9/9to10/9:10/9to10/10:10/10to10/11:10/11to10/12:10/12to11/12:,5,False,True
644,788,882,94,6/4to5/4,1/6to2/6,6/4to5/4:5/4to4/4:4/4to3/4:3/4to2/4:2/4to1/4:1/4to1/5:1/5to1/6:1/6to2/6:,8,True,True
2238,788,1131,343,14/14to14/15,0/5to1/5,14/14to14/15:14/15to13/15:13/15to12/15:12/15to11/15:11/15to10/15:10/15to9/15:9/15to8/15:8/15to7/15:7/15to6/15:6/15to5/15:5/15to4/15:4/15to3/15:3/15to2/15:2/15to1/15:1/15to0/15:0/15to0/14:0/14to0/13:0/13to0/12:0/12to0/11:0/11to0/10:0/10to0/9:0/9to0/8:0/8to0/7:0/7to0/6:0/6to0/5:0/5to1/5:,26,False,True
2742,788,938,150,10/8to10/9,3/11to3/12,10/8to10/9:10/9to10/10:10/10to9/10:9/10to8/10:8/10to7/10:7/10to6/10:6/10to5/10:5/10to4/10:4/10to3/10:3/10to3/11:3/11to3/12:,11,True,True
2445,789,1033,244,right15to15/15,10/0tobottom10,right15to15/15:15/15to14/15:14/15to13/15:13/15to12/15:12/15to11/15:11/15to10/15:10/15to10/14:10/14to10/13:10/13to10/12:10/12to10/11:10/11to10/10:10/10to10/9:10/9to10/8:10/8to10/7:10/7to10/6:10/6to10/5:10/5to10/4:10/4to10/3:10/3to10/2:10/2to10/1:10/1to10/0:10/0tobottom10:,22,False,True
3150,789,869,80,12/10to12/9,12/4to12/3,12/10to12/9:12/9to12/8:12/8to12/7:12/7to12/6:12/6to12/5:12/5to12/4:12/4to12/3:,7,False,True
829,789,887,98,right1to15/1,9/0tobottom9,right1to15/1:15/1to14/1:14/1to13/1:13/1to12/1:12/1to11/1:11/1to10/1:10/1to10/0:10/0to9/0:9/0tobottom9:,9,False,True
673,789,824,35,9/14to8/14,7/14to7/15,9/14to8/14:8/14to7/14:7/14to7/15:,3,True,True
2988,790,876,86,13/3to13/2,9/1to8/1,13/3to13/2:13/2to12/2:12/2to11/2:11/2to10/2:10/2to10/1:10/1to9/1:9/1to8/1:,7,False,True
1180,790,847,57,3/9to3/10,3/13to4/13,3/9to3/10:3/10to3/11:3/11to3/12:3/12to3/13:3/13to4/13:,5,False,True
44,790,1172,382,left15to0/15,15/0tobottom15,left15to0/15:0/15to1/15:1/15to2/15:2/15to3/15:3/15to4/15:4/15to5/15:5/15to6/15:6/15to7/15:7/15to8/15:8/15to9/15:9/15to10/15:10/15to10/14:10/14to10/13:10/13to10/12:10/12to10/11:10/11to10/10:10/10to10/9:10/9to10/8:10/8to10/7:10/7to10/6:10/6to10/5:10/5to10/4:10/4to10/3:10/3to10/2:10/2to10/1:10/1to10/0:10/0to11/0:11/0to12/0:12/0to13/0:13/0to14/0:14/0to15/0:15/0tobottom15:,32,False,True
2066,791,935,144,6/4to6/5,8/13to8/14,6/4to6/5:6/5to6/6:6/6to6/7:6/7to6/8:6/8to6/9:6/9to6/10:6/10to6/11:6/11to6/12:6/12to6/13:6/13to7/13:7/13to8/13:8/13to8/14:,12,False,True
3179,791,963,172,5/6to5/7,15/6toright6,5/6to5/7:5/7to5/6:5/6to6/6:6/6to7/6:7/6to8/6:8/6to9/6:9/6to10/6:10/6to11/6:11/6to12/6:12/6to13/6:13/6to14/6:14/6to15/6:15/6toright6:,13,True,True
2623,791,879,88,5/13to4/13,3/9to4/9,5/13to4/13:4/13to3/13:3/13to3/12:3/12to3/11:3/11to3/10:3/10to3/9:3/9to4/9:,7,False,True
824,791,863,72,14/9to14/10,14/14to14/15,14/9to14/10:14/10to14/11:14/11to14/12:14/12to14/13:14/13to14/14:14/14to14/15:,6,False,True
469,791,975,184,11/13to11/12,5/5to4/5,11/13to11/12:11/12to11/11:11/11to10/11:10/11to9/11:9/11to8/11:8/11to7/11:7/11to6/11:6/11to5/11:5/11to5/10:5/10to5/9:5/9to5/8:5/8to5/7:5/7to5/6:5/6to5/5:5/5to4/5:,15,True,True
1994,792,895,103,5/1to5/2,10/3to9/3,5/1to5/2:5/2to6/2:6/2to7/2:7/2to8/2:8/2to9/2:9/2to10/2:10/2to10/3:10/3to9/3:,8,True,True
342,792,1266,474,right0to15/0,0/15totop0,right0to15/0:15/0to14/0:14/0to13/0:13/0to12/0:12/0to11/0:11/0to11/1:11/1to10/1:10/1to9/1:9/1to8/1:8/1to7/1:7/1to6/1:6/1to5/1:5/1to4/1:4/1to3/1:3/1to2/1:2/1to1/1:1/1to0/1:0/1to0/2:0/2to0/3:0/3to0/4:0/4to0/5:0/5to0/6:0/6to0/7:0/7to0/8:0/8to0/9:0/9to0/10:0/10to0/11:0/11to0/12:0/12to0/13:0/13to0/14:0/14to0/15:0/15totop0:,32,True,True
2243,792,1129,337,right12to15/12,2/1to1/1,right12to15/12:15/12to14/12:14/12to13/12:13/12to12/12:12/12to11/12:11/12to11/11:11/11to10/11:10/11to9/11:9/11to8/11:8/11to7/11:7/11to6/11:6/11to5/11:5/11to4/11:4/11to3/11:3/11to2/11:2/11to2/10:2/10to2/9:2/9to2/8:2/8to2/7:2/7to2/6:2/6to2/5:2/5to2/4:2/4to2/3:2/3to2/2:2/2to2/1:2/1to1/1:,26,True,True
1768,793,839,46,2/5to2/4,1/5to1/6,2/5to2/4:2/4to1/4:1/4to1/5:1/5to1/6:,4,True,True
1701,793,937,144,5/7to4/7,9/11to10/11,5/7to4/7:4/7to4/8:4/8to4/9:4/9to4/10:4/10to4/11:4/11to5/11:5/11to6/11:6/11to7/11:7/11to8/11:8/11to9/11:9/11to10/11:,11,False,True
1683,793,895,102,3/5to3/6,4/12to4/11,3/5to3/6:3/6to3/7:3/7to3/8:3/8to3/9:3/9to3/10:3/10to3/11:3/11to3/12:3/12to4/12:4/12to4/11:,9,False,True
1524,793,875,82,9/15to10/15,15/15toright15,9/15to10/15:10/15to11/15:11/15to12/15:12/15to13/15:13/15to14/15:14/15to15/15:15/15toright15:,7,False,True
1314,793,956,163,4/7to3/7,8/0tobottom8,4/7to3/7:3/7to3/6:3/6to3/5:3/5to3/4:3/4to3/3:3/3to3/2:3/2to3/1:3/1to3/0:3/0to4/0:4/0to5/0:5/0to6/0:6/0to7/0:7/0to8/0:8/0tobottom8:,14,True,True
2235,793,862,69,6/14to5/14,2/15totop2,6/14to5/14:5/14to4/14:4/14to3/14:3/14to2/14:2/14to2/15:2/15totop2:,6,False,True
2103,794,1066,272,left13to0/13,10/4to9/4,left13to0/13:0/13to1/13:1/13to2/13:2/13to3/13:3/13to4/13:4/13to5/13:5/13to6/13:6/13to7/13:7/13to8/13:8/13to9/13:9/13to10/13:10/13to10/12:10/12to10/11:10/11to10/10:10/10to10/9:10/9to10/8:10/8to10/7:10/7to10/6:10/6to10/5:10/5to10/4:10/4to9/4:,21,False,True
2299,794,1083,289,0/5to1/5,13/14to14/14,0/5to1/5:1/5to1/6:1/6to1/7:1/7to1/8:1/8to1/9:1/9to1/10:1/10to1/11:1/11to1/12:1/12to1/13:1/13to1/14:1/14to2/14:2/14to3/14:3/14to4/14:4/14to5/14:5/14to6/14:6/14to7/14:7/14to8/14:8/14to9/14:9/14to10/14:10/14to11/14:11/14to12/14:12/14to13/14:13/14to14/14:,23,True,True
2285,794,937,143,7/6to7/5,4/12to3/12,7/6to7/5:7/5to6/5:6/5to5/5:5/5to4/5:4/5to4/6:4/6to4/7:4/7to4/8:4/8to4/9:4/9to4/10:4/10to4/11:4/11to4/12:4/12to3/12:,12,False,True
1273,794,1229,435,1/2to1/1,13/9to14/9,1/2to1/1:1/1to1/2:1/2to1/3:1/3to1/4:1/4to1/5:1/5to1/6:1/6to1/7:1/7to2/7:2/7to3/7:3/7to4/7:4/7to5/7:5/7to6/7:6/7to7/7:7/7to8/7:8/7to9/7:9/7to10/7:10/7to10/8:10/8to11/8:11/8to11/9:11/9to12/9:12/9to13/9:13/9to14/9:,22,True,True
2751,795,979,184,8/1to8/2,15/7toright7,8/1to8/2:8/2to8/3:8/3to8/4:8/4to8/5:8/5to8/6:8/6to8/7:8/7to9/7:9/7to10/7:10/7to11/7:11/7to12/7:12/7to13/7:13/7to14/7:14/7to15/7:15/7toright7:,14,True,True
1654,795,942,147,10/13to9/13,2/11to3/11,10/13to9/13:9/13to8/13:8/13to7/13:7/13to6/13:6/13to5/13:5/13to4/13:4/13to3/13:3/13to2/13:2/13to2/12:2/12to2/11:2/11to3/11:,11,False,True
2906,796,820,24,10/11to10/12,10/12to10/13,10/11to10/12:10/12to10/13:,2,False,True
2454,796,1023,227,13/4to12/4,7/7to7/8,13/4to12/4:12/4to11/4:11/4to10/4:10/4to9/4:9/4to8/4:8/4to7/4:7/4to7/5:7/5to7/6:7/6to7/7:7/7to7/8:,10,True,True
2086,796,979,183,8/2to7/2,5/13to5/14,8/2to7/2:7/2to6/2:6/2to5/2:5/2to5/3:5/3to5/4:5/4to5/5:5/5to5/6:5/6to5/7:5/7to5/8:5/8to5/9:5/9to5/10:5/10to5/11:5/11to5/12:5/12to5/13:5/13to5/14:,15,False,True
1596,796,868,72,13/10to12/10,11/7to10/7,13/10to12/10:12/10to12/9:12/9to11/9:11/9to11/8:11/8to11/7:11/7to10/7:,6,True,True
1653,797,823,26,6/3to5/3,5/3to4/3,6/3to5/3:5/3to4/3:,2,True,True
1276,798,1019,221,5/14to4/14,2/0to1/0,5/14to4/14:4/14to3/14:3/14to2/14:2/14to2/13:2/13to2/12:2/12to2/11:2/11to2/10:2/10to2/9:2/9to2/8:2/8to2/7:2/7to2/6:2/6to2/5:2/5to2/4:2/4to2/3:2/3to2/2:2/2to2/1:2/1to2/0:2/0to1/0:,18,False,True
1827,798,953,155,3/10to3/9,10/6to10/5,3/10to3/9:3/9to3/8:3/8to4/8:4/8to5/8:5/8to6/8:6/8to7/8:7/8to8/8:8/8to9/8:9/8to10/8:10/8to10/7:10/7to10/6:10/6to10/5:,12,True,True
3003,798,1042,244,13/10to13/9,1/5to1/4,13/10to13/9:13/9to12/9:12/9to11/9:11/9to10/9:10/9to9/9:9/9to8/9:8/9to7/9:7/9to6/9:6/9to5/9:5/9to4/9:4/9to3/9:3/9to2/9:2/9to1/9:1/9to1/8:1/8to1/7:1/7to1/6:1/6to1/5:1/5to1/4:,18,True,True
1184,798,924,126,7/13to8/13,8/4to8/3,7/13to8/13:8/13to8/12:8/12to8/11:8/11to8/10:8/10to8/9:8/9to8/8:8/8to8/7:8/7to8/6:8/6to8/5:8/5to8/4:8/4to8/3:,11,False,True
2,799,1184,385,left15to0/15,15/0tobottom15,left15to0/15:0/15to1/15:1/15to2/15:2/15to3/15:3/15to4/15:4/15to5/15:5/15to6/15:6/15to7/15:7/15to8/15:8/15to9/15:9/15to10/15:10/15to10/14:10/14to10/13:10/13to10/12:10/12to10/11:10/11to10/10:10/10to10/9:10/9to10/8:10/8to10/7:10/7to10/6:10/6to10/5:10/5to10/4:10/4to10/3:10/3to10/2:10/2to10/1:10/1to10/0:10/0to11/0:11/0to12/0:12/0to13/0:13/0to14/0:14/0to15/0:15/0tobottom15:,32,False,True
2381,799,972,173,1/3to0/3,5/9to6/9,1/3to0/3:0/3to0/4:0/4to0/5:0/5to0/6:0/6to0/7:0/7to0/8:0/8to0/9:0/9to1/9:1/9to2/9:2/9to3/9:3/9to4/9:4/9to5/9:5/9to6/9:,13,False,True
496,799,1007,208,10/15to11/15,11/1to11/0,10/15to11/15:11/15to11/14:11/14to12/14:12/14to12/13:12/13to12/12:12/12to12/11:12/11to12/10:12/10to12/9:12/9to12/8:12/8to12/7:12/7to12/6:12/6to12/5:12/5to12/4:12/4to12/3:12/3to11/3:11/3to11/2:11/2to11/1:11/1to11/0:,18,True,True
882,799,882,83,6/5to6/4,7/0to8/0,6/5to6/4:6/4to6/3:6/3to6/2:6/2to6/1:6/1to6/0:6/0to7/0:7/0to8/0:,7,False,True
19,799,1182,383,left15to0/15,15/0tobottom15,left15to0/15:0/15to1/15:1/15to2/15:2/15to3/15:3/15to4/15:4/15to5/15:5/15to6/15:6/15to7/15:7/15to8/15:8/15to9/15:9/15to10/15:10/15to10/14:10/14to10/13:10/13to10/12:10/12to10/11:10/11to10/10:10/10to10/9:10/9to10/8:10/8to10/7:10/7to10/6:10/6to10/5:10/5to10/4:10/4to10/3:10/3to10/2:10/2to10/1:10/1to10/0:10/0to11/0:11/0to12/0:12/0to13/0:13/0to14/0:14/0to15/0:15/0tobottom15:,32,False,True
2594,800,849,49,3/10to3/9,2/10to1/10,3/10to3/9:3/9to2/9:2/9to2/10:2/10to1/10:,4,False,True
2697,800,928,128,15/2to15/3,14/11to14/12,15/2to15/3:15/3to14/3:14/3to14/4:14/4to14/5:14/5to14/6:14/6to14/7:14/7to14/8:14/8to14/9:14/9to14/10:14/10to14/11:14/11to14/12:,11,True,True
576,800,1043,243,9/3to9/4,1/13to1/14,9/3to9/4:9/4to8/4:8/4to7/4:7/4to6/4:6/4to5/4:5/4to4/4:4/4to3/4:3/4to2/4:2/4to1/4:1/4to1/5:1/5to1/6:1/6to1/7:1/7to1/8:1/8to1/9:1/9to1/10:1/10to1/11:1/11to1/12:1/12to1/13:1/13to1/14:,19,False,True
2011,801,1034,233,9/4to9/5,1/14to0/14,9/4to9/5:9/5to8/5:8/5to7/5:7/5to6/5:6/5to5/5:5/5to4/5:4/5to3/5:3/5to2/5:2/5to1/5:1/5to1/6:1/6to1/7:1/7to1/8:1/8to1/9:1/9to1/10:1/10to1/11:1/11to1/12:1/12to1/13:1/13to1/14:1/14to0/14:,19,True,True
2626,801,956,155,top5to5/15,4/4to3/4,top5to5/15:5/15to4/15:4/15to4/14:4/14to4/13:4/13to4/12:4/12to4/11:4/11to4/10:4/10to4/9:4/9to4/8:4/8to4/7:4/7to4/6:4/6to4/5:4/5to4/4:4/4to3/4:,14,True,True
2395,801,953,152,0/9to0/10,9/11to9/10,0/9to0/10:0/10to0/11:0/11to1/11:1/11to2/11:2/11to3/11:3/11to4/11:4/11to5/11:5/11to6/11:6/11to7/11:7/11to8/11:8/11to9/11:9/11to9/10:,12,True,True
479,801,999,198,top0to0/15,13/15to14/15,top0to0/15:0/15to1/15:1/15to2/15:2/15to3/15:3/15to4/15:4/15to5/15:5/15to6/15:6/15to7/15:7/15to8/15:8/15to9/15:9/15to10/15:10/15to11/15:11/15to12/15:12/15to13/15:13/15to14/15:,15,False,True
2239,801,912,111,2/6to2/5,0/9toleft9,2/6to2/5:2/5to1/5:1/5to0/5:0/5to0/6:0/6to0/7:0/7to0/8:0/8to0/9:0/9toleft9:,8,False,True
1934,801,847,46,13/13to13/12,12/13to12/14,13/13to13/12:13/12to12/12:12/12to12/13:12/13to12/14:,4,False,True
3117,801,883,82,5/8to6/8,8/6to8/7,5/8to6/8:6/8to6/7:6/7to6/6:6/6to7/6:7/6to8/6:8/6to8/7:,6,True,True
3326,801,995,194,0/14to0/15,10/15to11/15,0/14to0/15:0/15to0/14:0/14to1/14:1/14to2/14:2/14to3/14:3/14to4/14:4/14to5/14:5/14to6/14:6/14to7/14:7/14to8/14:8/14to9/14:9/14to10/14:10/14to10/15:10/15to11/15:,14,True,True
1623,801,932,131,9/14to9/15,3/13to4/13,9/14to9/15:9/15to8/15:8/15to7/15:7/15to6/15:6/15to5/15:5/15to4/15:4/15to3/15:3/15to3/14:3/14to3/13:3/13to4/13:,10,True,True
522,802,1102,300,2/1to2/2,10/10to9/10,2/1to2/2:2/2to2/3:2/3to2/4:2/4to2/5:2/5to2/6:2/6to2/7:2/7to2/8:2/8to2/9:2/9to2/10:2/10to3/10:3/10to4/10:4/10to5/10:5/10to6/10:6/10to7/10:7/10to8/10:8/10to9/10:9/10to10/10:10/10to9/10:,18,True,True
123,802,1185,383,left0to0/0,15/15totop15,left0to0/0:0/0to1/0:1/0to2/0:2/0to3/0:3/0to4/0:4/0to5/0:5/0to6/0:6/0to7/0:7/0to8/0:8/0to9/0:9/0to10/0:10/0to10/1:10/1to10/2:10/2to10/3:10/3to10/4:10/4to10/5:10/5to10/6:10/6to10/7:10/7to10/8:10/8to10/9:10/9to10/10:10/10to10/11:10/11to10/12:10/12to10/13:10/13to10/14:10/14to10/15:10/15to11/15:11/15to12/15:12/15to13/15:13/15to14/15:14/15to15/15:15/15totop15:,32,False,True
889,802,965,163,1/3to2/3,11/4to12/4,1/3to2/3:2/3to3/3:3/3to4/3:4/3to5/3:5/3to6/3:6/3to7/3:7/3to8/3:8/3to9/3:9/3to10/3:10/3to11/3:11/3to11/4:11/4to12/4:,12,True,True
2289,802,991,189,12/9to11/9,4/14to4/15,12/9to11/9:11/9to10/9:10/9to9/9:9/9to8/9:8/9to7/9:7/9to6/9:6/9to5/9:5/9to4/9:4/9to4/10:4/10to4/11:4/11to4/12:4/12to4/13:4/13to4/14:4/14to4/15:,14,True,True
651,803,864,61,4/6to3/6,5/7to6/7,4/6to3/6:3/6to3/7:3/7to4/7:4/7to5/7:5/7to6/7:,5,True,True
2627,803,914,111,15/13to14/13,8/13to8/14,15/13to14/13:14/13to13/13:13/13to12/13:12/13to11/13:11/13to10/13:10/13to9/13:9/13to8/13:8/13to8/14:,8,False,True
1864,803,1049,246,15/15to14/15,10/0to9/0,15/15to14/15:14/15to13/15:13/15to12/15:12/15to11/15:11/15to10/15:10/15to10/14:10/14to10/13:10/13to10/12:10/12to10/11:10/11to10/10:10/10to10/9:10/9to10/8:10/8to10/7:10/7to10/6:10/6to10/5:10/5to10/4:10/4to10/3:10/3to10/2:10/2to10/1:10/1to10/0:10/0to9/0:,21,False,True
2947,805,889,84,5/10to5/9,10/9to11/9,5/10to5/9:5/9to6/9:6/9to7/9:7/9to8/9:8/9to9/9:9/9to10/9:10/9to11/9:,7,False,True
2428,805,1016,211,bottom8to8/0,10/14to10/15,bottom8to8/0:8/0to9/0:9/0to10/0:10/0to10/1:10/1to10/2:10/2to10/3:10/3to10/4:10/4to10/5:10/5to10/6:10/6to10/7:10/7to10/8:10/8to10/9:10/9to10/10:10/10to10/11:10/11to10/12:10/12to10/13:10/13to10/14:10/14to10/15:,18,False,True
3188,805,997,192,4/2to3/2,8/11to8/10,4/2to3/2:3/2to3/3:3/3to3/4:3/4to3/5:3/5to3/6:3/6to3/7:3/7to3/8:3/8to3/9:3/9to3/10:3/10to3/11:3/11to4/11:4/11to5/11:5/11to6/11:6/11to7/11:7/11to8/11:8/11to8/10:,16,True,True
1799,805,981,176,bottom15to15/0,13/12to13/13,bottom15to15/0:15/0to14/0:14/0to13/0:13/0to13/1:13/1to13/2:13/2to13/3:13/3to13/4:13/4to13/5:13/5to13/6:13/6to13/7:13/7to13/8:13/8to13/9:13/9to13/10:13/10to13/11:13/11to13/12:13/12to13/13:,16,False,True
2029,806,843,37,6/3to6/2,5/2to5/1,6/3to6/2:6/2to5/2:5/2to5/1:,3,False,True
553,806,957,151,6/3to6/4,9/12to9/13,6/3to6/4:6/4to6/5:6/5to6/6:6/6to6/7:6/7to6/8:6/8to6/9:6/9to6/10:6/10to6/11:6/11to6/12:6/12to7/12:7/12to8/12:8/12to9/12:9/12to9/13:,13,True,True
2364,806,851,45,15/6to14/6,15/7to15/8,15/6to14/6:14/6to14/7:14/7to15/7:15/7to15/8:,4,True,True
218,806,1178,372,right15to15/15,0/0tobottom0,right15to15/15:15/15to14/15:14/15to13/15:13/15to12/15:12/15to11/15:11/15to10/15:10/15to9/15:9/15to8/15:8/15to7/15:7/15to6/15:6/15to5/15:5/15to4/15:4/15to3/15:3/15to2/15:2/15to1/15:1/15to0/15:0/15to0/14:0/14to0/13:0/13to0/12:0/12to0/11:0/11to0/10:0/10to0/9:0/9to0/8:0/8to0/7:0/7to0/6:0/6to0/5:0/5to0/4:0/4to0/3:0/3to0/2:0/2to0/1:0/1to0/0:0/0tobottom0:,32,False,True
3007,807,874,67,13/13to12/13,13/11to13/10,13/13to12/13:12/13to12/12:12/12to12/11:12/11to13/11:13/11to13/10:,5,True,True
2908,807,892,85,13/15to13/14,12/10to12/9,13/15to13/14:13/14to12/14:12/14to12/13:12/13to12/12:12/12to12/11:12/11to12/10:12/10to12/9:,7,False,True
2064,807,887,80,9/6to9/7,10/11to9/11,9/6to9/7:9/7to9/8:9/8to9/9:9/9to9/10:9/10to9/11:9/11to10/11:10/11to9/11:,7,True,True
2825,807,959,152,9/4to9/5,13/3to14/3,9/4to9/5:9/5to10/5:10/5to10/4:10/4to10/3:10/3to11/3:11/3to12/3:12/3to13/3:13/3to14/3:,8,False,True
3375,808,1038,230,bottom9to9/0,13/14to13/15,bottom9to9/0:9/0to10/0:10/0to10/1:10/1to10/2:10/2to10/3:10/3to10/4:10/4to10/5:10/5to10/6:10/6to10/7:10/7to10/8:10/8to10/9:10/9to10/10:10/10to10/11:10/11to10/12:10/12to10/13:10/13to10/14:10/14to11/14:11/14to12/14:12/14to13/14:13/14to13/15:,20,False,True
3232,808,881,73,4/0to5/0,7/2to8/2,4/0to5/0:5/0to5/1:5/1to5/2:5/2to6/2:6/2to7/2:7/2to8/2:,6,False,True
3331,808,966,158,9/10to8/10,2/14to2/15,9/10to8/10:8/10to7/10:7/10to6/10:6/10to5/10:5/10to4/10:4/10to3/10:3/10to2/10:2/10to2/11:2/11to2/12:2/12to2/13:2/13to2/14:2/14to2/15:,12,False,True
151,809,1182,373,left0to0/0,15/15totop15,left0to0/0:0/0to0/1:0/1to0/2:0/2to0/3:0/3to0/4:0/4to0/5:0/5to0/6:0/6to0/7:0/7to0/8:0/8to0/9:0/9to0/10:0/10to0/11:0/11to0/12:0/12to0/13:0/13to0/14:0/14to1/14:1/14to2/14:2/14to3/14:3/14to4/14:4/14to5/14:5/14to6/14:6/14to7/14:7/14to8/14:8/14to9/14:9/14to10/14:10/14to10/15:10/15to11/15:11/15to12/15:12/15to13/15:13/15to14/15:14/15to15/15:15/15totop15:,32,True,True
363,809,1178,369,right0to15/0,0/15totop0,right0to15/0:15/0to14/0:14/0to13/0:13/0to12/0:12/0to11/0:11/0to10/0:10/0to9/0:9/0to8/0:8/0to7/0:7/0to6/0:6/0to5/0:5/0to4/0:4/0to3/0:3/0to2/0:2/0to1/0:1/0to0/0:0/0to0/1:0/1to0/2:0/2to0/3:0/3to0/4:0/4to0/5:0/5to0/6:0/6to0/7:0/7to0/8:0/8to0/9:0/9to0/10:0/10to0/11:0/11to0/12:0/12to0/13:0/13to0/14:0/14to0/15:0/15totop0:,32,False,True
1607,809,981,172,top2to2/15,13/14to14/14,top2to2/15:2/15to3/15:3/15to4/15:4/15to5/15:5/15to6/15:6/15to7/15:7/15to8/15:8/15to9/15:9/15to10/15:10/15to10/14:10/14to11/14:11/14to12/14:12/14to13/14:13/14to14/14:,14,False,True
115,809,1206,397,left0to0/0,15/15totop15,left0to0/0:0/0to0/1:0/1to0/2:0/2to0/3:0/3to0/4:0/4to0/5:0/5to0/6:0/6to0/7:0/7to0/8:0/8to0/9:0/9to0/10:0/10to0/11:0/11to0/12:0/12to0/13:0/13to0/14:0/14to1/14:1/14to2/14:2/14to3/14:3/14to4/14:4/14to5/14:5/14to6/14:6/14to7/14:7/14to8/14:8/14to9/14:9/14to10/14:10/14to10/15:10/15to11/15:11/15to12/15:12/15to13/15:13/15to14/15:14/15to15/15:15/15totop15:,32,True,True
163,809,1196,387,left0to0/0,15/15totop15,left0to0/0:0/0to1/0:1/0to2/0:2/0to3/0:3/0to4/0:4/0to5/0:5/0to6/0:6/0to7/0:7/0to8/0:8/0to9/0:9/0to10/0:10/0to10/1:10/1to10/2:10/2to10/3:10/3to10/4:10/4to10/5:10/5to10/6:10/6to10/7:10/7to10/8:10/8to10/9:10/9to10/10:10/10to10/11:10/11to10/12:10/12to10/13:10/13to10/14:10/14to10/15:10/15to11/15:11/15to12/15:12/15to13/15:13/15to14/15:14/15to15/15:15/15totop15:,32,False,True
3280,809,1005,196,5/1to5/2,7/15to8/15,5/1to5/2:5/2to5/3:5/3to5/4:5/4to5/5:5/5to5/6:5/6to5/7:5/7to5/8:5/8to5/9:5/9to5/10:5/10to5/11:5/11to5/12:5/12to5/13:5/13to5/14:5/14to5/15:5/15to6/15:6/15to7/15:7/15to8/15:,17,True,True
707,810,910,100,left8to0/8,1/3to2/3,left8to0/8:0/8to0/7:0/7to0/6:0/6to0/5:0/5to0/4:0/4to0/3:0/3to1/3:1/3to2/3:,8,False,True
3237,811,968,157,7/10to7/9,1/14to2/14,7/10to7/9:7/9to6/9:6/9to5/9:5/9to4/9:4/9to3/9:3/9to2/9:2/9to1/9:1/9to1/10:1/10to1/11:1/11to1/12:1/12to1/13:1/13to1/14:1/14to2/14:,13,True,True
1831,811,967,156,6/0to7/0,10/7to11/7,6/0to7/0:7/0to7/1:7/1to7/2:7/2to7/3:7/3to7/4:7/4to7/5:7/5to7/6:7/6to7/7:7/7to8/7:8/7to9/7:9/7to10/7:10/7to11/7:,12,True,True
253,812,1224,412,right15to15/15,0/0tobottom0,right15to15/15:15/15to14/15:14/15to13/15:13/15to12/15:12/15to11/15:11/15to11/14:11/14to10/14:10/14to9/14:9/14to8/14:8/14to7/14:7/14to6/14:6/14to5/14:5/14to4/14:4/14to3/14:3/14to2/14:2/14to1/14:1/14to0/14:0/14to0/13:0/13to0/12:0/12to0/11:0/11to0/10:0/10to0/9:0/9to0/8:0/8to0/7:0/7to0/6:0/6to0/5:0/5to0/4:0/4to0/3:0/3to0/2:0/2to0/1:0/1to0/0:0/0tobottom0:,32,True,True
534,812,973,161,right11to15/11,14/0to15/0,right11to15/11:15/11to14/11:14/11to14/10:14/10to14/9:14/9to14/8:14/8to14/7:14/7to14/6:14/6to14/5:14/5to14/4:14/4to14/3:14/3to14/2:14/2to14/1:14/1to14/0:14/0to15/0:,14,True,True
1547,813,1049,236,8/0to7/0,0/11toleft11,8/0to7/0:7/0to6/0:6/0to5/0:5/0to4/0:4/0to3/0:3/0to2/0:2/0to1/0:1/0to0/0:0/0to0/1:0/1to0/2:0/2to0/3:0/3to0/4:0/4to0/5:0/5to0/6:0/6to0/7:0/7to0/8:0/8to0/9:0/9to0/10:0/10to0/11:0/11toleft11:,20,False,True
1998,813,1098,285,15/14to15/13,4/3to5/3,15/14to15/13:15/13to14/13:14/13to13/13:13/13to12/13:12/13to12/12:12/12to11/12:11/12to10/12:10/12to9/12:9/12to8/12:8/12to7/12:7/12to6/12:6/12to5/12:5/12to4/12:4/12to4/11:4/11to4/10:4/10to4/9:4/9to4/8:4/8to4/7:4/7to4/6:4/6to4/5:4/5to4/4:4/4to4/3:4/3to5/3:,23,True,True
637,813,867,54,2/11to1/11,0/13toleft13,2/11to1/11:1/11to0/11:0/11to0/12:0/12to0/13:0/13toleft13:,5,True,True
906,813,1044,231,2/10to3/10,14/15totop14,2/10to3/10:3/10to3/11:3/11to3/12:3/12to3/13:3/13to4/13:4/13to5/13:5/13to6/13:6/13to7/13:7/13to8/13:8/13to9/13:9/13to10/13:10/13to10/14:10/14to11/14:11/14to11/15:11/15to12/15:12/15to13/15:13/15to14/15:14/15totop14:,18,True,True
2930,814,939,125,5/4to5/5,1/1to0/1,5/4to5/5:5/5to4/5:4/5to3/5:3/5to2/5:2/5to1/5:1/5to1/4:1/4to1/3:1/3to1/2:1/2to1/1:1/1to0/1:,10,True,True
2803,814,1080,266,7/5to8/5,12/13to12/12,7/5to8/5:8/5to8/6:8/6to8/7:8/7to8/8:8/8to8/9:8/9to8/10:8/10to8/11:8/11to9/11:9/11to10/11:10/11to10/12:10/12to11/12:11/12to12/12:12/12to12/13:12/13to12/12:,14,True,True
1150,815,1122,307,4/6to5/6,10/12to11/12,4/6to5/6:5/6to5/7:5/7to5/8:5/8to5/9:5/9to5/10:5/10to6/10:6/10to7/10:7/10to8/10:8/10to9/10:9/10to10/10:10/10to10/11:10/11to10/12:10/12to11/12:,13,True,True
3211,815,1265,450,3/4to3/5,14/8to15/8,3/4to3/5:3/5to4/5:4/5to5/5:5/5to6/5:6/5to7/5:7/5to8/5:8/5to9/5:9/5to10/5:10/5to10/6:10/6to10/7:10/7to10/8:10/8to11/8:11/8to12/8:12/8to13/8:13/8to14/8:14/8to15/8:,16,False,True
2265,815,1022,207,11/11to11/12,3/6to3/5,11/11to11/12:11/12to10/12:10/12to9/12:9/12to8/12:8/12to7/12:7/12to6/12:6/12to5/12:5/12to4/12:4/12to3/12:3/12to3/11:3/11to3/10:3/10to3/9:3/9to3/8:3/8to3/7:3/7to3/6:3/6to3/5:,16,False,True
2978,815,1110,295,0/0to0/1,10/13to10/14,0/0to0/1:0/1to0/2:0/2to0/3:0/3to0/4:0/4to0/5:0/5to0/6:0/6to0/7:0/7to0/8:0/8to0/9:0/9to0/10:0/10to0/11:0/11to0/12:0/12to0/13:0/13to1/13:1/13to2/13:2/13to3/13:3/13to4/13:4/13to5/13:5/13to6/13:6/13to7/13:7/13to8/13:8/13to9/13:9/13to10/13:10/13to10/14:,24,True,True
2124,816,910,94,0/11to1/11,4/9to4/10,0/11to1/11:1/11to1/10:1/10to1/9:1/9to2/9:2/9to3/9:3/9to4/9:4/9to4/10:,7,True,True
1235,817,966,149,12/9to12/8,9/15to8/15,12/9to12/8:12/8to11/8:11/8to10/8:10/8to10/9:10/9to10/10:10/10to10/11:10/11to10/12:10/12to10/13:10/13to10/14:10/14to10/15:10/15to9/15:9/15to8/15:,12,False,True
1403,817,1009,192,2/1to1/1,9/6to9/7,2/1to1/1:1/1to1/2:1/2to1/3:1/3to1/4:1/4to1/5:1/5to1/6:1/6to2/6:2/6to3/6:3/6to4/6:4/6to5/6:5/6to6/6:6/6to7/6:7/6to8/6:8/6to9/6:9/6to9/7:,15,False,True
265,817,1195,378,right15to15/15,0/0tobottom0,right15to15/15:15/15to14/15:14/15to13/15:13/15to12/15:12/15to11/15:11/15to10/15:10/15to9/15:9/15to8/15:8/15to7/15:7/15to6/15:6/15to5/15:5/15to4/15:4/15to3/15:3/15to2/15:2/15to1/15:1/15to0/15:0/15to0/14:0/14to0/13:0/13to0/12:0/12to0/11:0/11to0/10:0/10to0/9:0/9to0/8:0/8to0/7:0/7to0/6:0/6to0/5:0/5to0/4:0/4to0/3:0/3to0/2:0/2to0/1:0/1to0/0:0/0tobottom0:,32,False,True
1535,818,1037,219,9/11to8/11,1/4to2/4,9/11to8/11:8/11to7/11:7/11to6/11:6/11to5/11:5/11to4/11:4/11to3/11:3/11to2/11:2/11to1/11:1/11to1/10:1/10to1/9:1/9to1/8:1/8to1/7:1/7to1/6:1/6to1/5:1/5to1/4:1/4to2/4:,16,True,True
857,819,1104,285,left15to0/15,10/3to11/3,left15to0/15:0/15to0/14:0/14to0/13:0/13to0/12:0/12to0/11:0/11to0/10:0/10to0/9:0/9to0/8:0/8to0/7:0/7to0/6:0/6to0/5:0/5to0/4:0/4to0/3:0/3to1/3:1/3to2/3:2/3to3/3:3/3to4/3:4/3to5/3:5/3to6/3:6/3to7/3:7/3to8/3:8/3to9/3:9/3to10/3:10/3to11/3:,24,True,True
929,819,1049,230,15/8to14/8,6/9to7/9,15/8to14/8:14/8to13/8:13/8to12/8:12/8to11/8:11/8to10/8:10/8to9/8:9/8to8/8:8/8to7/8:7/8to6/8:6/8to6/9:6/9to7/9:,11,False,True
2097,820,873,53,2/13to1/13,0/14to1/14,2/13to1/13:1/13to0/13:0/13to0/14:0/14to1/14:,4,True,True
2230,820,880,60,12/9to12/8,11/10to10/10,12/9to12/8:12/8to11/8:11/8to11/9:11/9to11/10:11/10to10/10:,5,False,True
1986,820,1031,211,8/15to9/15,10/0to11/0,8/15to9/15:9/15to10/15:10/15to10/14:10/14to10/13:10/13to10/12:10/12to10/11:10/11to10/10:10/10to10/9:10/9to10/8:10/8to10/7:10/7to10/6:10/6to10/5:10/5to10/4:10/4to10/3:10/3to10/2:10/2to10/1:10/1to10/0:10/0to11/0:,18,False,True
1736,820,1007,187,10/15to9/15,6/7to7/7,10/15to9/15:9/15to8/15:8/15to7/15:7/15to6/15:6/15to6/14:6/14to6/13:6/13to6/12:6/12to6/11:6/11to6/10:6/10to6/9:6/9to6/8:6/8to6/7:6/7to7/7:,13,False,True
2094,821,1074,253,1/6to1/5,13/10to14/10,1/6to1/5:1/5to1/6:1/6to1/7:1/7to1/8:1/8to1/9:1/9to1/10:1/10to2/10:2/10to3/10:3/10to4/10:4/10to5/10:5/10to6/10:6/10to7/10:7/10to8/10:8/10to9/10:9/10to10/10:10/10to11/10:11/10to12/10:12/10to13/10:13/10to14/10:,19,True,True
924,821,916,95,6/4to5/4,3/1to3/0,6/4to5/4:5/4to4/4:4/4to3/4:3/4to3/3:3/3to3/2:3/2to3/1:3/1to3/0:,7,True,True
35,821,1212,391,left15to0/15,15/0tobottom15,left15to0/15:0/15to1/15:1/15to2/15:2/15to3/15:3/15to4/15:4/15to5/15:5/15to6/15:6/15to7/15:7/15to8/15:8/15to9/15:9/15to10/15:10/15to10/14:10/14to10/13:10/13to10/12:10/12to10/11:10/11to10/10:10/10to10/9:10/9to10/8:10/8to10/7:10/7to10/6:10/6to10/5:10/5to10/4:10/4to10/3:10/3to10/2:10/2to10/1:10/1to10/0:10/0to11/0:11/0to12/0:12/0to13/0:13/0to14/0:14/0to15/0:15/0tobottom15:,32,False,True
301,821,1191,370,right0to15/0,0/15totop0,right0to15/0:15/0to14/0:14/0to13/0:13/0to12/0:12/0to11/0:11/0to10/0:10/0to9/0:9/0to8/0:8/0to7/0:7/0to6/0:6/0to5/0:5/0to4/0:4/0to3/0:3/0to2/0:2/0to1/0:1/0to0/0:0/0to0/1:0/1to0/2:0/2to0/3:0/3to0/4:0/4to0/5:0/5to0/6:0/6to0/7:0/7to0/8:0/8to0/9:0/9to0/10:0/10to0/11:0/11to0/12:0/12to0/13:0/13to0/14:0/14to0/15:0/15totop0:,32,False,True
3076,822,1136,314,8/6to8/5,11/15to12/15,8/6to8/5:8/5to9/5:9/5to10/5:10/5to10/6:10/6to10/7:10/7to10/8:10/8to10/9:10/9to10/10:10/10to10/11:10/11to10/12:10/12to10/13:10/13to10/14:10/14to10/15:10/15to11/15:11/15to12/15:,15,False,True
1006,822,917,95,5/0to4/0,4/6to4/7,5/0to4/0:4/0to4/1:4/1to4/2:4/2to4/3:4/3to4/4:4/4to4/5:4/5to4/6:4/6to4/7:,8,True,True
2460,822,947,125,4/9to4/8,8/4to9/4,4/9to4/8:4/8to4/7:4/7to4/6:4/6to4/5:4/5to4/4:4/4to5/4:5/4to6/4:6/4to7/4:7/4to8/4:8/4to9/4:,10,False,True
2942,822,1204,382,11/2to11/1,1/11to2/11,11/2to11/1:11/1to10/1:10/1to9/1:9/1to8/1:8/1to7/1:7/1to6/1:6/1to5/1:5/1to4/1:4/1to3/1:3/1to2/1:2/1to1/1:1/1to1/2:1/2to1/3:1/3to1/4:1/4to1/5:1/5to1/6:1/6to1/7:1/7to1/8:1/8to1/9:1/9to1/10:1/10to1/11:1/11to2/11:,22,False,True
1949,822,997,175,12/2to11/2,13/13to14/13,12/2to11/2:11/2to11/3:11/3to11/4:11/4to11/5:11/5to11/6:11/6to11/7:11/7to11/8:11/8to11/9:11/9to11/10:11/10to11/11:11/11to11/12:11/12to11/13:11/13to12/13:12/13to13/13:13/13to14/13:,15,True,True
1442,823,1127,304,9/7to9/8,14/15to15/15,9/7to9/8:9/8to10/8:10/8to10/9:10/9to10/10:10/10to10/11:10/11to10/12:10/12to10/13:10/13to10/14:10/14to10/15:10/15to11/15:11/15to12/15:12/15to13/15:13/15to14/15:14/15to15/15:,14,False,True
1297,823,938,115,15/12to14/12,9/15totop9,15/12to14/12:14/12to13/12:13/12to12/12:12/12to11/12:11/12to11/13:11/13to10/13:10/13to10/14:10/14to9/14:9/14to9/15:9/15totop9:,10,True,True
51,823,1218,395,left15to0/15,15/0tobottom15,left15to0/15:0/15to1/15:1/15to2/15:2/15to3/15:3/15to4/15:4/15to5/15:5/15to6/15:6/15to7/15:7/15to8/15:8/15to9/15:9/15to10/15:10/15to10/14:10/14to10/13:10/13to10/12:10/12to10/11:10/11to10/10:10/10to10/9:10/9to10/8:10/8to10/7:10/7to10/6:10/6to10/5:10/5to10/4:10/4to10/3:10/3to10/2:10/2to10/1:10/1to10/0:10/0to11/0:11/0to12/0:12/0to13/0:13/0to14/0:14/0to15/0:15/0tobottom15:,32,False,True
1234,823,976,153,15/5to15/4,7/2to7/1,15/5to15/4:15/4to14/4:14/4to13/4:13/4to12/4:12/4to12/3:12/3to11/3:11/3to10/3:10/3to9/3:9/3to8/3:8/3to7/3:7/3to7/2:7/2to7/1:,12,True,True
437,824,957,133,10/4to9/4,1/4to0/4,10/4to9/4:9/4to8/4:8/4to7/4:7/4to6/4:6/4to5/4:5/4to4/4:4/4to3/4:3/4to2/4:2/4to1/4:1/4to0/4:,10,False,True
1833,824,893,69,0/11to0/10,3/10to3/11,0/11to0/10:0/10to1/10:1/10to2/10:2/10to3/10:3/10to3/11:,5,True,True
2604,825,1132,307,4/13to4/12,15/0tobottom15,4/13to4/12:4/12to4/11:4/11to4/10:4/10to4/9:4/9to4/8:4/8to4/7:4/7to4/6:4/6to4/5:4/5to4/4:4/4to4/3:4/3to4/2:4/2to5/2:5/2to6/2:6/2to7/2:7/2to8/2:8/2to9/2:9/2to10/2:10/2to10/1:10/1to11/1:11/1to11/0:11/0to12/0:12/0to13/0:13/0to14/0:14/0to15/0:15/0tobottom15:,25,True,True
560,825,1015,190,10/5to10/4,5/12to4/12,10/5to10/4:10/4to9/4:9/4to8/4:8/4to7/4:7/4to6/4:6/4to5/4:5/4to5/5:5/5to5/6:5/6to5/7:5/7to5/8:5/8to5/9:5/9to5/10:5/10to5/11:5/11to5/12:5/12to4/12:,15,True,True
3266,825,1056,231,6/10to7/10,12/15totop12,6/10to7/10:7/10to8/10:8/10to9/10:9/10to10/10:10/10to10/11:10/11to10/12:10/12to10/13:10/13to10/14:10/14to10/15:10/15to11/15:11/15to12/15:12/15totop12:,12,False,True
863,825,1018,193,2/12to1/12,0/2to0/1,2/12to1/12:1/12to0/12:0/12to0/11:0/11to0/10:0/10to0/9:0/9to0/8:0/8to0/7:0/7to0/6:0/6to0/5:0/5to0/4:0/4to0/3:0/3to0/2:0/2to0/1:,13,True,True
980,825,1126,301,12/5to11/5,4/6to4/7,12/5to11/5:11/5to10/5:10/5to9/5:9/5to8/5:8/5to7/5:7/5to6/5:6/5to5/5:5/5to4/5:4/5to4/6:4/6to4/7:,10,False,True
345,825,1294,469,right0to15/0,0/15totop0,right0to15/0:15/0to14/0:14/0to13/0:13/0to12/0:12/0to11/0:11/0to11/1:11/1to10/1:10/1to9/1:9/1to8/1:8/1to7/1:7/1to6/1:6/1to5/1:5/1to4/1:4/1to3/1:3/1to2/1:2/1to1/1:1/1to0/1:0/1to0/2:0/2to0/3:0/3to0/4:0/4to0/5:0/5to0/6:0/6to0/7:0/7to0/8:0/8to0/9:0/9to0/10:0/10to0/11:0/11to0/12:0/12to0/13:0/13to0/14:0/14to0/15:0/15totop0:,32,True,True
1384,826,1010,184,1/10to2/10,12/7to12/8,1/10to2/10:2/10to3/10:3/10to4/10:4/10to5/10:5/10to6/10:6/10to7/10:7/10to8/10:8/10to9/10:9/10to10/10:10/10to10/9:10/9to10/8:10/8to10/7:10/7to11/7:11/7to12/7:12/7to12/8:,15,False,True
1074,826,1116,290,9/1to9/2,0/14to0/15,9/1to9/2:9/2to8/2:8/2to7/2:7/2to6/2:6/2to5/2:5/2to4/2:4/2to3/2:3/2to2/2:2/2to1/2:1/2to0/2:0/2to0/3:0/3to0/4:0/4to0/5:0/5to0/6:0/6to0/7:0/7to0/8:0/8to0/9:0/9to0/10:0/10to0/11:0/11to0/12:0/12to0/13:0/13to0/14:0/14to0/15:,23,False,True
1375,826,968,142,12/12to12/11,14/3to14/4,12/12to12/11:12/11to12/10:12/10to12/9:12/9to12/8:12/8to12/7:12/7to12/6:12/6to12/5:12/5to12/4:12/4to12/3:12/3to13/3:13/3to14/3:14/3to14/4:,12,False,True
1955,826,1020,194,12/1to11/1,10/12to9/12,12/1to11/1:11/1to11/2:11/2to11/3:11/3to12/3:12/3to12/4:12/4to12/5:12/5to12/6:12/6to12/7:12/7to12/8:12/8to12/9:12/9to12/10:12/10to12/11:12/11to11/11:11/11to10/11:10/11to10/12:10/12to9/12:,16,True,True
731,826,1150,324,13/15to13/14,0/6to0/5,13/15to13/14:13/14to12/14:12/14to11/14:11/14to10/14:10/14to9/14:9/14to8/14:8/14to7/14:7/14to6/14:6/14to5/14:5/14to4/14:4/14to3/14:3/14to2/14:2/14to1/14:1/14to0/14:0/14to0/13:0/13to0/12:0/12to0/11:0/11to0/10:0/10to0/9:0/9to0/8:0/8to0/7:0/7to0/6:0/6to0/5:,23,False,True
1558,826,851,25,14/11to13/11,13/11to12/11,14/11to13/11:13/11to12/11:,2,True,True
2539,826,1197,371,14/12to13/12,3/2to4/2,14/12to13/12:13/12to12/12:12/12to11/12:11/12to11/11:11/11to10/11:10/11to9/11:9/11to8/11:8/11to7/11:7/11to6/11:6/11to5/11:5/11to4/11:4/11to3/11:3/11to3/10:3/10to3/9:3/9to3/8:3/8to3/7:3/7to3/6:3/6to3/5:3/5to3/4:3/4to3/3:3/3to3/2:3/2to4/2:,22,True,True
2175,826,953,127,8/8to8/7,3/5to2/5,8/8to8/7:8/7to7/7:7/7to6/7:6/7to5/7:5/7to4/7:4/7to3/7:3/7to3/6:3/6to3/5:3/5to2/5:,9,True,True
2642,827,1111,284,13/12to12/12,0/11to0/10,13/12to12/12:12/12to11/12:11/12to11/11:11/11to10/11:10/11to9/11:9/11to8/11:8/11to7/11:7/11to6/11:6/11to5/11:5/11to4/11:4/11to3/11:3/11to2/11:2/11to1/11:1/11to0/11:0/11to0/10:,15,True,True
1385,827,1080,253,15/12to15/11,5/10to4/10,15/12to15/11:15/11to14/11:14/11to13/11:13/11to12/11:12/11to11/11:11/11to10/11:10/11to9/11:9/11to8/11:8/11to7/11:7/11to6/11:6/11to5/11:5/11to5/10:5/10to4/10:,13,False,True
315,828,1306,478,right0to15/0,0/15totop0,right0to15/0:15/0to14/0:14/0to13/0:13/0to12/0:12/0to11/0:11/0to11/1:11/1to10/1:10/1to9/1:9/1to8/1:8/1to7/1:7/1to6/1:6/1to5/1:5/1to4/1:4/1to3/1:3/1to2/1:2/1to1/1:1/1to0/1:0/1to0/2:0/2to0/3:0/3to0/4:0/4to0/5:0/5to0/6:0/6to0/7:0/7to0/8:0/8to0/9:0/9to0/10:0/10to0/11:0/11to0/12:0/12to0/13:0/13to0/14:0/14to0/15:0/15totop0:,32,True,True
3078,828,1081,253,14/1to13/1,0/5toleft5,14/1to13/1:13/1to12/1:12/1to12/2:12/2to11/2:11/2to10/2:10/2to9/2:9/2to8/2:8/2to7/2:7/2to6/2:6/2to5/2:5/2to4/2:4/2to3/2:3/2to2/2:2/2to1/2:1/2to0/2:0/2to0/3:0/3to0/4:0/4to0/5:0/5toleft5:,19,True,True
209,829,1208,379,right15to15/15,0/0tobottom0,right15to15/15:15/15to14/15:14/15to13/15:13/15to12/15:12/15to11/15:11/15to10/15:10/15to9/15:9/15to8/15:8/15to7/15:7/15to6/15:6/15to5/15:5/15to4/15:4/15to3/15:3/15to2/15:2/15to1/15:1/15to0/15:0/15to0/14:0/14to0/13:0/13to0/12:0/12to0/11:0/11to0/10:0/10to0/9:0/9to0/8:0/8to0/7:0/7to0/6:0/6to0/5:0/5to0/4:0/4to0/3:0/3to0/2:0/2to0/1:0/1to0/0:0/0tobottom0:,32,False,True
725,829,1221,392,6/8to7/8,11/12to12/12,6/8to7/8:7/8to8/8:8/8to9/8:9/8to10/8:10/8to10/9:10/9to10/10:10/10to10/11:10/11to10/12:10/12to11/12:11/12to12/12:,10,False,True
348,829,1219,390,right0to15/0,0/15totop0,right0to15/0:15/0to14/0:14/0to13/0:13/0to12/0:12/0to11/0:11/0to10/0:10/0to9/0:9/0to8/0:8/0to7/0:7/0to6/0:6/0to5/0:5/0to4/0:4/0to3/0:3/0to2/0:2/0to1/0:1/0to0/0:0/0to0/1:0/1to0/2:0/2to0/3:0/3to0/4:0/4to0/5:0/5to0/6:0/6to0/7:0/7to0/8:0/8to0/9:0/9to0/10:0/10to0/11:0/11to0/12:0/12to0/13:0/13to0/14:0/14to0/15:0/15totop0:,32,False,True
1967,829,989,160,8/12to9/12,10/1to9/1,8/12to9/12:9/12to10/12:10/12to10/11:10/11to10/10:10/10to10/9:10/9to10/8:10/8to10/7:10/7to10/6:10/6to10/5:10/5to10/4:10/4to10/3:10/3to10/2:10/2to10/1:10/1to9/1:,14,False,True
1207,829,1004,175,7/4to7/3,5/14to4/14,7/4to7/3:7/3to6/3:6/3to5/3:5/3to5/4:5/4to5/5:5/5to5/6:5/6to5/7:5/7to5/8:5/8to5/9:5/9to5/10:5/10to5/11:5/11to5/12:5/12to5/13:5/13to5/14:5/14to4/14:,15,True,True
612,829,1176,347,15/0to14/0,0/6to0/7,15/0to14/0:14/0to13/0:13/0to12/0:12/0to11/0:11/0to11/1:11/1to10/1:10/1to9/1:9/1to8/1:8/1to7/1:7/1to6/1:6/1to5/1:5/1to4/1:4/1to3/1:3/1to2/1:2/1to1/1:1/1to0/1:0/1to0/2:0/2to0/3:0/3to0/4:0/4to0/5:0/5to0/6:0/6to0/7:,22,True,True
2475,829,1200,371,left1to0/1,10/14to9/14,left1to0/1:0/1to1/1:1/1to2/1:2/1to3/1:3/1to4/1:4/1to5/1:5/1to6/1:6/1to7/1:7/1to8/1:8/1to9/1:9/1to10/1:10/1to10/2:10/2to10/3:10/3to10/4:10/4to10/5:10/5to10/6:10/6to10/7:10/7to10/8:10/8to10/9:10/9to10/10:10/10to10/11:10/11to10/12:10/12to10/13:10/13to10/14:10/14to9/14:,25,False,True
1441,830,865,35,9/0to9/1,9/2to8/2,9/0to9/1:9/1to9/2:9/2to8/2:,3,True,True
744,830,1104,274,8/12to8/13,15/0tobottom15,8/12to8/13:8/13to8/12:8/12to8/11:8/11to8/10:8/10to8/9:8/9to8/8:8/8to8/7:8/7to8/6:8/6to8/5:8/5to8/4:8/4to8/3:8/3to8/2:8/2to8/1:8/1to8/0:8/0to9/0:9/0to10/0:10/0to11/0:11/0to12/0:12/0to13/0:13/0to14/0:14/0to15/0:15/0tobottom15:,22,True,True
1172,830,1014,184,9/9to9/8,15/1to15/0,9/9to9/8:9/8to9/7:9/7to9/6:9/6to9/5:9/5to9/4:9/4to9/3:9/3to10/3:10/3to10/2:10/2to11/2:11/2to12/2:12/2to12/1:12/1to13/1:13/1to14/1:14/1to15/1:15/1to15/0:,15,True,True
2136,831,1125,294,right10to15/10,5/12to6/12,right10to15/10:15/10to14/10:14/10to13/10:13/10to12/10:12/10to11/10:11/10to10/10:10/10to9/10:9/10to8/10:8/10to7/10:7/10to6/10:6/10to5/10:5/10to5/11:5/11to5/12:5/12to6/12:,14,False,True
1470,831,912,81,9/2to8/2,8/7to8/8,9/2to8/2:8/2to8/3:8/3to8/4:8/4to8/5:8/5to8/6:8/6to8/7:8/7to8/8:,7,False,True
1270,831,1036,205,7/3to6/3,1/13to1/14,7/3to6/3:6/3to5/3:5/3to4/3:4/3to3/3:3/3to2/3:2/3to1/3:1/3to1/4:1/4to1/5:1/5to1/6:1/6to1/7:1/7to1/8:1/8to1/9:1/9to1/10:1/10to1/11:1/11to1/12:1/12to1/13:1/13to1/14:,17,True,True
491,831,1199,368,3/4to4/4,12/8to13/8,3/4to4/4:4/4to5/4:5/4to6/4:6/4to7/4:7/4to8/4:8/4to9/4:9/4to10/4:10/4to10/5:10/5to10/6:10/6to10/7:10/7to10/8:10/8to11/8:11/8to12/8:12/8to13/8:,14,False,True
2992,831,953,122,3/1to3/2,8/5to9/5,3/1to3/2:3/2to3/3:3/3to3/4:3/4to3/5:3/5to4/5:4/5to5/5:5/5to6/5:6/5to7/5:7/5to8/5:8/5to9/5:,10,True,True
1929,831,953,122,2/4to1/4,5/8to5/9,2/4to1/4:1/4to1/5:1/5to1/6:1/6to1/7:1/7to1/8:1/8to2/8:2/8to3/8:3/8to4/8:4/8to5/8:5/8to5/9:,10,False,True
3388,831,1045,214,15/1to14/1,11/14to12/14,15/1to14/1:14/1to13/1:13/1to12/1:12/1to12/2:12/2to12/3:12/3to12/4:12/4to12/5:12/5to12/6:12/6to12/7:12/7to12/8:12/8to12/9:12/9to12/10:12/10to12/11:12/11to12/12:12/12to12/13:12/13to12/14:12/14to11/14:11/14to12/14:,18,True,True
1313,831,960,129,15/9to14/9,15/1to15/0,15/9to14/9:14/9to14/8:14/8to14/7:14/7to14/6:14/6to14/5:14/5to14/4:14/4to14/3:14/3to14/2:14/2to14/1:14/1to15/1:15/1to15/0:,11,False,True
1256,832,1061,229,3/3to3/2,15/7toright7,3/3to3/2:3/2to4/2:4/2to5/2:5/2to6/2:6/2to7/2:7/2to8/2:8/2to9/2:9/2to10/2:10/2to10/3:10/3to10/4:10/4to10/5:10/5to10/6:10/6to10/7:10/7to11/7:11/7to12/7:12/7to13/7:13/7to14/7:14/7to15/7:15/7toright7:,19,False,True
2766,832,980,148,9/4to9/3,12/6to12/5,9/4to9/3:9/3to10/3:10/3to10/4:10/4to10/5:10/5to10/6:10/6to11/6:11/6to12/6:12/6to12/5:,8,False,True
174,832,1202,370,left0to0/0,15/15totop15,left0to0/0:0/0to1/0:1/0to2/0:2/0to3/0:3/0to4/0:4/0to5/0:5/0to6/0:6/0to7/0:7/0to8/0:8/0to9/0:9/0to10/0:10/0to10/1:10/1to10/2:10/2to10/3:10/3to10/4:10/4to10/5:10/5to10/6:10/6to10/7:10/7to10/8:10/8to10/9:10/9to10/10:10/10to10/11:10/11to10/12:10/12to10/13:10/13to10/14:10/14to10/15:10/15to11/15:11/15to12/15:12/15to13/15:13/15to14/15:14/15to15/15:15/15totop15:,32,False,True
3166,832,930,98,13/5to12/5,11/10to11/11,13/5to12/5:12/5to12/6:12/6to12/7:12/7to12/8:12/8to11/8:11/8to11/9:11/9to11/10:11/10to11/11:,8,True,True
1220,832,942,110,4/1to5/1,9/3to9/4,4/1to5/1:5/1to5/2:5/2to5/3:5/3to6/3:6/3to7/3:7/3to8/3:8/3to9/3:9/3to9/4:,8,False,True
3235,832,869,37,left3to0/3,0/1to0/0,left3to0/3:0/3to0/2:0/2to0/1:0/1to0/0:,4,True,True
813,833,946,113,6/11to7/11,10/12to9/12,6/11to7/11:7/11to8/11:8/11to9/11:9/11to10/11:10/11to10/12:10/12to9/12:,6,False,True
2584,833,943,110,1/10to1/9,4/5to4/6,1/10to1/9:1/9to1/8:1/8to1/7:1/7to1/6:1/6to1/5:1/5to2/5:2/5to3/5:3/5to4/5:4/5to4/6:,9,True,True
3276,834,1111,277,2/3to3/3,15/10toright10,2/3to3/3:3/3to3/4:3/4to3/5:3/5to3/6:3/6to3/7:3/7to3/8:3/8to3/9:3/9to3/10:3/10to4/10:4/10to5/10:5/10to6/10:6/10to7/10:7/10to8/10:8/10to9/10:9/10to10/10:10/10to11/10:11/10to12/10:12/10to13/10:13/10to14/10:14/10to15/10:15/10toright10:,21,True,True
2867,834,1043,209,11/9to11/8,7/12to7/13,11/9to11/8:11/8to10/8:10/8to9/8:9/8to8/8:8/8to7/8:7/8to7/9:7/9to7/10:7/10to7/11:7/11to7/12:7/12to7/13:,10,True,True
2307,834,1013,179,15/12to14/12,4/13to4/14,15/12to14/12:14/12to13/12:13/12to12/12:12/12to11/12:11/12to10/12:10/12to9/12:9/12to8/12:8/12to7/12:7/12to6/12:6/12to5/12:5/12to4/12:4/12to4/13:4/13to4/14:,13,True,True
2847,834,1065,231,3/12to2/12,8/1to8/0,3/12to2/12:2/12to2/11:2/11to2/10:2/10to2/9:2/9to2/8:2/8to2/7:2/7to2/6:2/6to2/5:2/5to2/4:2/4to2/3:2/3to2/2:2/2to2/1:2/1to3/1:3/1to4/1:4/1to5/1:5/1to6/1:6/1to7/1:7/1to8/1:8/1to8/0:,19,True,True
3300,834,915,81,12/12to12/11,12/6to12/5,12/12to12/11:12/11to12/10:12/10to12/9:12/9to12/8:12/8to12/7:12/7to12/6:12/6to12/5:,7,False,True
1830,834,888,54,8/7to7/7,5/7to4/7,8/7to7/7:7/7to6/7:6/7to5/7:5/7to4/7:,4,False,True
663,834,1026,192,0/1to0/2,7/7to8/7,0/1to0/2:0/2to0/3:0/3to0/4:0/4to0/5:0/5to0/6:0/6to0/7:0/7to1/7:1/7to2/7:2/7to3/7:3/7to4/7:4/7to5/7:5/7to6/7:6/7to7/7:7/7to8/7:,14,True,True
830,835,1074,239,10/3to9/3,0/9toleft9,10/3to9/3:9/3to8/3:8/3to7/3:7/3to6/3:6/3to5/3:5/3to4/3:4/3to3/3:3/3to2/3:2/3to1/3:1/3to0/3:0/3to0/4:0/4to0/5:0/5to0/6:0/6to0/7:0/7to0/8:0/8to0/9:0/9toleft9:,17,True,True
3380,835,1066,231,right2to15/2,0/2to0/1,right2to15/2:15/2to14/2:14/2to13/2:13/2to12/2:12/2to11/2:11/2to10/2:10/2to9/2:9/2to8/2:8/2to7/2:7/2to6/2:6/2to5/2:5/2to4/2:4/2to3/2:3/2to2/2:2/2to1/2:1/2to0/2:0/2to0/1:,17,True,True
2981,835,1077,242,15/1to14/1,3/1to3/2,15/1to14/1:14/1to13/1:13/1to12/1:12/1to11/1:11/1to10/1:10/1to9/1:9/1to8/1:8/1to7/1:7/1to6/1:6/1to5/1:5/1to4/1:4/1to3/1:3/1to3/2:,13,False,True
1304,835,906,71,6/6to6/5,7/2to7/3,6/6to6/5:6/5to6/4:6/4to6/3:6/3to6/2:6/2to7/2:7/2to7/3:,6,False,True
3173,835,881,46,12/0to12/1,11/2to12/2,12/0to12/1:12/1to11/1:11/1to11/2:11/2to12/2:,4,True,True
1050,836,1151,315,13/14to12/14,1/3to2/3,13/14to12/14:12/14to11/14:11/14to10/14:10/14to9/14:9/14to8/14:8/14to7/14:7/14to6/14:6/14to5/14:5/14to4/14:4/14to3/14:3/14to2/14:2/14to1/14:1/14to1/13:1/13to1/12:1/12to1/11:1/11to1/10:1/10to1/9:1/9to1/8:1/8to1/7:1/7to1/6:1/6to1/5:1/5to1/4:1/4to1/3:1/3to2/3:,24,False,True
324,837,1226,389,right0to15/0,0/15totop0,right0to15/0:15/0to14/0:14/0to13/0:13/0to12/0:12/0to11/0:11/0to10/0:10/0to9/0:9/0to8/0:8/0to7/0:7/0to6/0:6/0to5/0:5/0to4/0:4/0to3/0:3/0to2/0:2/0to1/0:1/0to0/0:0/0to0/1:0/1to0/2:0/2to0/3:0/3to0/4:0/4to0/5:0/5to0/6:0/6to0/7:0/7to0/8:0/8to0/9:0/9to0/10:0/10to0/11:0/11to0/12:0/12to0/13:0/13to0/14:0/14to0/15:0/15totop0:,32,False,True
1708,837,1137,300,3/5to3/6,13/15to13/14,3/5to3/6:3/6to4/6:4/6to5/6:5/6to6/6:6/6to7/6:7/6to8/6:8/6to9/6:9/6to10/6:10/6to10/7:10/7to10/8:10/8to10/9:10/9to10/10:10/10to10/11:10/11to10/12:10/12to10/13:10/13to10/14:10/14to10/15:10/15to11/15:11/15to12/15:12/15to13/15:13/15to13/14:,21,False,True
2856,837,861,24,9/3to9/2,9/2to9/1,9/3to9/2:9/2to9/1:,2,False,True
2146,837,1209,372,0/5to0/4,12/8to12/9,0/5to0/4:0/4to0/5:0/5to0/6:0/6to0/7:0/7to1/7:1/7to2/7:2/7to3/7:3/7to4/7:4/7to5/7:5/7to6/7:6/7to7/7:7/7to8/7:8/7to9/7:9/7to10/7:10/7to10/8:10/8to11/8:11/8to12/8:12/8to12/9:,18,True,True
2941,837,927,90,15/11to14/11,13/7to13/6,15/11to14/11:14/11to13/11:13/11to13/10:13/10to13/9:13/9to13/8:13/8to13/7:13/7to13/6:,7,False,True
1642,837,921,84,14/2to14/3,11/2to10/2,14/2to14/3:14/3to13/3:13/3to12/3:12/3to11/3:11/3to11/2:11/2to10/2:,6,False,True
285,838,1225,387,right15to15/15,0/0tobottom0,right15to15/15:15/15to14/15:14/15to13/15:13/15to12/15:12/15to11/15:11/15to10/15:10/15to9/15:9/15to8/15:8/15to7/15:7/15to6/15:6/15to5/15:5/15to4/15:4/15to3/15:3/15to2/15:2/15to1/15:1/15to0/15:0/15to0/14:0/14to0/13:0/13to0/12:0/12to0/11:0/11to0/10:0/10to0/9:0/9to0/8:0/8to0/7:0/7to0/6:0/6to0/5:0/5to0/4:0/4to0/3:0/3to0/2:0/2to0/1:0/1to0/0:0/0tobottom0:,32,False,True
3134,838,1090,252,0/8to1/8,15/4to15/5,0/8to1/8:1/8to2/8:2/8to3/8:3/8to4/8:4/8to5/8:5/8to6/8:6/8to7/8:7/8to8/8:8/8to9/8:9/8to10/8:10/8to10/7:10/7to10/6:10/6to10/5:10/5to10/4:10/4to11/4:11/4to12/4:12/4to13/4:13/4to14/4:14/4to15/4:15/4to15/5:,20,False,True
3027,838,1008,170,7/14to8/14,13/7to14/7,7/14to8/14:8/14to9/14:9/14to10/14:10/14to10/13:10/13to10/12:10/12to10/11:10/11to10/10:10/10to10/9:10/9to10/8:10/8to10/7:10/7to11/7:11/7to12/7:12/7to13/7:13/7to14/7:,14,False,True
2488,839,890,51,4/1to4/0,6/0to7/0,4/1to4/0:4/0to5/0:5/0to6/0:6/0to7/0:,4,True,True
2484,840,1132,292,13/6to12/6,8/15to9/15,13/6to12/6:12/6to11/6:11/6to10/6:10/6to9/6:9/6to8/6:8/6to8/7:8/7to8/8:8/8to8/9:8/9to8/10:8/10to8/11:8/11to8/12:8/12to8/13:8/13to8/14:8/14to8/15:8/15to9/15:,15,False,True
1670,841,938,97,12/9to11/9,10/5to10/4,12/9to11/9:11/9to10/9:10/9to10/8:10/8to10/7:10/7to10/6:10/6to10/5:10/5to10/4:,7,False,True
2249,841,1127,286,14/1to14/2,0/5to0/6,14/1to14/2:14/2to13/2:13/2to12/2:12/2to11/2:11/2to10/2:10/2to9/2:9/2to8/2:8/2to7/2:7/2to6/2:6/2to5/2:5/2to4/2:4/2to3/2:3/2to2/2:2/2to1/2:1/2to0/2:0/2to0/3:0/3to0/4:0/4to0/5:0/5to0/6:,19,True,True
3175,842,1102,260,4/14to4/13,11/1to12/1,4/14to4/13:4/13to5/13:5/13to6/13:6/13to7/13:7/13to8/13:8/13to9/13:9/13to10/13:10/13to10/12:10/12to10/11:10/11to10/10:10/10to10/9:10/9to10/8:10/8to10/7:10/7to10/6:10/6to10/5:10/5to10/4:10/4to10/3:10/3to10/2:10/2to10/1:10/1to11/1:11/1to12/1:,21,False,True
2506,842,938,96,10/5to9/5,8/10to8/11,10/5to9/5:9/5to8/5:8/5to8/6:8/6to8/7:8/7to8/8:8/8to8/9:8/9to8/10:8/10to8/11:,8,False,True
712,842,942,100,6/13to5/13,3/9to3/8,6/13to5/13:5/13to4/13:4/13to3/13:3/13to3/12:3/12to3/11:3/11to3/10:3/10to3/9:3/9to3/8:,8,False,True
2461,842,1123,281,13/11to13/12,3/2to4/2,13/11to13/12:13/12to12/12:12/12to11/12:11/12to10/12:10/12to9/12:9/12to8/12:8/12to7/12:7/12to6/12:6/12to5/12:5/12to4/12:4/12to3/12:3/12to3/11:3/11to3/10:3/10to3/9:3/9to3/8:3/8to3/7:3/7to3/6:3/6to3/5:3/5to3/4:3/4to3/3:3/3to3/2:3/2to4/2:,22,False,True
1861,842,1006,164,15/12to14/12,11/4to10/4,15/12to14/12:14/12to13/12:13/12to12/12:12/12to11/12:11/12to11/11:11/11to11/10:11/10to11/9:11/9to11/8:11/8to11/7:11/7to11/6:11/6to11/5:11/5to11/4:11/4to10/4:,13,True,True
2181,843,1059,216,2/5to3/5,15/1to15/2,2/5to3/5:3/5to3/4:3/4to3/3:3/3to3/2:3/2to4/2:4/2to5/2:5/2to6/2:6/2to7/2:7/2to8/2:8/2to9/2:9/2to10/2:10/2to10/1:10/1to11/1:11/1to12/1:12/1to13/1:13/1to14/1:14/1to15/1:15/1to15/2:,18,True,True
2334,843,1078,235,11/11to11/12,0/11toleft11,11/11to11/12:11/12to10/12:10/12to9/12:9/12to8/12:8/12to7/12:7/12to6/12:6/12to5/12:5/12to4/12:4/12to3/12:3/12to2/12:2/12to1/12:1/12to0/12:0/12to0/11:0/11toleft11:,14,False,True
1159,843,906,63,right2to15/2,13/4to13/5,right2to15/2:15/2to14/2:14/2to13/2:13/2to13/3:13/3to13/4:13/4to13/5:,6,True,True
575,843,996,153,7/7to6/7,1/11to1/12,7/7to6/7:6/7to5/7:5/7to4/7:4/7to3/7:3/7to2/7:2/7to1/7:1/7to1/8:1/8to1/9:1/9to1/10:1/10to1/11:1/11to1/12:,11,False,True
1873,844,872,28,left7to0/7,0/5toleft5,left7to0/7:0/7to0/6:0/6to0/5:0/5toleft5:,4,True,True
956,844,1124,280,14/15to13/15,4/3to4/2,14/15to13/15:13/15to12/15:12/15to11/15:11/15to10/15:10/15to9/15:9/15to8/15:8/15to7/15:7/15to6/15:6/15to5/15:5/15to4/15:4/15to4/14:4/14to4/13:4/13to4/12:4/12to4/11:4/11to4/10:4/10to4/9:4/9to4/8:4/8to4/7:4/7to4/6:4/6to4/5:4/5to4/4:4/4to4/3:4/3to4/2:,23,False,True
875,844,1148,304,0/1to1/1,12/7to13/7,0/1to1/1:1/1to2/1:2/1to3/1:3/1to4/1:4/1to5/1:5/1to6/1:6/1to7/1:7/1to8/1:8/1to9/1:9/1to10/1:10/1to10/2:10/2to10/3:10/3to10/4:10/4to10/5:10/5to10/6:10/6to10/7:10/7to11/7:11/7to12/7:12/7to13/7:,19,False,True
2874,844,1024,180,2/8to2/7,14/8to15/8,2/8to2/7:2/7to2/8:2/8to3/8:3/8to4/8:4/8to5/8:5/8to6/8:6/8to7/8:7/8to8/8:8/8to9/8:9/8to10/8:10/8to11/8:11/8to12/8:12/8to13/8:13/8to14/8:14/8to15/8:,15,True,True
1800,845,988,143,12/7to11/7,15/1toright1,12/7to11/7:11/7to11/6:11/6to11/5:11/5to12/5:12/5to12/4:12/4to12/3:12/3to12/2:12/2to12/1:12/1to13/1:13/1to14/1:14/1to15/1:15/1toright1:,12,True,True
2870,845,988,143,7/7to6/7,2/12to3/12,7/7to6/7:6/7to5/7:5/7to4/7:4/7to3/7:3/7to2/7:2/7to2/8:2/8to2/9:2/9to2/10:2/10to2/11:2/11to2/12:2/12to3/12:,11,False,True
1968,846,1045,199,3/1to3/2,13/6to14/6,3/1to3/2:3/2to4/2:4/2to5/2:5/2to6/2:6/2to7/2:7/2to8/2:8/2to9/2:9/2to10/2:10/2to10/3:10/3to10/4:10/4to10/5:10/5to10/6:10/6to11/6:11/6to12/6:12/6to13/6:13/6to14/6:,16,False,True
270,846,1223,377,right15to15/15,0/0tobottom0,right15to15/15:15/15to14/15:14/15to13/15:13/15to12/15:12/15to11/15:11/15to10/15:10/15to9/15:9/15to8/15:8/15to7/15:7/15to6/15:6/15to5/15:5/15to4/15:4/15to3/15:3/15to2/15:2/15to1/15:1/15to0/15:0/15to0/14:0/14to0/13:0/13to0/12:0/12to0/11:0/11to0/10:0/10to0/9:0/9to0/8:0/8to0/7:0/7to0/6:0/6to0/5:0/5to0/4:0/4to0/3:0/3to0/2:0/2to0/1:0/1to0/0:0/0tobottom0:,32,False,True
1506,847,1000,153,12/9to12/8,10/3to9/3,12/9to12/8:12/8to11/8:11/8to10/8:10/8to10/7:10/7to10/6:10/6to10/5:10/5to10/4:10/4to10/3:10/3to9/3:,9,False,True
238,848,1230,382,right15to15/15,0/0tobottom0,right15to15/15:15/15to14/15:14/15to13/15:13/15to12/15:12/15to11/15:11/15to10/15:10/15to9/15:9/15to8/15:8/15to7/15:7/15to6/15:6/15to5/15:5/15to4/15:4/15to3/15:3/15to2/15:2/15to1/15:1/15to0/15:0/15to0/14:0/14to0/13:0/13to0/12:0/12to0/11:0/11to0/10:0/10to0/9:0/9to0/8:0/8to0/7:0/7to0/6:0/6to0/5:0/5to0/4:0/4to0/3:0/3to0/2:0/2to0/1:0/1to0/0:0/0tobottom0:,32,True,True
1740,848,1051,203,0/13to0/12,7/5to7/6,0/13to0/12:0/12to0/11:0/11to0/10:0/10to0/9:0/9to0/8:0/8to0/7:0/7to0/6:0/6to0/5:0/5to1/5:1/5to2/5:2/5to3/5:3/5to4/5:4/5to5/5:5/5to6/5:6/5to7/5:7/5to7/6:,16,False,True
1108,848,1026,178,10/5to11/5,15/14to15/13,10/5to11/5:11/5to11/6:11/6to12/6:12/6to12/7:12/7to12/8:12/8to12/9:12/9to12/10:12/10to12/11:12/11to12/12:12/12to12/13:12/13to12/14:12/14to13/14:13/14to14/14:14/14to15/14:15/14to15/13:,15,True,True
2392,850,1002,152,4/10to3/10,4/1to5/1,4/10to3/10:3/10to3/9:3/9to3/8:3/8to3/7:3/7to3/6:3/6to3/5:3/5to3/4:3/4to3/3:3/3to3/2:3/2to3/1:3/1to4/1:4/1to5/1:,12,True,True
1205,850,1037,187,left5to0/5,7/11to7/10,left5to0/5:0/5to0/6:0/6to0/7:0/7to0/8:0/8to0/9:0/9to0/10:0/10to0/11:0/11to1/11:1/11to2/11:2/11to3/11:3/11to4/11:4/11to5/11:5/11to6/11:6/11to7/11:7/11to7/10:,15,True,True
2473,850,1022,172,1/0to1/1,5/9to6/9,1/0to1/1:1/1to1/2:1/2to1/3:1/3to1/4:1/4to1/5:1/5to1/6:1/6to1/7:1/7to1/8:1/8to1/9:1/9to2/9:2/9to3/9:3/9to4/9:4/9to5/9:5/9to6/9:,14,True,True
898,850,1160,310,13/2to13/3,0/12toleft12,13/2to13/3:13/3to12/3:12/3to11/3:11/3to10/3:10/3to9/3:9/3to8/3:8/3to7/3:7/3to6/3:6/3to5/3:5/3to4/3:4/3to3/3:3/3to2/3:2/3to1/3:1/3to0/3:0/3to0/4:0/4to0/5:0/5to0/6:0/6to0/7:0/7to0/8:0/8to0/9:0/9to0/10:0/10to0/11:0/11to0/12:0/12toleft12:,24,True,True
201,850,1233,383,right15to15/15,0/0tobottom0,right15to15/15:15/15to14/15:14/15to13/15:13/15to12/15:12/15to11/15:11/15to10/15:10/15to9/15:9/15to8/15:8/15to7/15:7/15to6/15:6/15to5/15:5/15to4/15:4/15to3/15:3/15to2/15:2/15to1/15:1/15to0/15:0/15to0/14:0/14to0/13:0/13to0/12:0/12to0/11:0/11to0/10:0/10to0/9:0/9to0/8:0/8to0/7:0/7to0/6:0/6to0/5:0/5to0/4:0/4to0/3:0/3to0/2:0/2to0/1:0/1to0/0:0/0tobottom0:,32,False,True
2005,851,1101,250,left3to0/3,10/10to11/10,left3to0/3:0/3to0/4:0/4to0/5:0/5to0/6:0/6to0/7:0/7to0/8:0/8to0/9:0/9to0/10:0/10to1/10:1/10to2/10:2/10to3/10:3/10to4/10:4/10to5/10:5/10to6/10:6/10to7/10:7/10to8/10:8/10to9/10:9/10to10/10:10/10to11/10:,19,True,True
3227,851,1008,157,6/10to7/10,15/10to15/9,6/10to7/10:7/10to8/10:8/10to9/10:9/10to10/10:10/10to11/10:11/10to12/10:12/10to13/10:13/10to14/10:14/10to15/10:15/10to15/9:,10,True,True
2650,851,1033,182,bottom15to15/0,5/2to5/3,bottom15to15/0:15/0to14/0:14/0to13/0:13/0to12/0:12/0to11/0:11/0to10/0:10/0to9/0:9/0to8/0:8/0to7/0:7/0to6/0:6/0to5/0:5/0to5/1:5/1to5/2:5/2to5/3:,14,False,True
2193,851,939,88,9/3to9/4,5/3to5/2,9/3to9/4:9/4to8/4:8/4to7/4:7/4to6/4:6/4to5/4:5/4to5/3:5/3to5/2:,7,False,True
2527,852,1151,299,3/14to4/14,12/0to12/1,3/14to4/14:4/14to5/14:5/14to6/14:6/14to7/14:7/14to8/14:8/14to9/14:9/14to10/14:10/14to10/13:10/13to10/12:10/12to10/11:10/11to10/10:10/10to10/9:10/9to10/8:10/8to10/7:10/7to10/6:10/6to10/5:10/5to10/4:10/4to10/3:10/3to10/2:10/2to10/1:10/1to10/0:10/0to11/0:11/0to12/0:12/0to12/1:,24,False,True
5,853,1226,373,left15to0/15,15/0tobottom15,left15to0/15:0/15to1/15:1/15to2/15:2/15to3/15:3/15to4/15:4/15to5/15:5/15to6/15:6/15to7/15:7/15to8/15:8/15to9/15:9/15to10/15:10/15to10/14:10/14to10/13:10/13to10/12:10/12to10/11:10/11to10/10:10/10to10/9:10/9to10/8:10/8to10/7:10/7to10/6:10/6to10/5:10/5to10/4:10/4to10/3:10/3to10/2:10/2to10/1:10/1to10/0:10/0to11/0:11/0to12/0:12/0to13/0:13/0to14/0:14/0to15/0:15/0tobottom15:,32,False,True
537,853,976,123,9/7to9/6,3/7to3/8,9/7to9/6:9/6to8/6:8/6to7/6:7/6to6/6:6/6to5/6:5/6to4/6:4/6to3/6:3/6to3/7:3/7to3/8:,9,True,True
2208,853,1050,197,14/12to13/12,10/4to10/3,14/12to13/12:13/12to12/12:12/12to11/12:11/12to11/11:11/11to11/10:11/10to11/9:11/9to11/8:11/8to11/7:11/7to11/6:11/6to11/5:11/5to10/5:10/5to10/4:10/4to10/3:,13,True,True
3062,853,1109,256,15/9to15/10,6/1to7/1,15/9to15/10:15/10to14/10:14/10to13/10:13/10to12/10:12/10to12/9:12/9to11/9:11/9to10/9:10/9to9/9:9/9to8/9:8/9to7/9:7/9to6/9:6/9to6/8:6/8to6/7:6/7to6/6:6/6to6/5:6/5to6/4:6/4to6/3:6/3to6/2:6/2to6/1:6/1to7/1:,20,True,True
194,853,1226,373,left0to0/0,15/15totop15,left0to0/0:0/0to0/1:0/1to0/2:0/2to0/3:0/3to0/4:0/4to0/5:0/5to0/6:0/6to0/7:0/7to0/8:0/8to0/9:0/9to0/10:0/10to0/11:0/11to0/12:0/12to0/13:0/13to0/14:0/14to1/14:1/14to2/14:2/14to3/14:3/14to4/14:4/14to5/14:5/14to6/14:6/14to7/14:7/14to8/14:8/14to9/14:9/14to10/14:10/14to10/15:10/15to11/15:11/15to12/15:12/15to13/15:13/15to14/15:14/15to15/15:15/15totop15:,32,True,True
1146,853,894,41,10/5to9/5,8/5to8/6,10/5to9/5:9/5to8/5:8/5to8/6:,3,True,True
2996,854,1005,151,7/8to7/9,13/5to14/5,7/8to7/9:7/9to8/9:8/9to9/9:9/9to10/9:10/9to10/8:10/8to10/7:10/7to10/6:10/6to10/5:10/5to11/5:11/5to12/5:12/5to13/5:13/5to14/5:,12,False,True
3317,854,1080,226,13/1to13/2,4/9to4/10,13/1to13/2:13/2to12/2:12/2to11/2:11/2to10/2:10/2to9/2:9/2to8/2:8/2to7/2:7/2to6/2:6/2to5/2:5/2to4/2:4/2to4/3:4/3to4/4:4/4to4/5:4/5to4/6:4/6to4/7:4/7to4/8:4/8to4/9:4/9to4/10:,18,True,True
2595,854,1184,330,0/6to0/7,15/11to15/10,0/6to0/7:0/7to0/8:0/8to0/9:0/9to0/10:0/10to1/10:1/10to2/10:2/10to3/10:3/10to4/10:4/10to5/10:5/10to6/10:6/10to7/10:7/10to8/10:8/10to9/10:9/10to10/10:10/10to10/11:10/11to11/11:11/11to12/11:12/11to13/11:13/11to14/11:14/11to15/11:15/11to15/10:,21,True,True
1481,854,1040,186,2/9to2/8,11/5to12/5,2/9to2/8:2/8to3/8:3/8to4/8:4/8to5/8:5/8to6/8:6/8to7/8:7/8to8/8:8/8to9/8:9/8to10/8:10/8to10/7:10/7to10/6:10/6to10/5:10/5to11/5:11/5to12/5:,14,False,True
873,854,970,116,14/12to14/13,7/13to7/12,14/12to14/13:14/13to13/13:13/13to12/13:12/13to11/13:11/13to10/13:10/13to9/13:9/13to8/13:8/13to7/13:7/13to7/12:,9,True,True
3249,854,1112,258,10/2to9/2,2/14to2/15,10/2to9/2:9/2to8/2:8/2to7/2:7/2to6/2:6/2to5/2:5/2to4/2:4/2to3/2:3/2to2/2:2/2to2/3:2/3to2/4:2/4to2/5:2/5to2/6:2/6to2/7:2/7to2/8:2/8to2/9:2/9to2/10:2/10to2/11:2/11to2/12:2/12to2/13:2/13to2/14:2/14to2/15:,21,True,True
945,854,985,131,0/13to0/12,4/8to5/8,0/13to0/12:0/12to0/11:0/11to0/10:0/10to0/9:0/9to0/8:0/8to1/8:1/8to2/8:2/8to3/8:3/8to4/8:4/8to5/8:,10,True,True
2378,855,975,120,9/14to9/15,6/10to7/10,9/14to9/15:9/15to8/15:8/15to7/15:7/15to6/15:6/15to6/14:6/14to6/13:6/13to6/12:6/12to6/11:6/11to6/10:6/10to7/10:,10,False,True
2886,856,1107,251,0/7to1/7,12/1to13/1,0/7to1/7:1/7to2/7:2/7to3/7:3/7to4/7:4/7to5/7:5/7to6/7:6/7to7/7:7/7to8/7:8/7to9/7:9/7to10/7:10/7to10/6:10/6to10/5:10/5to10/4:10/4to10/3:10/3to10/2:10/2to10/1:10/1to11/1:11/1to12/1:12/1to13/1:,19,False,True
492,856,904,48,4/2to4/1,2/1to2/2,4/2to4/1:4/1to3/1:3/1to2/1:2/1to2/2:,4,False,True
677,856,1076,220,14/2to13/2,6/8to6/9,14/2to13/2:13/2to12/2:12/2to11/2:11/2to10/2:10/2to9/2:9/2to8/2:8/2to7/2:7/2to6/2:6/2to6/3:6/3to6/4:6/4to6/5:6/5to6/6:6/6to6/7:6/7to6/8:6/8to6/9:,15,True,True
1526,857,997,140,1/15to1/14,2/5to2/4,1/15to1/14:1/14to1/13:1/13to1/12:1/12to1/11:1/11to1/10:1/10to1/9:1/9to1/8:1/8to1/7:1/7to1/6:1/6to1/5:1/5to2/5:2/5to2/4:,12,False,True
1983,857,914,57,5/9to6/9,6/6to5/6,5/9to6/9:6/9to6/8:6/8to6/7:6/7to6/6:6/6to5/6:,5,True,True
2940,857,883,26,3/10to4/10,4/10to4/11,3/10to4/10:4/10to4/11:,2,True,True
1567,857,1100,243,left10to0/10,10/4to11/4,left10to0/10:0/10to1/10:1/10to2/10:2/10to3/10:3/10to4/10:4/10to5/10:5/10to6/10:6/10to7/10:7/10to8/10:8/10to9/10:9/10to10/10:10/10to10/9:10/9to10/8:10/8to10/7:10/7to10/6:10/6to10/5:10/5to10/4:10/4to11/4:,18,False,True
1766,858,1089,231,left0to0/0,5/11to5/12,left0to0/0:0/0to0/1:0/1to0/2:0/2to0/3:0/3to0/4:0/4to0/5:0/5to0/6:0/6to0/7:0/7to0/8:0/8to0/9:0/9to0/10:0/10to0/11:0/11to1/11:1/11to2/11:2/11to3/11:3/11to4/11:4/11to5/11:5/11to5/12:,18,True,True
2067,858,1097,239,0/8to1/8,14/8to14/7,0/8to1/8:1/8to2/8:2/8to3/8:3/8to4/8:4/8to5/8:5/8to6/8:6/8to7/8:7/8to8/8:8/8to9/8:9/8to10/8:10/8to11/8:11/8to12/8:12/8to13/8:13/8to14/8:14/8to14/7:,15,False,True
3124,859,1154,295,13/9to13/8,8/12to8/13,13/9to13/8:13/8to12/8:12/8to11/8:11/8to10/8:10/8to9/8:9/8to8/8:8/8to8/9:8/9to8/10:8/10to8/11:8/11to8/12:8/12to8/13:,11,True,True
1067,859,1078,219,0/8to0/9,10/5to11/5,0/8to0/9:0/9to1/9:1/9to2/9:2/9to3/9:3/9to4/9:4/9to5/9:5/9to6/9:6/9to7/9:7/9to8/9:8/9to9/9:9/9to10/9:10/9to10/8:10/8to10/7:10/7to10/6:10/6to10/5:10/5to11/5:,16,False,True
1727,859,917,58,5/12to5/13,3/13to3/12,5/12to5/13:5/13to4/13:4/13to3/13:3/13to3/12:,4,True,True
103,859,1261,402,left0to0/0,15/15totop15,left0to0/0:0/0to0/1:0/1to0/2:0/2to0/3:0/3to0/4:0/4to0/5:0/5to0/6:0/6to0/7:0/7to0/8:0/8to0/9:0/9to0/10:0/10to0/11:0/11to0/12:0/12to0/13:0/13to0/14:0/14to1/14:1/14to2/14:2/14to3/14:3/14to4/14:4/14to5/14:5/14to6/14:6/14to7/14:7/14to8/14:8/14to9/14:9/14to10/14:10/14to10/15:10/15to11/15:11/15to12/15:12/15to13/15:13/15to14/15:14/15to15/15:15/15totop15:,32,True,True
1113,859,1008,149,0/13to1/13,7/10to7/9,0/13to1/13:1/13to1/12:1/12to1/11:1/11to1/10:1/10to2/10:2/10to3/10:3/10to4/10:4/10to5/10:5/10to6/10:6/10to7/10:7/10to7/9:,11,True,True
3374,860,998,138,12/10to11/10,11/0to10/0,12/10to11/10:11/10to11/9:11/9to11/8:11/8to11/7:11/7to11/6:11/6to11/5:11/5to11/4:11/4to11/3:11/3to11/2:11/2to11/1:11/1to11/0:11/0to10/0:,12,False,True
701,860,1073,213,6/1to6/0,13/4to13/5,6/1to6/0:6/0to6/1:6/1to6/2:6/2to6/3:6/3to6/4:6/4to7/4:7/4to8/4:8/4to9/4:9/4to10/4:10/4to11/4:11/4to12/4:12/4to13/4:13/4to13/5:,13,True,True
1614,860,1102,242,12/12to12/13,7/7to6/7,12/12to12/13:12/13to12/12:12/12to11/12:11/12to10/12:10/12to9/12:9/12to8/12:8/12to7/12:7/12to7/11:7/11to7/10:7/10to7/9:7/9to7/8:7/8to7/7:7/7to6/7:,13,True,True
2638,860,1162,302,0/1to0/0,10/12to10/13,0/1to0/0:0/0to0/1:0/1to0/2:0/2to0/3:0/3to0/4:0/4to0/5:0/5to0/6:0/6to0/7:0/7to0/8:0/8to0/9:0/9to0/10:0/10to1/10:1/10to2/10:2/10to3/10:3/10to4/10:4/10to5/10:5/10to6/10:6/10to7/10:7/10to8/10:8/10to9/10:9/10to10/10:10/10to10/11:10/11to10/12:10/12to10/13:,24,True,True
2273,861,1260,399,15/11to15/10,0/7to0/6,15/11to15/10:15/10to14/10:14/10to13/10:13/10to12/10:12/10to11/10:11/10to10/10:10/10to9/10:9/10to8/10:8/10to7/10:7/10to6/10:6/10to5/10:5/10to4/10:4/10to3/10:3/10to2/10:2/10to1/10:1/10to0/10:0/10to0/9:0/9to0/8:0/8to0/7:0/7to0/6:,20,False,True
711,861,1024,163,8/10to9/10,11/0tobottom11,8/10to9/10:9/10to10/10:10/10to10/9:10/9to10/8:10/8to10/7:10/7to10/6:10/6to10/5:10/5to10/4:10/4to10/3:10/3to10/2:10/2to10/1:10/1to10/0:10/0to11/0:11/0tobottom11:,14,False,True
37,862,0,-862,left15to0/15,15/0tobottom15,left15to0/15:0/15to0/14:0/14to0/13:0/13to0/12:0/12to0/11:0/11to0/10:0/10to0/9:0/9to0/8:0/8to0/7:0/7to0/6:0/6to0/5:0/5to0/4:0/4to0/3:0/3to0/2:0/2to0/1:0/1to0/0:,16,True,False
2237,862,1139,277,bottom15to15/0,6/13to7/13,bottom15to15/0:15/0to14/0:14/0to13/0:13/0to12/0:12/0to11/0:11/0to10/0:10/0to9/0:9/0to8/0:8/0to7/0:7/0to6/0:6/0to6/1:6/1to6/2:6/2to6/3:6/3to6/4:6/4to6/5:6/5to6/6:6/6to6/7:6/7to6/8:6/8to6/9:6/9to6/10:6/10to6/11:6/11to6/12:6/12to6/13:6/13to7/13:,24,False,True
1870,863,967,104,6/14to7/14,13/14to13/15,6/14to7/14:7/14to8/14:8/14to9/14:9/14to10/14:10/14to11/14:11/14to12/14:12/14to13/14:13/14to13/15:,8,True,True
1525,863,1071,208,8/8to8/9,3/0to4/0,8/8to8/9:8/9to7/9:7/9to6/9:6/9to5/9:5/9to4/9:4/9to3/9:3/9to3/8:3/8to3/7:3/7to3/6:3/6to3/5:3/5to3/4:3/4to3/3:3/3to3/2:3/2to3/1:3/1to3/0:3/0to4/0:,16,False,True
2277,863,901,38,11/5to11/4,12/4to13/4,11/5to11/4:11/4to12/4:12/4to13/4:,3,False,True
3048,863,1007,144,11/11to10/11,14/8to14/7,11/11to10/11:10/11to10/10:10/10to10/9:10/9to10/8:10/8to11/8:11/8to12/8:12/8to13/8:13/8to14/8:14/8to14/7:,9,False,True
2465,863,913,50,14/4to15/4,15/7toright7,14/4to15/4:15/4to15/5:15/5to15/6:15/6to15/7:15/7toright7:,5,True,True
2197,863,1095,232,14/11to13/11,7/14to6/14,14/11to13/11:13/11to12/11:12/11to11/11:11/11to10/11:10/11to9/11:9/11to8/11:8/11to7/11:7/11to7/12:7/12to7/13:7/13to7/14:7/14to6/14:,11,True,True
630,863,921,58,6/11to6/10,6/7to6/6,6/11to6/10:6/10to6/9:6/9to6/8:6/8to6/7:6/7to6/6:,5,False,True
3041,864,1044,180,7/9to6/9,0/2toleft2,7/9to6/9:6/9to5/9:5/9to4/9:4/9to3/9:3/9to2/9:2/9to1/9:1/9to0/9:0/9to0/8:0/8to0/7:0/7to0/6:0/6to0/5:0/5to0/4:0/4to0/3:0/3to0/2:0/2toleft2:,15,True,True
3044,865,1256,391,0/4to1/4,14/6to15/6,0/4to1/4:1/4to1/5:1/5to2/5:2/5to3/5:3/5to4/5:4/5to5/5:5/5to6/5:6/5to7/5:7/5to8/5:8/5to9/5:9/5to10/5:10/5to10/6:10/6to11/6:11/6to12/6:12/6to13/6:13/6to14/6:14/6to15/6:,17,True,True
304,865,1319,454,right0to15/0,0/15totop0,right0to15/0:15/0to14/0:14/0to13/0:13/0to12/0:12/0to11/0:11/0to11/1:11/1to10/1:10/1to9/1:9/1to8/1:8/1to7/1:7/1to6/1:6/1to5/1:5/1to4/1:4/1to3/1:3/1to2/1:2/1to1/1:1/1to0/1:0/1to0/2:0/2to0/3:0/3to0/4:0/4to0/5:0/5to0/6:0/6to0/7:0/7to0/8:0/8to0/9:0/9to0/10:0/10to0/11:0/11to0/12:0/12to0/13:0/13to0/14:0/14to0/15:0/15totop0:,32,True,True
2993,865,1019,154,4/2to5/2,13/4to14/4,4/2to5/2:5/2to6/2:6/2to7/2:7/2to8/2:8/2to9/2:9/2to10/2:10/2to10/3:10/3to10/4:10/4to11/4:11/4to12/4:12/4to13/4:13/4to14/4:,12,False,True
2236,865,1060,195,6/10to5/10,1/2to1/1,6/10to5/10:5/10to4/10:4/10to3/10:3/10to2/10:2/10to1/10:1/10to1/9:1/9to1/8:1/8to1/7:1/7to1/6:1/6to1/5:1/5to1/4:1/4to1/3:1/3to1/2:1/2to1/1:,14,True,True
3350,865,1003,138,5/8to5/9,1/15totop1,5/8to5/9:5/9to4/9:4/9to3/9:3/9to2/9:2/9to1/9:1/9to1/10:1/10to1/11:1/11to1/12:1/12to1/13:1/13to1/14:1/14to1/15:1/15totop1:,12,True,True
228,866,1239,373,right15to15/15,0/0tobottom0,right15to15/15:15/15to14/15:14/15to13/15:13/15to12/15:12/15to11/15:11/15to10/15:10/15to9/15:9/15to8/15:8/15to7/15:7/15to6/15:6/15to5/15:5/15to4/15:4/15to3/15:3/15to2/15:2/15to1/15:1/15to0/15:0/15to0/14:0/14to0/13:0/13to0/12:0/12to0/11:0/11to0/10:0/10to0/9:0/9to0/8:0/8to0/7:0/7to0/6:0/6to0/5:0/5to0/4:0/4to0/3:0/3to0/2:0/2to0/1:0/1to0/0:0/0tobottom0:,32,True,True
208,866,1241,375,right15to15/15,0/0tobottom0,right15to15/15:15/15to14/15:14/15to13/15:13/15to12/15:12/15to11/15:11/15to11/14:11/14to10/14:10/14to9/14:9/14to8/14:8/14to7/14:7/14to6/14:6/14to5/14:5/14to4/14:4/14to3/14:3/14to2/14:2/14to1/14:1/14to0/14:0/14to0/13:0/13to0/12:0/12to0/11:0/11to0/10:0/10to0/9:0/9to0/8:0/8to0/7:0/7to0/6:0/6to0/5:0/5to0/4:0/4to0/3:0/3to0/2:0/2to0/1:0/1to0/0:0/0tobottom0:,32,True,True
2333,866,987,121,2/15to3/15,6/10to6/9,2/15to3/15:3/15to3/14:3/14to3/13:3/13to3/12:3/12to3/11:3/11to3/10:3/10to4/10:4/10to5/10:5/10to6/10:6/10to6/9:,10,True,True
2622,866,1061,195,5/3to4/3,1/15totop1,5/3to4/3:4/3to3/3:3/3to2/3:2/3to1/3:1/3to1/4:1/4to1/5:1/5to1/6:1/6to1/7:1/7to1/8:1/8to1/9:1/9to1/10:1/10to1/11:1/11to1/12:1/12to1/13:1/13to1/14:1/14to1/15:1/15totop1:,17,False,True
2896,866,968,102,12/1to11/1,13/5to13/6,12/1to11/1:11/1to11/2:11/2to11/3:11/3to11/4:11/4to11/5:11/5to12/5:12/5to13/5:13/5to13/6:,8,True,True
2774,866,979,113,14/4to14/5,14/13to15/13,14/4to14/5:14/5to14/6:14/6to14/7:14/7to14/8:14/8to14/9:14/9to14/10:14/10to14/11:14/11to14/12:14/12to14/13:14/13to15/13:,10,True,True
3060,867,1066,199,11/9to10/9,2/10to1/10,11/9to10/9:10/9to9/9:9/9to8/9:8/9to7/9:7/9to6/9:6/9to5/9:5/9to4/9:4/9to3/9:3/9to2/9:2/9to2/10:2/10to1/10:,11,False,True
2342,867,987,120,2/10to3/10,6/15totop6,2/10to3/10:3/10to3/11:3/11to3/12:3/12to3/13:3/13to3/14:3/14to3/15:3/15to4/15:4/15to5/15:5/15to6/15:6/15totop6:,10,False,True
3034,868,0,-868,1/13to0/13,1/0tobottom1,1/13to0/13:0/13to0/12:0/12to0/11:0/11to0/10:0/10to0/9:0/9to0/8:0/8to0/7:0/7to0/6:0/6to0/5:0/5to0/4:0/4to0/3:0/3to0/2:0/2to0/1:0/1to0/0:,14,False,False
1436,868,1125,257,right15to15/15,1/11to0/11,right15to15/15:15/15to14/15:14/15to13/15:13/15to12/15:12/15to11/15:11/15to10/15:10/15to9/15:9/15to8/15:8/15to7/15:7/15to6/15:6/15to5/15:5/15to4/15:4/15to3/15:3/15to2/15:2/15to1/15:1/15to1/14:1/14to1/13:1/13to1/12:1/12to1/11:1/11to0/11:,20,False,True
2582,868,942,74,10/9to9/9,6/9to6/8,10/9to9/9:9/9to8/9:8/9to7/9:7/9to6/9:6/9to6/8:,5,True,True
2965,868,1061,193,bottom8to8/0,7/14to8/14,bottom8to8/0:8/0to7/0:7/0to7/1:7/1to7/2:7/2to7/3:7/3to7/4:7/4to7/5:7/5to7/6:7/6to7/7:7/7to7/8:7/8to7/9:7/9to7/10:7/10to7/11:7/11to7/12:7/12to7/13:7/13to7/14:7/14to8/14:,17,True,True
2675,869,1070,201,2/15to2/14,8/6to9/6,2/15to2/14:2/14to2/13:2/13to2/12:2/12to2/11:2/11to2/10:2/10to2/9:2/9to2/8:2/8to2/7:2/7to2/6:2/6to3/6:3/6to4/6:4/6to5/6:5/6to6/6:6/6to7/6:7/6to8/6:8/6to9/6:,16,False,True
260,869,1258,389,right15to15/15,0/0tobottom0,right15to15/15:15/15to14/15:14/15to13/15:13/15to12/15:12/15to11/15:11/15to10/15:10/15to9/15:9/15to8/15:8/15to7/15:7/15to6/15:6/15to5/15:5/15to4/15:4/15to3/15:3/15to2/15:2/15to1/15:1/15to0/15:0/15to0/14:0/14to0/13:0/13to0/12:0/12to0/11:0/11to0/10:0/10to0/9:0/9to0/8:0/8to0/7:0/7to0/6:0/6to0/5:0/5to0/4:0/4to0/3:0/3to0/2:0/2to0/1:0/1to0/0:0/0tobottom0:,32,False,True
17,869,1244,375,left15to0/15,15/0tobottom15,left15to0/15:0/15to1/15:1/15to2/15:2/15to3/15:3/15to4/15:4/15to5/15:5/15to6/15:6/15to7/15:7/15to8/15:8/15to9/15:9/15to10/15:10/15to10/14:10/14to10/13:10/13to10/12:10/12to10/11:10/11to10/10:10/10to10/9:10/9to10/8:10/8to10/7:10/7to10/6:10/6to10/5:10/5to10/4:10/4to10/3:10/3to10/2:10/2to10/1:10/1to10/0:10/0to11/0:11/0to12/0:12/0to13/0:13/0to14/0:14/0to15/0:15/0tobottom15:,32,False,True
281,869,1272,403,right15to15/15,0/0tobottom0,right15to15/15:15/15to14/15:14/15to13/15:13/15to12/15:12/15to11/15:11/15to10/15:10/15to9/15:9/15to8/15:8/15to7/15:7/15to6/15:6/15to5/15:5/15to4/15:4/15to3/15:3/15to2/15:2/15to1/15:1/15to0/15:0/15to0/14:0/14to0/13:0/13to0/12:0/12to0/11:0/11to0/10:0/10to0/9:0/9to0/8:0/8to0/7:0/7to0/6:0/6to0/5:0/5to0/4:0/4to0/3:0/3to0/2:0/2to0/1:0/1to0/0:0/0tobottom0:,32,False,True
400,869,1047,178,6/6to6/5,2/15totop2,6/6to6/5:6/5to5/5:5/5to4/5:4/5to3/5:3/5to2/5:2/5to2/6:2/6to2/7:2/7to2/8:2/8to2/9:2/9to2/10:2/10to2/11:2/11to2/12:2/12to2/13:2/13to2/14:2/14to2/15:2/15totop2:,16,True,True
2219,869,1167,298,0/11to1/11,14/3to14/2,0/11to1/11:1/11to2/11:2/11to3/11:3/11to4/11:4/11to5/11:5/11to6/11:6/11to7/11:7/11to8/11:8/11to9/11:9/11to10/11:10/11to10/10:10/10to10/9:10/9to10/8:10/8to10/7:10/7to10/6:10/6to10/5:10/5to10/4:10/4to10/3:10/3to11/3:11/3to12/3:12/3to13/3:13/3to14/3:14/3to14/2:,23,False,True
987,870,997,127,13/8to13/9,10/13to10/14,13/8to13/9:13/9to12/9:12/9to12/10:12/10to12/11:12/11to11/11:11/11to10/11:10/11to10/12:10/12to10/13:10/13to10/14:,9,True,True
395,870,1248,378,right0to15/0,0/15totop0,right0to15/0:15/0to14/0:14/0to13/0:13/0to12/0:12/0to11/0:11/0to10/0:10/0to9/0:9/0to8/0:8/0to7/0:7/0to6/0:6/0to5/0:5/0to4/0:4/0to3/0:3/0to2/0:2/0to1/0:1/0to0/0:0/0to0/1:0/1to0/2:0/2to0/3:0/3to0/4:0/4to0/5:0/5to0/6:0/6to0/7:0/7to0/8:0/8to0/9:0/9to0/10:0/10to0/11:0/11to0/12:0/12to0/13:0/13to0/14:0/14to0/15:0/15totop0:,32,True,True
3355,871,1046,175,10/13to9/13,7/3to8/3,10/13to9/13:9/13to8/13:8/13to7/13:7/13to7/12:7/12to7/11:7/11to7/10:7/10to7/9:7/9to7/8:7/8to7/7:7/7to7/6:7/6to7/5:7/5to7/4:7/4to7/3:7/3to8/3:,14,False,True
2203,872,912,40,0/4to1/4,1/5to1/6,0/4to1/4:1/4to1/5:1/5to1/6:,3,False,True
1633,872,958,86,12/7to12/8,15/10to15/11,12/7to12/8:12/8to12/9:12/9to12/10:12/10to13/10:13/10to14/10:14/10to15/10:15/10to15/11:,7,False,True
1544,872,936,64,0/11to1/11,2/9to3/9,0/11to1/11:1/11to1/10:1/10to1/9:1/9to2/9:2/9to3/9:,5,True,True
137,873,1284,411,left0to0/0,15/15totop15,left0to0/0:0/0to1/0:1/0to2/0:2/0to3/0:3/0to4/0:4/0to5/0:5/0to6/0:6/0to7/0:7/0to8/0:8/0to9/0:9/0to10/0:10/0to10/1:10/1to10/2:10/2to10/3:10/3to10/4:10/4to10/5:10/5to10/6:10/6to10/7:10/7to10/8:10/8to10/9:10/9to10/10:10/10to10/11:10/11to10/12:10/12to10/13:10/13to10/14:10/14to10/15:10/15to11/15:11/15to12/15:12/15to13/15:13/15to14/15:14/15to15/15:15/15totop15:,32,False,True
1612,873,997,124,4/8to3/8,3/0to4/0,4/8to3/8:3/8to3/7:3/7to3/6:3/6to3/5:3/5to3/4:3/4to3/3:3/3to3/2:3/2to3/1:3/1to3/0:3/0to4/0:,10,False,True
1814,873,996,123,top5to5/15,0/11toleft11,top5to5/15:5/15to4/15:4/15to3/15:3/15to2/15:2/15to1/15:1/15to0/15:0/15to0/14:0/14to0/13:0/13to0/12:0/12to0/11:0/11toleft11:,11,False,True
176,873,1274,401,left0to0/0,15/15totop15,left0to0/0:0/0to0/1:0/1to0/2:0/2to0/3:0/3to0/4:0/4to0/5:0/5to0/6:0/6to0/7:0/7to0/8:0/8to0/9:0/9to0/10:0/10to0/11:0/11to0/12:0/12to0/13:0/13to1/13:1/13to2/13:2/13to3/13:3/13to4/13:4/13to5/13:5/13to6/13:6/13to7/13:7/13to8/13:8/13to9/13:9/13to10/13:10/13to10/14:10/14to11/14:11/14to11/15:11/15to12/15:12/15to13/15:13/15to14/15:14/15to15/15:15/15totop15:,32,True,True
2340,874,973,99,8/12to8/11,13/11to14/11,8/12to8/11:8/11to9/11:9/11to10/11:10/11to11/11:11/11to12/11:12/11to13/11:13/11to14/11:,7,False,True
1329,874,1071,197,11/3to11/2,10/5to9/5,11/3to11/2:11/2to11/3:11/3to12/3:12/3to12/4:12/4to12/5:12/5to11/5:11/5to10/5:10/5to9/5:,8,True,True
3161,875,990,115,top5to5/15,4/8to5/8,top5to5/15:5/15to4/15:4/15to4/14:4/14to4/13:4/13to4/12:4/12to4/11:4/11to4/10:4/10to4/9:4/9to4/8:4/8to5/8:,10,True,True
2727,875,1083,208,9/9to9/10,2/2to2/1,9/9to9/10:9/10to8/10:8/10to7/10:7/10to6/10:6/10to5/10:5/10to4/10:4/10to3/10:3/10to2/10:2/10to2/9:2/9to2/8:2/8to2/7:2/7to2/6:2/6to2/5:2/5to2/4:2/4to2/3:2/3to2/2:2/2to2/1:,17,False,True
338,875,1322,447,right0to15/0,0/15totop0,right0to15/0:15/0to14/0:14/0to13/0:13/0to12/0:12/0to11/0:11/0to11/1:11/1to10/1:10/1to9/1:9/1to8/1:8/1to7/1:7/1to6/1:6/1to5/1:5/1to4/1:4/1to3/1:3/1to2/1:2/1to1/1:1/1to0/1:0/1to0/2:0/2to0/3:0/3to0/4:0/4to0/5:0/5to0/6:0/6to0/7:0/7to0/8:0/8to0/9:0/9to0/10:0/10to0/11:0/11to0/12:0/12to0/13:0/13to0/14:0/14to0/15:0/15totop0:,32,True,True
897,875,928,53,5/2to4/2,4/4to3/4,5/2to4/2:4/2to4/3:4/3to4/4:4/4to3/4:,4,True,True
1346,876,1110,234,left11to0/11,10/12to10/13,left11to0/11:0/11to1/11:1/11to2/11:2/11to3/11:3/11to4/11:4/11to5/11:5/11to6/11:6/11to7/11:7/11to8/11:8/11to9/11:9/11to10/11:10/11to10/12:10/12to10/13:,13,True,True
1803,876,1064,188,4/1to4/2,5/15totop5,4/1to4/2:4/2to4/3:4/3to4/4:4/4to4/5:4/5to4/6:4/6to4/7:4/7to4/8:4/8to4/9:4/9to4/10:4/10to4/11:4/11to4/12:4/12to4/13:4/13to4/14:4/14to4/15:4/15to5/15:5/15totop5:,16,False,True
1589,876,948,72,right13to15/13,15/8to15/7,right13to15/13:15/13to15/12:15/12to15/11:15/11to15/10:15/10to15/9:15/9to15/8:15/8to15/7:,7,True,True
3294,876,937,61,9/9to8/9,7/11to6/11,9/9to8/9:8/9to7/9:7/9to7/10:7/10to7/11:7/11to6/11:,5,True,True
1495,877,912,35,7/9to6/9,6/8to5/8,7/9to6/9:6/9to6/8:6/8to5/8:,3,False,True
1138,877,1122,245,15/11to14/11,3/11to3/10,15/11to14/11:14/11to13/11:13/11to12/11:12/11to11/11:11/11to10/11:10/11to9/11:9/11to8/11:8/11to7/11:7/11to6/11:6/11to5/11:5/11to4/11:4/11to3/11:3/11to3/10:,13,False,True
1536,878,957,79,6/3to6/2,3/3to3/4,6/3to6/2:6/2to5/2:5/2to4/2:4/2to3/2:3/2to3/3:3/3to3/4:,6,True,True
1840,878,1092,214,top12to12/15,2/9to2/8,top12to12/15:12/15to11/15:11/15to11/14:11/14to10/14:10/14to9/14:9/14to8/14:8/14to7/14:7/14to6/14:6/14to5/14:5/14to4/14:4/14to3/14:3/14to2/14:2/14to2/13:2/13to2/12:2/12to2/11:2/11to2/10:2/10to2/9:2/9to2/8:,18,True,True
2879,878,1017,139,9/12to8/12,3/14to4/14,9/12to8/12:8/12to7/12:7/12to6/12:6/12to5/12:5/12to4/12:4/12to3/12:3/12to3/13:3/13to3/14:3/14to4/14:,9,True,True
408,879,1163,284,14/14to14/15,5/3to6/3,14/14to14/15:14/15to13/15:13/15to12/15:12/15to11/15:11/15to10/15:10/15to9/15:9/15to8/15:8/15to7/15:7/15to6/15:6/15to5/15:5/15to5/14:5/14to5/13:5/13to5/12:5/12to5/11:5/11to5/10:5/10to5/9:5/9to5/8:5/8to5/7:5/7to5/6:5/6to5/5:5/5to5/4:5/4to5/3:5/3to6/3:,23,True,True
2003,879,968,89,9/11to9/12,6/15totop6,9/11to9/12:9/12to8/12:8/12to7/12:7/12to6/12:6/12to6/13:6/13to6/14:6/14to6/15:6/15totop6:,8,False,True
2530,879,1082,203,8/11to8/10,11/13to11/12,8/11to8/10:8/10to8/11:8/11to9/11:9/11to10/11:10/11to10/12:10/12to11/12:11/12to11/13:11/13to11/12:,8,True,True
1839,879,938,59,3/8to3/9,4/11to4/12,3/8to3/9:3/9to3/10:3/10to3/11:3/11to4/11:4/11to4/12:,5,False,True
1360,880,958,78,9/8to8/8,5/9to4/9,9/8to8/8:8/8to7/8:7/8to6/8:6/8to5/8:5/8to5/9:5/9to4/9:,6,False,True
2396,880,1058,178,10/3to9/3,5/11to5/12,10/3to9/3:9/3to8/3:8/3to7/3:7/3to6/3:6/3to5/3:5/3to5/4:5/4to5/5:5/5to5/6:5/6to5/7:5/7to5/8:5/8to5/9:5/9to5/10:5/10to5/11:5/11to5/12:,14,False,True
3369,880,997,117,3/0to4/0,6/6to6/5,3/0to4/0:4/0to4/1:4/1to4/2:4/2to4/3:4/3to4/4:4/4to4/5:4/5to4/6:4/6to5/6:5/6to6/6:6/6to6/5:,10,False,True
2963,881,1080,199,left3to0/3,8/8to8/9,left3to0/3:0/3to0/4:0/4to0/5:0/5to0/6:0/6to0/7:0/7to0/8:0/8to1/8:1/8to2/8:2/8to3/8:3/8to4/8:4/8to5/8:5/8to6/8:6/8to7/8:7/8to8/8:8/8to8/9:,15,False,True
2210,882,954,72,13/4to12/4,13/1to13/0,13/4to12/4:12/4to12/3:12/3to12/2:12/2to12/1:12/1to13/1:13/1to13/0:,6,False,True
221,882,1275,393,right15to15/15,0/0tobottom0,right15to15/15:15/15to14/15:14/15to13/15:13/15to12/15:12/15to11/15:11/15to10/15:10/15to9/15:9/15to8/15:8/15to7/15:7/15to6/15:6/15to5/15:5/15to4/15:4/15to3/15:3/15to2/15:2/15to1/15:1/15to0/15:0/15to0/14:0/14to0/13:0/13to0/12:0/12to0/11:0/11to0/10:0/10to0/9:0/9to0/8:0/8to0/7:0/7to0/6:0/6to0/5:0/5to0/4:0/4to0/3:0/3to0/2:0/2to0/1:0/1to0/0:0/0tobottom0:,32,False,True
443,882,977,95,15/14to14/14,13/9to13/8,15/14to14/14:14/14to13/14:13/14to13/13:13/13to13/12:13/12to13/11:13/11to13/10:13/10to13/9:13/9to13/8:,8,True,True
1957,882,965,83,8/9to7/9,6/5to5/5,8/9to7/9:7/9to6/9:6/9to6/8:6/8to6/7:6/7to6/6:6/6to6/5:6/5to5/5:,7,False,True
402,883,1160,277,14/6to13/6,4/11to4/12,14/6to13/6:13/6to12/6:12/6to11/6:11/6to10/6:10/6to9/6:9/6to8/6:8/6to7/6:7/6to6/6:6/6to5/6:5/6to4/6:4/6to4/7:4/7to4/8:4/8to4/9:4/9to4/10:4/10to4/11:4/11to4/12:,16,True,True
3372,884,1076,192,8/11to8/12,10/0to11/0,8/11to8/12:8/12to8/11:8/11to8/10:8/10to8/9:8/9to8/8:8/8to8/7:8/7to8/6:8/6to8/5:8/5to8/4:8/4to8/3:8/3to8/2:8/2to9/2:9/2to10/2:10/2to10/1:10/1to10/0:10/0to11/0:,16,True,True
1860,886,1009,123,6/8to5/8,3/15totop3,6/8to5/8:5/8to4/8:4/8to3/8:3/8to3/9:3/9to3/10:3/10to3/11:3/11to3/12:3/12to3/13:3/13to3/14:3/14to3/15:3/15totop3:,11,True,True
693,886,1066,180,4/13to5/13,10/5to9/5,4/13to5/13:5/13to5/12:5/12to5/11:5/11to5/10:5/10to5/9:5/9to5/8:5/8to5/7:5/7to5/6:5/6to6/6:6/6to7/6:7/6to8/6:8/6to9/6:9/6to10/6:10/6to10/5:10/5to9/5:,15,True,True
1942,886,985,99,10/8to10/9,13/12to14/12,10/8to10/9:10/9to11/9:11/9to12/9:12/9to12/10:12/10to12/11:12/11to12/12:12/12to13/12:13/12to14/12:,8,True,True
2092,886,969,83,8/10to7/10,7/6to8/6,8/10to7/10:7/10to7/9:7/9to7/8:7/8to7/7:7/7to7/6:7/6to8/6:,6,False,True
1147,886,1083,197,9/11to10/11,13/0to13/1,9/11to10/11:10/11to10/10:10/10to11/10:11/10to11/9:11/9to11/8:11/8to11/7:11/7to11/6:11/6to11/5:11/5to11/4:11/4to11/3:11/3to11/2:11/2to11/1:11/1to11/0:11/0to12/0:12/0to13/0:13/0to13/1:,16,True,True
697,887,1026,139,4/9to3/9,9/12to9/11,4/9to3/9:3/9to3/10:3/10to3/11:3/11to3/12:3/12to4/12:4/12to5/12:5/12to6/12:6/12to7/12:7/12to8/12:8/12to9/12:9/12to9/11:,11,True,True
3318,887,1027,140,1/12to2/12,10/12to10/11,1/12to2/12:2/12to3/12:3/12to4/12:4/12to5/12:5/12to6/12:6/12to7/12:7/12to8/12:8/12to9/12:9/12to10/12:10/12to10/11:,10,False,True
66,887,1260,373,left15to0/15,15/0tobottom15,left15to0/15:0/15to0/14:0/14to0/13:0/13to0/12:0/12to0/11:0/11to0/10:0/10to0/9:0/9to0/8:0/8to0/7:0/7to0/6:0/6to0/5:0/5to0/4:0/4to0/3:0/3to0/2:0/2to1/2:1/2to2/2:2/2to3/2:3/2to4/2:4/2to5/2:5/2to6/2:6/2to7/2:7/2to8/2:8/2to9/2:9/2to10/2:10/2to10/1:10/1to11/1:11/1to11/0:11/0to12/0:12/0to13/0:13/0to14/0:14/0to15/0:15/0tobottom15:,32,True,True
3119,887,1222,335,right4to15/4,1/9to1/10,right4to15/4:15/4to14/4:14/4to13/4:13/4to12/4:12/4to11/4:11/4to10/4:10/4to9/4:9/4to8/4:8/4to7/4:7/4to6/4:6/4to5/4:5/4to4/4:4/4to3/4:3/4to2/4:2/4to1/4:1/4to1/5:1/5to1/6:1/6to1/7:1/7to1/8:1/8to1/9:1/9to1/10:,21,False,True
652,887,909,22,6/12to6/11,6/11to5/11,6/12to6/11:6/11to5/11:,2,True,True
2853,887,1006,119,8/1to7/1,6/8to6/9,8/1to7/1:7/1to6/1:6/1to6/2:6/2to6/3:6/3to6/4:6/4to6/5:6/5to6/6:6/6to6/7:6/7to6/8:6/8to6/9:,10,False,True
591,887,1142,255,15/4to14/4,5/8to5/9,15/4to14/4:14/4to13/4:13/4to12/4:12/4to11/4:11/4to10/4:10/4to9/4:9/4to8/4:8/4to7/4:7/4to6/4:6/4to5/4:5/4to5/5:5/5to5/6:5/6to5/7:5/7to5/8:5/8to5/9:,15,False,True
1646,888,1099,211,4/9to4/10,10/12to11/12,4/9to4/10:4/10to4/11:4/11to5/11:5/11to6/11:6/11to7/11:7/11to8/11:8/11to9/11:9/11to10/11:10/11to10/12:10/12to11/12:,10,True,True
1787,888,1159,271,1/7to2/7,14/1to14/2,1/7to2/7:2/7to3/7:3/7to4/7:4/7to5/7:5/7to6/7:6/7to7/7:7/7to8/7:8/7to9/7:9/7to10/7:10/7to10/6:10/6to10/5:10/5to10/4:10/4to10/3:10/3to10/2:10/2to10/1:10/1to11/1:11/1to12/1:12/1to13/1:13/1to14/1:14/1to14/2:,20,False,True
1872,888,1083,195,11/1to10/1,10/14to10/15,11/1to10/1:10/1to10/2:10/2to10/3:10/3to9/3:9/3to9/4:9/4to9/5:9/5to9/6:9/6to9/7:9/7to9/8:9/8to9/9:9/9to9/10:9/10to9/11:9/11to9/12:9/12to9/13:9/13to9/14:9/14to10/14:10/14to10/15:,17,True,True
1401,888,1025,137,0/0to0/1,5/5to5/6,0/0to0/1:0/1to0/2:0/2to0/3:0/3to0/4:0/4to0/5:0/5to1/5:1/5to2/5:2/5to3/5:3/5to4/5:4/5to5/5:5/5to5/6:,11,True,True
202,889,1293,404,right15to15/15,0/0tobottom0,right15to15/15:15/15to14/15:14/15to13/15:13/15to12/15:12/15to11/15:11/15to10/15:10/15to9/15:9/15to8/15:8/15to7/15:7/15to6/15:6/15to5/15:5/15to4/15:4/15to3/15:3/15to2/15:2/15to1/15:1/15to0/15:0/15to0/14:0/14to0/13:0/13to0/12:0/12to0/11:0/11to0/10:0/10to0/9:0/9to0/8:0/8to0/7:0/7to0/6:0/6to0/5:0/5to0/4:0/4to0/3:0/3to0/2:0/2to0/1:0/1to0/0:0/0tobottom0:,32,True,True
836,889,1062,173,3/5to3/4,12/2to13/2,3/5to3/4:3/4to3/3:3/3to4/3:4/3to5/3:5/3to6/3:6/3to7/3:7/3to8/3:8/3to9/3:9/3to10/3:10/3to10/2:10/2to11/2:11/2to12/2:12/2to13/2:,13,True,True
2441,889,1122,233,top14to14/15,6/6to5/6,top14to14/15:14/15to13/15:13/15to12/15:12/15to11/15:11/15to10/15:10/15to9/15:9/15to8/15:8/15to7/15:7/15to6/15:6/15to6/14:6/14to6/13:6/13to6/12:6/12to6/11:6/11to6/10:6/10to6/9:6/9to6/8:6/8to6/7:6/7to6/6:6/6to5/6:,19,True,True
791,890,1005,115,left5to0/5,4/1to5/1,left5to0/5:0/5to0/4:0/4to0/3:0/3to0/2:0/2to0/1:0/1to1/1:1/1to2/1:2/1to3/1:3/1to4/1:4/1to5/1:,10,False,True
245,890,1295,405,right15to15/15,0/0tobottom0,right15to15/15:15/15to14/15:14/15to13/15:13/15to12/15:12/15to11/15:11/15to10/15:10/15to9/15:9/15to8/15:8/15to7/15:7/15to6/15:6/15to5/15:5/15to4/15:4/15to3/15:3/15to2/15:2/15to1/15:1/15to0/15:0/15to0/14:0/14to0/13:0/13to0/12:0/12to0/11:0/11to0/10:0/10to0/9:0/9to0/8:0/8to0/7:0/7to0/6:0/6to0/5:0/5to0/4:0/4to0/3:0/3to0/2:0/2to0/1:0/1to0/0:0/0tobottom0:,32,True,True
4,890,1263,373,left15to0/15,15/0tobottom15,left15to0/15:0/15to0/14:0/14to0/13:0/13to0/12:0/12to0/11:0/11to0/10:0/10to0/9:0/9to0/8:0/8to0/7:0/7to0/6:0/6to0/5:0/5to0/4:0/4to0/3:0/3to0/2:0/2to1/2:1/2to2/2:2/2to3/2:3/2to4/2:4/2to5/2:5/2to6/2:6/2to7/2:7/2to8/2:8/2to9/2:9/2to10/2:10/2to10/1:10/1to11/1:11/1to11/0:11/0to12/0:12/0to13/0:13/0to14/0:14/0to15/0:15/0tobottom15:,32,True,True
2338,890,963,73,3/5to2/5,0/7to1/7,3/5to2/5:2/5to1/5:1/5to0/5:0/5to0/6:0/6to0/7:0/7to1/7:,6,True,True
1022,890,1077,187,13/0to12/0,15/11to15/12,13/0to12/0:12/0to12/1:12/1to12/2:12/2to12/3:12/3to12/4:12/4to12/5:12/5to12/6:12/6to12/7:12/7to12/8:12/8to12/9:12/9to12/10:12/10to12/11:12/11to13/11:13/11to14/11:14/11to15/11:15/11to15/12:,16,True,True
36,891,1271,380,left15to0/15,15/0tobottom15,left15to0/15:0/15to0/14:0/14to0/13:0/13to0/12:0/12to0/11:0/11to0/10:0/10to0/9:0/9to0/8:0/8to0/7:0/7to0/6:0/6to0/5:0/5to0/4:0/4to0/3:0/3to0/2:0/2to1/2:1/2to2/2:2/2to3/2:3/2to4/2:4/2to5/2:5/2to6/2:6/2to7/2:7/2to8/2:8/2to9/2:9/2to10/2:10/2to10/1:10/1to11/1:11/1to11/0:11/0to12/0:12/0to13/0:13/0to14/0:14/0to15/0:15/0tobottom15:,32,True,True
3036,891,974,83,13/8to12/8,11/4to11/3,13/8to12/8:12/8to11/8:11/8to11/7:11/7to11/6:11/6to11/5:11/5to11/4:11/4to11/3:,7,True,True
3077,891,1017,126,4/4to4/3,3/11to3/12,4/4to4/3:4/3to3/3:3/3to3/4:3/4to3/5:3/5to3/6:3/6to3/7:3/7to3/8:3/8to3/9:3/9to3/10:3/10to3/11:3/11to3/12:,11,False,True
3284,891,1064,173,4/11to5/11,13/9to13/8,4/11to5/11:5/11to6/11:6/11to7/11:7/11to8/11:8/11to9/11:9/11to10/11:10/11to10/10:10/10to10/9:10/9to11/9:11/9to12/9:12/9to13/9:13/9to13/8:,12,False,True
3176,892,1049,157,5/6to6/6,14/4to14/3,5/6to6/6:6/6to7/6:7/6to8/6:8/6to9/6:9/6to10/6:10/6to10/5:10/5to10/4:10/4to11/4:11/4to12/4:12/4to13/4:13/4to14/4:14/4to14/3:,12,False,True
2547,892,955,63,15/5to15/4,12/4to12/3,15/5to15/4:15/4to14/4:14/4to13/4:13/4to12/4:12/4to12/3:,5,True,True
2895,893,1081,188,9/3to8/3,0/5to0/6,9/3to8/3:8/3to7/3:7/3to6/3:6/3to5/3:5/3to4/3:4/3to3/3:3/3to2/3:2/3to1/3:1/3to0/3:0/3to0/4:0/4to0/5:0/5to0/6:,12,True,True
2866,893,1135,242,10/2to9/2,3/14to3/15,10/2to9/2:9/2to8/2:8/2to7/2:7/2to6/2:6/2to5/2:5/2to4/2:4/2to3/2:3/2to3/3:3/3to3/4:3/4to3/5:3/5to3/6:3/6to3/7:3/7to3/8:3/8to3/9:3/9to3/10:3/10to3/11:3/11to3/12:3/12to3/13:3/13to3/14:3/14to3/15:,20,False,True
2532,893,1109,216,1/14to2/14,5/0tobottom5,1/14to2/14:2/14to2/13:2/13to2/12:2/12to2/11:2/11to2/10:2/10to2/9:2/9to2/8:2/8to2/7:2/7to2/6:2/6to2/5:2/5to2/4:2/4to2/3:2/3to2/2:2/2to2/1:2/1to2/0:2/0to3/0:3/0to4/0:4/0to5/0:5/0tobottom5:,19,True,True
1051,893,983,90,2/11to3/11,6/13to6/12,2/11to3/11:3/11to3/12:3/12to3/13:3/13to4/13:4/13to5/13:5/13to6/13:6/13to6/12:,7,False,True
1580,893,1231,338,13/11to12/11,3/1to4/1,13/11to12/11:12/11to11/11:11/11to10/11:10/11to9/11:9/11to8/11:8/11to7/11:7/11to6/11:6/11to5/11:5/11to4/11:4/11to3/11:3/11to3/10:3/10to3/9:3/9to3/8:3/8to3/7:3/7to3/6:3/6to3/5:3/5to3/4:3/4to3/3:3/3to3/2:3/2to3/1:3/1to4/1:,21,False,True
1543,893,1250,357,14/6to13/6,3/0to4/0,14/6to13/6:13/6to12/6:12/6to11/6:11/6to10/6:10/6to9/6:9/6to8/6:8/6to7/6:7/6to6/6:6/6to5/6:5/6to4/6:4/6to3/6:3/6to3/5:3/5to3/4:3/4to3/3:3/3to3/2:3/2to3/1:3/1to3/0:3/0to4/0:,18,False,True
2698,893,1014,121,14/5to14/4,10/8to9/8,14/5to14/4:14/4to13/4:13/4to12/4:12/4to11/4:11/4to10/4:10/4to10/5:10/5to10/6:10/6to10/7:10/7to10/8:10/8to9/8:,10,False,True
1980,894,1035,141,15/4to15/3,10/8to10/9,15/4to15/3:15/3to14/3:14/3to13/3:13/3to12/3:12/3to11/3:11/3to11/4:11/4to11/5:11/5to11/6:11/6to11/7:11/7to10/7:10/7to10/8:10/8to10/9:,12,True,True
2178,894,1133,239,bottom10to10/0,4/13to5/13,bottom10to10/0:10/0to10/1:10/1to9/1:9/1to8/1:8/1to7/1:7/1to6/1:6/1to5/1:5/1to4/1:4/1to4/2:4/2to4/3:4/3to4/4:4/4to4/5:4/5to4/6:4/6to4/7:4/7to4/8:4/8to4/9:4/9to4/10:4/10to4/11:4/11to4/12:4/12to4/13:4/13to5/13:,21,True,True
1661,894,1062,168,3/8to4/8,9/15totop9,3/8to4/8:4/8to4/9:4/9to4/10:4/10to4/11:4/11to4/12:4/12to4/13:4/13to4/14:4/14to4/15:4/15to5/15:5/15to6/15:6/15to7/15:7/15to8/15:8/15to9/15:9/15totop9:,14,False,True
631,895,1233,338,14/8to14/7,0/5to0/4,14/8to14/7:14/7to13/7:13/7to12/7:12/7to12/6:12/6to11/6:11/6to10/6:10/6to9/6:9/6to8/6:8/6to7/6:7/6to6/6:6/6to5/6:5/6to4/6:4/6to3/6:3/6to2/6:2/6to1/6:1/6to0/6:0/6to0/5:0/5to0/4:,18,True,True
3109,895,1014,119,9/5to9/6,10/9to10/10,9/5to9/6:9/6to10/6:10/6to10/7:10/7to10/8:10/8to10/9:10/9to10/10:,6,False,True
1248,896,1043,147,3/12to3/11,3/0to2/0,3/12to3/11:3/11to3/10:3/10to3/9:3/9to3/8:3/8to3/7:3/7to3/6:3/6to3/5:3/5to3/4:3/4to3/3:3/3to3/2:3/2to3/1:3/1to3/0:3/0to2/0:,13,True,True
153,896,1275,379,left0to0/0,15/15totop15,left0to0/0:0/0to0/1:0/1to0/2:0/2to0/3:0/3to0/4:0/4to0/5:0/5to0/6:0/6to0/7:0/7to0/8:0/8to0/9:0/9to0/10:0/10to0/11:0/11to0/12:0/12to0/13:0/13to1/13:1/13to2/13:2/13to3/13:3/13to4/13:4/13to5/13:5/13to6/13:6/13to7/13:7/13to8/13:8/13to9/13:9/13to10/13:10/13to10/14:10/14to11/14:11/14to11/15:11/15to12/15:12/15to13/15:13/15to14/15:14/15to15/15:15/15totop15:,32,True,True
2331,896,1031,135,10/5to10/4,5/8to6/8,10/5to10/4:10/4to9/4:9/4to8/4:8/4to7/4:7/4to6/4:6/4to5/4:5/4to5/5:5/5to5/6:5/6to5/7:5/7to5/8:5/8to6/8:,11,False,True
1992,897,1176,279,14/1to14/0,0/6toleft6,14/1to14/0:14/0to13/0:13/0to12/0:12/0to11/0:11/0to10/0:10/0to9/0:9/0to8/0:8/0to7/0:7/0to6/0:6/0to5/0:5/0to4/0:4/0to3/0:3/0to2/0:2/0to1/0:1/0to0/0:0/0to0/1:0/1to0/2:0/2to0/3:0/3to0/4:0/4to0/5:0/5to0/6:0/6toleft6:,22,False,True
2455,897,989,92,left6to0/6,2/2to2/3,left6to0/6:0/6to0/5:0/5to0/4:0/4to0/3:0/3to0/2:0/2to1/2:1/2to2/2:2/2to2/3:,8,False,True
3297,897,1025,128,5/2to5/3,0/4to0/5,5/2to5/3:5/3to4/3:4/3to3/3:3/3to2/3:2/3to1/3:1/3to0/3:0/3to0/4:0/4to0/5:,8,False,True
1121,898,1222,324,9/5to9/4,13/9to13/10,9/5to9/4:9/4to10/4:10/4to10/5:10/5to10/6:10/6to10/7:10/7to10/8:10/8to10/9:10/9to11/9:11/9to12/9:12/9to13/9:13/9to13/10:,11,False,True
3322,898,1072,174,4/3to4/4,14/2to15/2,4/3to4/4:4/4to4/3:4/3to4/2:4/2to5/2:5/2to6/2:6/2to7/2:7/2to8/2:8/2to9/2:9/2to10/2:10/2to11/2:11/2to12/2:12/2to13/2:13/2to14/2:14/2to15/2:,14,True,True
485,898,978,80,15/13to15/12,15/7to15/6,15/13to15/12:15/12to15/11:15/11to15/10:15/10to15/9:15/9to15/8:15/8to15/7:15/7to15/6:,7,False,True
2667,899,1057,158,10/4to9/4,6/12to6/13,10/4to9/4:9/4to8/4:8/4to7/4:7/4to6/4:6/4to6/5:6/5to6/6:6/6to6/7:6/7to6/8:6/8to6/9:6/9to6/10:6/10to6/11:6/11to6/12:6/12to6/13:,13,True,True
393,899,1324,425,right0to15/0,0/15totop0,right0to15/0:15/0to14/0:14/0to13/0:13/0to12/0:12/0to11/0:11/0to11/1:11/1to10/1:10/1to9/1:9/1to8/1:8/1to7/1:7/1to6/1:6/1to5/1:5/1to4/1:4/1to3/1:3/1to2/1:2/1to1/1:1/1to0/1:0/1to0/2:0/2to0/3:0/3to0/4:0/4to0/5:0/5to0/6:0/6to0/7:0/7to0/8:0/8to0/9:0/9to0/10:0/10to0/11:0/11to0/12:0/12to0/13:0/13to0/14:0/14to0/15:0/15totop0:,32,True,True
756,899,1048,149,0/6to1/6,7/10to7/11,0/6to1/6:1/6to1/7:1/7to1/8:1/8to1/9:1/9to1/10:1/10to2/10:2/10to3/10:3/10to4/10:4/10to5/10:5/10to6/10:6/10to7/10:7/10to7/11:,12,True,True
1310,899,1053,154,9/9to10/9,15/14to15/13,9/9to10/9:10/9to10/10:10/10to10/11:10/11to10/12:10/12to10/13:10/13to10/14:10/14to11/14:11/14to12/14:12/14to13/14:13/14to14/14:14/14to15/14:15/14to15/13:,12,False,True
878,900,1064,164,11/2to10/2,8/10to9/10,11/2to10/2:10/2to9/2:9/2to8/2:8/2to8/3:8/3to8/4:8/4to8/5:8/5to8/6:8/6to8/7:8/7to8/8:8/8to8/9:8/9to8/10:8/10to9/10:,12,False,True
2791,901,1067,166,12/6to12/7,8/3to9/3,12/6to12/7:12/7to11/7:11/7to10/7:10/7to9/7:9/7to8/7:8/7to8/6:8/6to8/5:8/5to8/4:8/4to8/3:8/3to9/3:,10,True,True
1438,901,1029,128,3/5to3/6,5/13to5/14,3/5to3/6:3/6to3/7:3/7to3/8:3/8to3/9:3/9to3/10:3/10to3/11:3/11to3/12:3/12to3/13:3/13to4/13:4/13to5/13:5/13to5/14:,11,True,True
2786,901,1103,202,15/1to14/1,2/1to1/1,15/1to14/1:14/1to13/1:13/1to12/1:12/1to12/0:12/0to11/0:11/0to10/0:10/0to9/0:9/0to8/0:8/0to7/0:7/0to6/0:6/0to5/0:5/0to4/0:4/0to3/0:3/0to2/0:2/0to2/1:2/1to1/1:,16,True,True
967,901,971,70,11/6to11/5,15/5to15/4,11/6to11/5:11/5to12/5:12/5to13/5:13/5to14/5:14/5to15/5:15/5to15/4:,6,True,True
562,901,1259,358,1/4to2/4,14/9to15/9,1/4to2/4:2/4to3/4:3/4to4/4:4/4to5/4:5/4to6/4:6/4to7/4:7/4to8/4:8/4to9/4:9/4to10/4:10/4to10/5:10/5to10/6:10/6to10/7:10/7to10/8:10/8to10/9:10/9to11/9:11/9to12/9:12/9to13/9:13/9to14/9:14/9to15/9:,19,False,True
2300,902,1092,190,0/13to0/12,4/3to5/3,0/13to0/12:0/12to0/11:0/11to0/10:0/10to0/9:0/9to0/8:0/8to0/7:0/7to0/6:0/6to0/5:0/5to0/4:0/4to0/3:0/3to1/3:1/3to2/3:2/3to3/3:3/3to4/3:4/3to5/3:,15,False,True
1632,902,1073,171,8/13to9/13,15/8to15/7,8/13to9/13:9/13to10/13:10/13to10/12:10/12to10/11:10/11to10/10:10/10to10/9:10/9to10/8:10/8to11/8:11/8to12/8:12/8to13/8:13/8to14/8:14/8to15/8:15/8to15/7:,13,False,True
2142,902,1090,188,left5to0/5,7/12to7/11,left5to0/5:0/5to0/6:0/6to0/7:0/7to0/8:0/8to0/9:0/9to0/10:0/10to0/11:0/11to0/12:0/12to1/12:1/12to2/12:2/12to3/12:3/12to4/12:4/12to5/12:5/12to6/12:6/12to7/12:7/12to7/11:,16,False,True
2631,902,1138,236,top2to2/15,11/6to11/5,top2to2/15:2/15to3/15:3/15to4/15:4/15to5/15:5/15to6/15:6/15to7/15:7/15to8/15:8/15to9/15:9/15to10/15:10/15to10/14:10/14to10/13:10/13to10/12:10/12to10/11:10/11to10/10:10/10to10/9:10/9to10/8:10/8to10/7:10/7to10/6:10/6to11/6:11/6to11/5:,20,False,True
1335,903,1007,104,14/6to13/6,12/0tobottom12,14/6to13/6:13/6to12/6:12/6to12/5:12/5to12/4:12/4to12/3:12/3to12/2:12/2to12/1:12/1to12/0:12/0tobottom12:,9,False,True
3390,903,1066,163,3/10to3/9,7/2to7/3,3/10to3/9:3/9to3/8:3/8to3/7:3/7to3/6:3/6to3/5:3/5to3/4:3/4to3/3:3/3to3/2:3/2to4/2:4/2to5/2:5/2to6/2:6/2to7/2:7/2to7/3:,13,True,True
487,903,963,60,8/0to9/0,11/1to12/1,8/0to9/0:9/0to10/0:10/0to11/0:11/0to11/1:11/1to12/1:,5,True,True
1421,903,1017,114,1/7to1/6,8/6to9/6,1/7to1/6:1/6to2/6:2/6to3/6:3/6to4/6:4/6to5/6:5/6to6/6:6/6to7/6:7/6to8/6:8/6to9/6:,9,False,True
3067,903,1041,138,3/6to4/6,8/0tobottom8,3/6to4/6:4/6to4/5:4/5to4/4:4/4to4/3:4/3to4/2:4/2to4/1:4/1to4/0:4/0to5/0:5/0to6/0:6/0to7/0:7/0to8/0:8/0tobottom8:,12,True,True
885,904,1233,329,7/7to8/7,14/8to14/9,7/7to8/7:8/7to9/7:9/7to10/7:10/7to10/8:10/8to11/8:11/8to12/8:12/8to13/8:13/8to14/8:14/8to14/9:,9,False,True
1996,904,1012,108,5/13to4/13,0/12to0/11,5/13to4/13:4/13to3/13:3/13to2/13:2/13to1/13:1/13to0/13:0/13to0/12:0/12to0/11:,7,False,True
1338,904,969,65,1/10to1/9,3/8to4/8,1/10to1/9:1/9to1/8:1/8to2/8:2/8to3/8:3/8to4/8:,5,False,True
2975,904,960,56,10/9to10/8,10/5to9/5,10/9to10/8:10/8to10/7:10/7to10/6:10/6to10/5:10/5to9/5:,5,False,True
2083,905,1088,183,7/9to6/9,0/14to1/14,7/9to6/9:6/9to5/9:5/9to4/9:4/9to3/9:3/9to2/9:2/9to1/9:1/9to0/9:0/9to0/10:0/10to0/11:0/11to0/12:0/12to0/13:0/13to0/14:0/14to1/14:,13,False,True
3019,905,1138,233,top6to6/15,13/4to14/4,top6to6/15:6/15to7/15:7/15to8/15:8/15to9/15:9/15to10/15:10/15to10/14:10/14to10/13:10/13to10/12:10/12to10/11:10/11to10/10:10/10to10/9:10/9to10/8:10/8to10/7:10/7to10/6:10/6to10/5:10/5to10/4:10/4to11/4:11/4to12/4:12/4to13/4:13/4to14/4:,20,False,True
27,905,1291,386,left15to0/15,15/0tobottom15,left15to0/15:0/15to1/15:1/15to2/15:2/15to3/15:3/15to4/15:4/15to5/15:5/15to6/15:6/15to7/15:7/15to8/15:8/15to9/15:9/15to10/15:10/15to10/14:10/14to10/13:10/13to10/12:10/12to10/11:10/11to10/10:10/10to10/9:10/9to10/8:10/8to10/7:10/7to10/6:10/6to10/5:10/5to10/4:10/4to10/3:10/3to10/2:10/2to10/1:10/1to10/0:10/0to11/0:11/0to12/0:12/0to13/0:13/0to14/0:14/0to15/0:15/0tobottom15:,32,False,True
2122,905,1144,239,0/1to0/2,6/14to7/14,0/1to0/2:0/2to0/3:0/3to0/4:0/4to0/5:0/5to0/6:0/6to0/7:0/7to0/8:0/8to0/9:0/9to0/10:0/10to0/11:0/11to0/12:0/12to0/13:0/13to0/14:0/14to1/14:1/14to2/14:2/14to3/14:3/14to4/14:4/14to5/14:5/14to6/14:6/14to7/14:,20,False,True
1899,905,1034,129,6/11to6/12,0/15to1/15,6/11to6/12:6/12to5/12:5/12to4/12:4/12to3/12:3/12to2/12:2/12to1/12:1/12to0/12:0/12to0/13:0/13to0/14:0/14to0/15:0/15to1/15:,11,False,True
290,906,1294,388,right15to15/15,0/0tobottom0,right15to15/15:15/15to14/15:14/15to13/15:13/15to12/15:12/15to11/15:11/15to10/15:10/15to9/15:9/15to8/15:8/15to7/15:7/15to6/15:6/15to5/15:5/15to4/15:4/15to3/15:3/15to2/15:2/15to1/15:1/15to0/15:0/15to0/14:0/14to0/13:0/13to0/12:0/12to0/11:0/11to0/10:0/10to0/9:0/9to0/8:0/8to0/7:0/7to0/6:0/6to0/5:0/5to0/4:0/4to0/3:0/3to0/2:0/2to0/1:0/1to0/0:0/0tobottom0:,32,True,True
2859,906,942,36,7/8to7/7,7/6to7/5,7/8to7/7:7/7to7/6:7/6to7/5:,3,True,True
1789,906,990,84,13/7to13/6,11/3to12/3,13/7to13/6:13/6to12/6:12/6to11/6:11/6to11/5:11/5to11/4:11/4to11/3:11/3to12/3:,7,False,True
2668,906,1088,182,14/0to13/0,2/0to2/1,14/0to13/0:13/0to12/0:12/0to11/0:11/0to10/0:10/0to9/0:9/0to8/0:8/0to7/0:7/0to6/0:6/0to5/0:5/0to4/0:4/0to3/0:3/0to2/0:2/0to2/1:,13,False,True
674,906,1282,376,14/9to14/8,0/7to1/7,14/9to14/8:14/8to13/8:13/8to12/8:12/8to11/8:11/8to10/8:10/8to9/8:9/8to8/8:8/8to7/8:7/8to6/8:6/8to5/8:5/8to4/8:4/8to3/8:3/8to2/8:2/8to1/8:1/8to0/8:0/8to0/7:0/7to1/7:,17,True,True
657,906,1005,99,left9to0/9,1/4to2/4,left9to0/9:0/9to0/8:0/8to0/7:0/7to0/6:0/6to0/5:0/5to0/4:0/4to1/4:1/4to2/4:,8,True,True
620,907,989,82,6/10to6/11,5/7to4/7,6/10to6/11:6/11to5/11:5/11to5/10:5/10to5/9:5/9to5/8:5/8to5/7:5/7to4/7:,7,False,True
503,907,1285,378,14/2to14/3,0/13toleft13,14/2to14/3:14/3to13/3:13/3to12/3:12/3to11/3:11/3to10/3:10/3to9/3:9/3to8/3:8/3to7/3:7/3to6/3:6/3to5/3:5/3to4/3:4/3to3/3:3/3to2/3:2/3to1/3:1/3to0/3:0/3to0/4:0/4to0/5:0/5to0/6:0/6to0/7:0/7to0/8:0/8to0/9:0/9to0/10:0/10to0/11:0/11to0/12:0/12to0/13:0/13toleft13:,26,True,True
1826,907,1223,316,8/5to8/6,13/9to13/8,8/5to8/6:8/6to8/7:8/7to8/8:8/8to9/8:9/8to10/8:10/8to10/9:10/9to11/9:11/9to12/9:12/9to13/9:13/9to13/8:,10,True,True
1221,908,1136,228,bottom6to6/0,15/3to15/4,bottom6to6/0:6/0to6/1:6/1to7/1:7/1to8/1:8/1to9/1:9/1to10/1:10/1to10/2:10/2to11/2:11/2to11/3:11/3to12/3:12/3to13/3:13/3to14/3:14/3to15/3:15/3to15/4:,14,True,True
1581,908,1113,205,3/15to4/15,13/11to13/12,3/15to4/15:4/15to4/14:4/14to4/13:4/13to4/12:4/12to4/11:4/11to5/11:5/11to6/11:6/11to7/11:7/11to8/11:8/11to9/11:9/11to10/11:10/11to11/11:11/11to12/11:12/11to13/11:13/11to13/12:,15,True,True
1018,909,1347,438,15/6to15/5,0/11to1/11,15/6to15/5:15/5to14/5:14/5to13/5:13/5to12/5:12/5to11/5:11/5to10/5:10/5to9/5:9/5to8/5:8/5to7/5:7/5to6/5:6/5to5/5:5/5to4/5:4/5to3/5:3/5to2/5:2/5to1/5:1/5to0/5:0/5to0/6:0/6to0/7:0/7to0/8:0/8to0/9:0/9to0/10:0/10to0/11:0/11to1/11:,23,True,True
1462,909,999,90,6/14to5/14,7/11to8/11,6/14to5/14:5/14to5/13:5/13to5/12:5/12to5/11:5/11to6/11:6/11to7/11:7/11to8/11:,7,True,True
2637,910,1003,93,left11to0/11,4/10to5/10,left11to0/11:0/11to0/10:0/10to1/10:1/10to2/10:2/10to3/10:3/10to4/10:4/10to5/10:,7,True,True
1847,910,1011,101,8/4to7/4,2/5to2/6,8/4to7/4:7/4to6/4:6/4to5/4:5/4to4/4:4/4to3/4:3/4to2/4:2/4to2/5:2/5to2/6:,8,False,True
1088,910,1056,146,6/1to5/1,0/6to1/6,6/1to5/1:5/1to4/1:4/1to3/1:3/1to2/1:2/1to1/1:1/1to0/1:0/1to0/2:0/2to0/3:0/3to0/4:0/4to0/5:0/5to0/6:0/6to1/6:,12,True,True
1216,910,1121,211,13/11to12/11,6/13to7/13,13/11to12/11:12/11to11/11:11/11to10/11:10/11to9/11:9/11to8/11:8/11to7/11:7/11to6/11:6/11to6/12:6/12to6/13:6/13to7/13:,10,False,True
276,910,1308,398,right15to15/15,0/0tobottom0,right15to15/15:15/15to14/15:14/15to13/15:13/15to12/15:12/15to11/15:11/15to10/15:10/15to9/15:9/15to8/15:8/15to7/15:7/15to6/15:6/15to5/15:5/15to4/15:4/15to3/15:3/15to2/15:2/15to1/15:1/15to0/15:0/15to0/14:0/14to0/13:0/13to0/12:0/12to0/11:0/11to0/10:0/10to0/9:0/9to0/8:0/8to0/7:0/7to0/6:0/6to0/5:0/5to0/4:0/4to0/3:0/3to0/2:0/2to0/1:0/1to0/0:0/0tobottom0:,32,False,True
13,912,1304,392,left15to0/15,15/0tobottom15,left15to0/15:0/15to1/15:1/15to2/15:2/15to3/15:3/15to4/15:4/15to5/15:5/15to6/15:6/15to7/15:7/15to8/15:8/15to9/15:9/15to10/15:10/15to10/14:10/14to10/13:10/13to10/12:10/12to10/11:10/11to10/10:10/10to10/9:10/9to10/8:10/8to10/7:10/7to10/6:10/6to10/5:10/5to10/4:10/4to10/3:10/3to10/2:10/2to10/1:10/1to10/0:10/0to11/0:11/0to12/0:12/0to13/0:13/0to14/0:14/0to15/0:15/0tobottom15:,32,False,True
481,912,1060,148,10/5to10/4,0/4to0/3,10/5to10/4:10/4to9/4:9/4to8/4:8/4to7/4:7/4to6/4:6/4to5/4:5/4to4/4:4/4to3/4:3/4to2/4:2/4to1/4:1/4to0/4:0/4to0/3:,12,False,True
1735,912,1080,168,6/1to6/0,0/6to0/7,6/1to6/0:6/0to5/0:5/0to4/0:4/0to3/0:3/0to2/0:2/0to1/0:1/0to0/0:0/0to0/1:0/1to0/2:0/2to0/3:0/3to0/4:0/4to0/5:0/5to0/6:0/6to0/7:,14,True,True
1097,912,1050,138,5/1to5/2,13/1to14/1,5/1to5/2:5/2to6/2:6/2to7/2:7/2to8/2:8/2to9/2:9/2to10/2:10/2to10/1:10/1to11/1:11/1to12/1:12/1to13/1:13/1to14/1:,11,True,True
3203,913,1117,204,top9to9/15,15/6toright6,top9to9/15:9/15to9/14:9/14to9/13:9/13to9/12:9/12to9/11:9/11to9/10:9/10to9/9:9/9to9/8:9/8to9/7:9/7to9/6:9/6to10/6:10/6to11/6:11/6to12/6:12/6to13/6:13/6to14/6:14/6to15/6:15/6toright6:,17,True,True
177,913,1290,377,left0to0/0,15/15totop15,left0to0/0:0/0to1/0:1/0to2/0:2/0to3/0:3/0to4/0:4/0to5/0:5/0to6/0:6/0to7/0:7/0to8/0:8/0to9/0:9/0to10/0:10/0to10/1:10/1to10/2:10/2to10/3:10/3to10/4:10/4to10/5:10/5to10/6:10/6to10/7:10/7to10/8:10/8to10/9:10/9to10/10:10/10to10/11:10/11to10/12:10/12to10/13:10/13to10/14:10/14to10/15:10/15to11/15:11/15to12/15:12/15to13/15:13/15to14/15:14/15to15/15:15/15totop15:,32,False,True
3029,913,951,38,right0to15/0,14/1to13/1,right0to15/0:15/0to14/0:14/0to14/1:14/1to13/1:,4,False,True
355,913,1288,375,right0to15/0,0/15totop0,right0to15/0:15/0to14/0:14/0to13/0:13/0to12/0:12/0to11/0:11/0to10/0:10/0to9/0:9/0to8/0:8/0to7/0:7/0to6/0:6/0to5/0:5/0to4/0:4/0to3/0:3/0to2/0:2/0to1/0:1/0to0/0:0/0to0/1:0/1to0/2:0/2to0/3:0/3to0/4:0/4to0/5:0/5to0/6:0/6to0/7:0/7to0/8:0/8to0/9:0/9to0/10:0/10to0/11:0/11to0/12:0/12to0/13:0/13to0/14:0/14to0/15:0/15totop0:,32,True,True
2055,914,977,63,9/3to9/2,7/0tobottom7,9/3to9/2:9/2to8/2:8/2to7/2:7/2to7/1:7/1to7/0:7/0tobottom7:,6,False,True
1252,914,1117,203,12/4to12/5,8/9to8/10,12/4to12/5:12/5to11/5:11/5to10/5:10/5to9/5:9/5to8/5:8/5to8/6:8/6to8/7:8/7to8/8:8/8to8/9:8/9to8/10:,10,True,True
856,914,1292,378,13/8to12/8,0/1to1/1,13/8to12/8:12/8to11/8:11/8to10/8:10/8to9/8:9/8to8/8:8/8to7/8:7/8to6/8:6/8to5/8:5/8to4/8:4/8to3/8:3/8to2/8:2/8to1/8:1/8to0/8:0/8to0/7:0/7to0/6:0/6to0/5:0/5to0/4:0/4to0/3:0/3to0/2:0/2to0/1:0/1to1/1:,21,True,True
279,915,1310,395,right15to15/15,0/0tobottom0,right15to15/15:15/15to14/15:14/15to13/15:13/15to12/15:12/15to11/15:11/15to10/15:10/15to9/15:9/15to8/15:8/15to7/15:7/15to6/15:6/15to5/15:5/15to4/15:4/15to3/15:3/15to2/15:2/15to1/15:1/15to0/15:0/15to0/14:0/14to0/13:0/13to0/12:0/12to0/11:0/11to0/10:0/10to0/9:0/9to0/8:0/8to0/7:0/7to0/6:0/6to0/5:0/5to0/4:0/4to0/3:0/3to0/2:0/2to0/1:0/1to0/0:0/0tobottom0:,32,False,True
3010,915,1064,149,8/7to9/7,13/1to14/1,8/7to9/7:9/7to9/6:9/6to9/5:9/5to9/4:9/4to9/3:9/3to10/3:10/3to10/2:10/2to11/2:11/2to12/2:12/2to12/1:12/1to13/1:13/1to14/1:,12,True,True
3332,915,1004,89,12/5to11/5,10/0tobottom10,12/5to11/5:11/5to10/5:10/5to10/4:10/4to10/3:10/3to10/2:10/2to10/1:10/1to10/0:10/0tobottom10:,8,False,True
940,916,1116,200,9/15to9/14,15/6to15/7,9/15to9/14:9/14to10/14:10/14to10/13:10/13to11/13:11/13to11/12:11/12to11/11:11/11to11/10:11/10to11/9:11/9to11/8:11/8to11/7:11/7to11/6:11/6to12/6:12/6to13/6:13/6to14/6:14/6to15/6:15/6to15/7:,16,True,True
2099,916,1212,296,1/8to1/7,10/10to10/11,1/8to1/7:1/7to2/7:2/7to3/7:3/7to4/7:4/7to5/7:5/7to6/7:6/7to7/7:7/7to8/7:8/7to9/7:9/7to10/7:10/7to10/8:10/8to10/9:10/9to10/10:10/10to10/11:,14,False,True
25,916,1302,386,left15to0/15,15/0tobottom15,left15to0/15:0/15to1/15:1/15to2/15:2/15to3/15:3/15to4/15:4/15to5/15:5/15to6/15:6/15to7/15:7/15to8/15:8/15to9/15:9/15to10/15:10/15to10/14:10/14to10/13:10/13to10/12:10/12to10/11:10/11to10/10:10/10to10/9:10/9to10/8:10/8to10/7:10/7to10/6:10/6to10/5:10/5to10/4:10/4to10/3:10/3to10/2:10/2to10/1:10/1to10/0:10/0to11/0:11/0to12/0:12/0to13/0:13/0to14/0:14/0to15/0:15/0tobottom15:,32,False,True
877,916,1155,239,1/9to2/9,12/2to12/3,1/9to2/9:2/9to2/8:2/8to2/7:2/7to2/6:2/6to2/5:2/5to2/4:2/4to2/3:2/3to3/3:3/3to4/3:4/3to5/3:5/3to6/3:6/3to7/3:7/3to8/3:8/3to9/3:9/3to10/3:10/3to10/2:10/2to11/2:11/2to12/2:12/2to12/3:,19,True,True
810,916,1165,249,4/3to4/2,12/10to13/10,4/3to4/2:4/2to5/2:5/2to6/2:6/2to7/2:7/2to8/2:8/2to9/2:9/2to10/2:10/2to10/3:10/3to10/4:10/4to10/5:10/5to10/6:10/6to10/7:10/7to10/8:10/8to10/9:10/9to10/10:10/10to11/10:11/10to12/10:12/10to13/10:,18,False,True
1688,917,1188,271,9/3to8/3,0/15totop0,9/3to8/3:8/3to7/3:7/3to6/3:6/3to5/3:5/3to4/3:4/3to3/3:3/3to2/3:2/3to1/3:1/3to0/3:0/3to0/4:0/4to0/5:0/5to0/6:0/6to0/7:0/7to0/8:0/8to0/9:0/9to0/10:0/10to0/11:0/11to0/12:0/12to0/13:0/13to0/14:0/14to0/15:0/15totop0:,22,False,True
3216,917,1035,118,10/8to10/7,9/4to9/3,10/8to10/7:10/7to11/7:11/7to11/6:11/6to11/5:11/5to10/5:10/5to10/4:10/4to9/4:9/4to9/3:,8,True,True
2154,917,976,59,4/2to5/2,6/4to6/3,4/2to5/2:5/2to5/3:5/3to5/4:5/4to6/4:6/4to6/3:,5,False,True
225,918,1313,395,right15to15/15,0/0tobottom0,right15to15/15:15/15to14/15:14/15to13/15:13/15to12/15:12/15to11/15:11/15to10/15:10/15to9/15:9/15to8/15:8/15to7/15:7/15to6/15:6/15to5/15:5/15to4/15:4/15to3/15:3/15to2/15:2/15to1/15:1/15to0/15:0/15to0/14:0/14to0/13:0/13to0/12:0/12to0/11:0/11to0/10:0/10to0/9:0/9to0/8:0/8to0/7:0/7to0/6:0/6to0/5:0/5to0/4:0/4to0/3:0/3to0/2:0/2to0/1:0/1to0/0:0/0tobottom0:,32,False,True
1400,918,1188,270,12/6to12/7,2/15totop2,12/6to12/7:12/7to11/7:11/7to10/7:10/7to9/7:9/7to8/7:8/7to7/7:7/7to6/7:6/7to5/7:5/7to4/7:4/7to3/7:3/7to2/7:2/7to2/8:2/8to2/9:2/9to2/10:2/10to2/11:2/11to2/12:2/12to2/13:2/13to2/14:2/14to2/15:2/15totop2:,20,True,True
1131,918,1093,175,4/2to4/3,7/13to7/14,4/2to4/3:4/3to4/4:4/4to4/5:4/5to4/6:4/6to4/7:4/7to4/8:4/8to4/9:4/9to4/10:4/10to4/11:4/11to4/12:4/12to4/13:4/13to5/13:5/13to6/13:6/13to7/13:7/13to7/14:,15,True,True
1425,918,964,46,1/11to1/12,1/14to1/15,1/11to1/12:1/12to1/13:1/13to1/14:1/14to1/15:,4,True,True
1763,918,1091,173,4/6to4/5,0/11to1/11,4/6to4/5:4/5to3/5:3/5to2/5:2/5to1/5:1/5to0/5:0/5to0/6:0/6to0/7:0/7to0/8:0/8to0/9:0/9to0/10:0/10to0/11:0/11to1/11:,12,True,True
375,919,1291,372,right0to15/0,0/15totop0,right0to15/0:15/0to14/0:14/0to13/0:13/0to12/0:12/0to11/0:11/0to10/0:10/0to9/0:9/0to8/0:8/0to7/0:7/0to6/0:6/0to5/0:5/0to4/0:4/0to3/0:3/0to2/0:2/0to1/0:1/0to0/0:0/0to0/1:0/1to0/2:0/2to0/3:0/3to0/4:0/4to0/5:0/5to0/6:0/6to0/7:0/7to0/8:0/8to0/9:0/9to0/10:0/10to0/11:0/11to0/12:0/12to0/13:0/13to0/14:0/14to0/15:0/15totop0:,32,False,True
2077,919,955,36,15/12to15/11,15/10to15/9,15/12to15/11:15/11to15/10:15/10to15/9:,3,True,True
796,919,969,50,10/11to9/11,8/12to7/12,10/11to9/11:9/11to8/11:8/11to8/12:8/12to7/12:,4,False,True
621,920,1191,271,14/2to14/3,2/7to1/7,14/2to14/3:14/3to13/3:13/3to12/3:12/3to11/3:11/3to11/4:11/4to10/4:10/4to9/4:9/4to8/4:8/4to7/4:7/4to6/4:6/4to5/4:5/4to4/4:4/4to3/4:3/4to2/4:2/4to2/5:2/5to2/6:2/6to2/7:2/7to1/7:,18,True,True
1582,920,1076,156,11/4to11/3,7/9to6/9,11/4to11/3:11/3to11/4:11/4to10/4:10/4to9/4:9/4to8/4:8/4to7/4:7/4to7/5:7/5to7/6:7/6to7/7:7/7to7/8:7/8to7/9:7/9to6/9:,12,True,True
3271,920,1014,94,15/4to14/4,14/10to13/10,15/4to14/4:14/4to14/5:14/5to14/6:14/6to14/7:14/7to14/8:14/8to14/9:14/9to14/10:14/10to13/10:,8,False,True
2872,920,1162,242,9/13to8/13,2/1to3/1,9/13to8/13:8/13to7/13:7/13to6/13:6/13to5/13:5/13to4/13:4/13to3/13:3/13to2/13:2/13to2/12:2/12to2/11:2/11to2/10:2/10to2/9:2/9to2/8:2/8to2/7:2/7to2/6:2/6to2/5:2/5to2/4:2/4to2/3:2/3to2/2:2/2to2/1:2/1to3/1:,20,True,True
1019,920,0,-920,1/2to0/2,7/0to7/1,1/2to0/2:0/2to0/1:0/1to0/0:,3,False,False
861,920,1053,133,6/12to5/12,2/8to3/8,6/12to5/12:5/12to4/12:4/12to3/12:3/12to2/12:2/12to2/11:2/11to2/10:2/10to2/9:2/9to2/8:2/8to3/8:,9,True,True
2711,921,1047,126,10/1to9/1,9/10to10/10,10/1to9/1:9/1to9/2:9/2to9/3:9/3to9/4:9/4to9/5:9/5to9/6:9/6to9/7:9/7to9/8:9/8to9/9:9/9to9/10:9/10to10/10:,11,False,True
2112,922,1029,107,15/3to15/2,11/5to11/6,15/3to15/2:15/2to14/2:14/2to13/2:13/2to12/2:12/2to11/2:11/2to11/3:11/3to11/4:11/4to11/5:11/5to11/6:,9,True,True
1439,922,1024,102,10/13to11/13,13/9to14/9,10/13to11/13:11/13to11/12:11/12to11/11:11/11to11/10:11/10to11/9:11/9to12/9:12/9to13/9:13/9to14/9:,8,False,True
2205,922,1049,127,0/0to1/0,9/0tobottom9,0/0to1/0:1/0to2/0:2/0to3/0:3/0to4/0:4/0to5/0:5/0to6/0:6/0to7/0:7/0to8/0:8/0to9/0:9/0tobottom9:,10,True,True
542,922,1125,203,bottom14to14/0,5/6to5/7,bottom14to14/0:14/0to13/0:13/0to12/0:12/0to11/0:11/0to10/0:10/0to9/0:9/0to8/0:8/0to7/0:7/0to6/0:6/0to5/0:5/0to5/1:5/1to5/2:5/2to5/3:5/3to5/4:5/4to5/5:5/5to5/6:5/6to5/7:,17,True,True
1054,923,1151,228,11/4to10/4,3/13to4/13,11/4to10/4:10/4to9/4:9/4to8/4:8/4to7/4:7/4to6/4:6/4to5/4:5/4to4/4:4/4to3/4:3/4to3/5:3/5to3/6:3/6to3/7:3/7to3/8:3/8to3/9:3/9to3/10:3/10to3/11:3/11to3/12:3/12to3/13:3/13to4/13:,18,True,True
2502,923,1105,182,1/8to1/9,11/9to12/9,1/8to1/9:1/9to2/9:2/9to3/9:3/9to4/9:4/9to5/9:5/9to6/9:6/9to7/9:7/9to8/9:8/9to9/9:9/9to10/9:10/9to11/9:11/9to12/9:,12,False,True
3196,923,1077,154,10/11to9/11,4/6to4/5,10/11to9/11:9/11to8/11:8/11to7/11:7/11to6/11:6/11to5/11:5/11to4/11:4/11to4/10:4/10to4/9:4/9to4/8:4/8to4/7:4/7to4/6:4/6to4/5:,12,True,True
1498,923,1083,160,6/14to5/14,0/10to1/10,6/14to5/14:5/14to4/14:4/14to3/14:3/14to2/14:2/14to1/14:1/14to0/14:0/14to0/13:0/13to0/12:0/12to0/11:0/11to0/10:0/10to1/10:,11,False,True
59,924,1294,370,left15to0/15,15/0tobottom15,left15to0/15:0/15to0/14:0/14to0/13:0/13to0/12:0/12to0/11:0/11to0/10:0/10to0/9:0/9to0/8:0/8to0/7:0/7to0/6:0/6to0/5:0/5to0/4:0/4to0/3:0/3to0/2:0/2to1/2:1/2to2/2:2/2to3/2:3/2to4/2:4/2to5/2:5/2to6/2:6/2to7/2:7/2to8/2:8/2to9/2:9/2to10/2:10/2to10/1:10/1to11/1:11/1to11/0:11/0to12/0:12/0to13/0:13/0to14/0:14/0to15/0:15/0tobottom15:,32,True,True
1577,924,1086,162,13/2to13/1,10/10to10/11,13/2to13/1:13/1to12/1:12/1to11/1:11/1to10/1:10/1to10/2:10/2to10/3:10/3to10/4:10/4to10/5:10/5to10/6:10/6to10/7:10/7to10/8:10/8to10/9:10/9to10/10:10/10to10/11:,14,False,True
1958,925,1041,116,7/13to8/13,15/13to15/12,7/13to8/13:8/13to9/13:9/13to10/13:10/13to11/13:11/13to12/13:12/13to13/13:13/13to14/13:14/13to15/13:15/13to15/12:,9,False,True
936,925,1263,338,14/2to13/2,2/14to1/14,14/2to13/2:13/2to12/2:12/2to11/2:11/2to10/2:10/2to9/2:9/2to8/2:8/2to7/2:7/2to6/2:6/2to5/2:5/2to4/2:4/2to3/2:3/2to2/2:2/2to2/3:2/3to2/4:2/4to2/5:2/5to2/6:2/6to2/7:2/7to2/8:2/8to2/9:2/9to2/10:2/10to2/11:2/11to2/12:2/12to2/13:2/13to2/14:2/14to1/14:,25,False,True
1289,925,1084,159,7/6to6/6,2/0to1/0,7/6to6/6:6/6to5/6:5/6to4/6:4/6to3/6:3/6to2/6:2/6to2/5:2/5to2/4:2/4to2/3:2/3to2/2:2/2to2/1:2/1to2/0:2/0to1/0:,12,False,True
2218,926,1194,268,15/2to14/2,7/13to7/14,15/2to14/2:14/2to13/2:13/2to12/2:12/2to11/2:11/2to10/2:10/2to9/2:9/2to8/2:8/2to7/2:7/2to7/3:7/3to7/4:7/4to7/5:7/5to7/6:7/6to7/7:7/7to7/8:7/8to7/9:7/9to7/10:7/10to7/11:7/11to7/12:7/12to7/13:7/13to7/14:,20,True,True
2371,926,1047,121,6/2to6/3,7/10to8/10,6/2to6/3:6/3to6/4:6/4to6/5:6/5to6/6:6/6to6/7:6/7to6/8:6/8to6/9:6/9to6/10:6/10to7/10:7/10to8/10:,10,False,True
1807,927,1204,277,bottom4to4/0,15/8to15/7,bottom4to4/0:4/0to5/0:5/0to6/0:6/0to7/0:7/0to8/0:8/0to9/0:9/0to10/0:10/0to10/1:10/1to10/2:10/2to10/3:10/3to10/4:10/4to10/5:10/5to10/6:10/6to10/7:10/7to10/8:10/8to11/8:11/8to12/8:12/8to13/8:13/8to14/8:14/8to15/8:15/8to15/7:,21,False,True
692,927,1025,98,2/13to2/14,7/15to7/14,2/13to2/14:2/14to2/15:2/15to3/15:3/15to4/15:4/15to5/15:5/15to6/15:6/15to7/15:7/15to7/14:,8,True,True
2771,928,1180,252,0/10to0/9,12/4to12/3,0/10to0/9:0/9to0/8:0/8to0/7:0/7to0/6:0/6to1/6:1/6to2/6:2/6to3/6:3/6to4/6:4/6to5/6:5/6to6/6:6/6to7/6:7/6to8/6:8/6to9/6:9/6to10/6:10/6to10/5:10/5to11/5:11/5to12/5:12/5to12/4:12/4to12/3:,19,True,True
1249,928,1189,261,left6to0/6,12/12to13/12,left6to0/6:0/6to0/7:0/7to0/8:0/8to0/9:0/9to0/10:0/10to0/11:0/11to1/11:1/11to2/11:2/11to3/11:3/11to4/11:4/11to5/11:5/11to6/11:6/11to7/11:7/11to8/11:8/11to9/11:9/11to10/11:10/11to10/12:10/12to11/12:11/12to12/12:12/12to13/12:,20,True,True
850,928,1209,281,5/1to5/2,10/6to9/6,5/1to5/2:5/2to5/3:5/3to5/4:5/4to5/5:5/5to6/5:6/5to7/5:7/5to8/5:8/5to9/5:9/5to10/5:10/5to10/6:10/6to9/6:,11,True,True
508,928,1078,150,4/4to4/5,0/4to1/4,4/4to4/5:4/5to3/5:3/5to2/5:2/5to1/5:1/5to0/5:0/5to0/4:0/4to1/4:,7,True,True
1502,929,1050,121,7/1to7/0,10/3to11/3,7/1to7/0:7/0to7/1:7/1to7/2:7/2to8/2:8/2to9/2:9/2to10/2:10/2to10/3:10/3to11/3:,8,True,True
1671,929,1182,253,3/2to4/2,13/10to14/10,3/2to4/2:4/2to5/2:5/2to6/2:6/2to7/2:7/2to8/2:8/2to9/2:9/2to10/2:10/2to10/3:10/3to10/4:10/4to10/5:10/5to10/6:10/6to10/7:10/7to10/8:10/8to10/9:10/9to10/10:10/10to11/10:11/10to12/10:12/10to13/10:13/10to14/10:,19,False,True
1971,930,1094,164,10/14to10/13,13/6to14/6,10/14to10/13:10/13to10/12:10/12to10/11:10/11to10/10:10/10to10/9:10/9to10/8:10/8to10/7:10/7to10/6:10/6to11/6:11/6to12/6:12/6to13/6:13/6to14/6:,12,False,True
2876,930,1032,102,9/0to9/1,5/3to4/3,9/0to9/1:9/1to8/1:8/1to7/1:7/1to6/1:6/1to5/1:5/1to5/2:5/2to5/3:5/3to4/3:,8,True,True
1339,931,1123,192,4/8to4/7,12/10to13/10,4/8to4/7:4/7to4/8:4/8to4/9:4/9to4/10:4/10to5/10:5/10to6/10:6/10to7/10:7/10to8/10:8/10to9/10:9/10to10/10:10/10to11/10:11/10to12/10:12/10to13/10:,13,True,True
1682,931,1094,163,6/4to6/5,9/14to9/13,6/4to6/5:6/5to6/6:6/6to6/7:6/7to6/8:6/8to6/9:6/9to6/10:6/10to6/11:6/11to6/12:6/12to6/13:6/13to6/14:6/14to7/14:7/14to8/14:8/14to9/14:9/14to9/13:,14,False,True
1103,931,1229,298,13/15to12/15,2/3to2/2,13/15to12/15:12/15to11/15:11/15to10/15:10/15to9/15:9/15to8/15:8/15to7/15:7/15to6/15:6/15to5/15:5/15to4/15:4/15to3/15:3/15to2/15:2/15to2/14:2/14to2/13:2/13to2/12:2/12to2/11:2/11to2/10:2/10to2/9:2/9to2/8:2/8to2/7:2/7to2/6:2/6to2/5:2/5to2/4:2/4to2/3:2/3to2/2:,24,False,True
1030,932,1157,225,11/1to10/1,13/15to14/15,11/1to10/1:10/1to10/2:10/2to10/3:10/3to10/4:10/4to10/5:10/5to10/6:10/6to10/7:10/7to10/8:10/8to10/9:10/9to10/10:10/10to10/11:10/11to10/12:10/12to10/13:10/13to10/14:10/14to10/15:10/15to11/15:11/15to12/15:12/15to13/15:13/15to14/15:,19,False,True
3038,932,1037,105,6/11to6/10,6/3to7/3,6/11to6/10:6/10to6/9:6/9to6/8:6/8to6/7:6/7to6/6:6/6to6/5:6/5to6/4:6/4to6/3:6/3to7/3:,9,False,True
3212,932,1155,223,bottom10to10/0,7/15totop7,bottom10to10/0:10/0to9/0:9/0to8/0:8/0to7/0:7/0to7/1:7/1to7/2:7/2to7/3:7/3to7/4:7/4to7/5:7/5to7/6:7/6to7/7:7/7to7/8:7/8to7/9:7/9to7/10:7/10to7/11:7/11to7/12:7/12to7/13:7/13to7/14:7/14to7/15:7/15totop7:,20,True,True
1795,932,980,48,11/10to11/9,13/9to14/9,11/10to11/9:11/9to12/9:12/9to13/9:13/9to14/9:,4,True,True
1486,932,1132,200,8/1to8/2,14/7to15/7,8/1to8/2:8/2to9/2:9/2to10/2:10/2to10/3:10/3to10/4:10/4to10/5:10/5to10/6:10/6to10/7:10/7to11/7:11/7to12/7:12/7to13/7:13/7to14/7:14/7to15/7:,13,False,True
2247,933,1188,255,12/8to11/8,6/12to6/13,12/8to11/8:11/8to10/8:10/8to9/8:9/8to8/8:8/8to7/8:7/8to6/8:6/8to6/9:6/9to6/10:6/10to6/11:6/11to6/12:6/12to6/13:,11,False,True
3140,933,1301,368,2/4to3/4,15/12toright12,2/4to3/4:3/4to4/4:4/4to5/4:5/4to6/4:6/4to7/4:7/4to8/4:8/4to9/4:9/4to10/4:10/4to10/5:10/5to10/6:10/6to10/7:10/7to10/8:10/8to10/9:10/9to10/10:10/10to10/11:10/11to10/12:10/12to11/12:11/12to12/12:12/12to13/12:13/12to14/12:14/12to15/12:15/12toright12:,22,False,True
2888,933,1085,152,7/6to7/5,3/10to3/11,7/6to7/5:7/5to6/5:6/5to5/5:5/5to4/5:4/5to3/5:3/5to3/6:3/6to3/7:3/7to3/8:3/8to3/9:3/9to3/10:3/10to3/11:,11,True,True
1284,934,1155,221,12/3to11/3,3/6to2/6,12/3to11/3:11/3to10/3:10/3to9/3:9/3to8/3:8/3to7/3:7/3to6/3:6/3to5/3:5/3to4/3:4/3to3/3:3/3to3/4:3/4to3/5:3/5to3/6:3/6to2/6:,13,True,True
561,934,1135,201,1/0to2/0,6/11to6/12,1/0to2/0:2/0to2/1:2/1to2/2:2/2to2/3:2/3to2/4:2/4to2/5:2/5to2/6:2/6to2/7:2/7to2/8:2/8to2/9:2/9to2/10:2/10to2/11:2/11to3/11:3/11to4/11:4/11to5/11:5/11to6/11:6/11to6/12:,17,False,True
2194,934,1166,232,left8to0/8,6/15to7/15,left8to0/8:0/8to0/9:0/9to0/10:0/10to0/11:0/11to0/12:0/12to0/13:0/13to0/14:0/14to0/15:0/15to1/15:1/15to2/15:2/15to3/15:3/15to4/15:4/15to5/15:5/15to6/15:6/15to7/15:,15,True,True
890,935,985,50,7/0to7/1,5/1to4/1,7/0to7/1:7/1to6/1:6/1to5/1:5/1to4/1:,4,False,True
2152,935,1088,153,4/4to4/5,7/13to7/14,4/4to4/5:4/5to4/6:4/6to4/7:4/7to4/8:4/8to4/9:4/9to4/10:4/10to4/11:4/11to4/12:4/12to4/13:4/13to5/13:5/13to6/13:6/13to7/13:7/13to7/14:,13,False,True
801,935,1103,168,5/3to5/4,1/12to1/13,5/3to5/4:5/4to4/4:4/4to3/4:3/4to2/4:2/4to1/4:1/4to1/5:1/5to1/6:1/6to1/7:1/7to1/8:1/8to1/9:1/9to1/10:1/10to1/11:1/11to1/12:1/12to1/13:,14,False,True
1685,935,1223,288,4/1to5/1,15/10to15/11,4/1to5/1:5/1to6/1:6/1to7/1:7/1to8/1:8/1to9/1:9/1to10/1:10/1to10/2:10/2to10/3:10/3to10/4:10/4to10/5:10/5to10/6:10/6to10/7:10/7to10/8:10/8to10/9:10/9to10/10:10/10to11/10:11/10to12/10:12/10to13/10:13/10to14/10:14/10to15/10:15/10to15/11:,21,False,True
2564,936,1072,136,10/15to10/14,9/5to9/6,10/15to10/14:10/14to9/14:9/14to9/13:9/13to9/12:9/12to9/11:9/11to9/10:9/10to9/9:9/9to9/8:9/8to9/7:9/7to9/6:9/6to9/5:9/5to9/6:,12,True,True
1717,936,1116,180,5/11to6/11,10/13to11/13,5/11to6/11:6/11to7/11:7/11to8/11:8/11to9/11:9/11to10/11:10/11to10/12:10/12to10/13:10/13to11/13:,8,False,True
3125,936,1045,109,2/7to1/7,0/13toleft13,2/7to1/7:1/7to0/7:0/7to0/8:0/8to0/9:0/9to0/10:0/10to0/11:0/11to0/12:0/12to0/13:0/13toleft13:,9,False,True
1218,937,1164,227,8/14to7/14,0/5toleft5,8/14to7/14:7/14to6/14:6/14to5/14:5/14to4/14:4/14to3/14:3/14to2/14:2/14to1/14:1/14to0/14:0/14to0/13:0/13to0/12:0/12to0/11:0/11to0/10:0/10to0/9:0/9to0/8:0/8to0/7:0/7to0/6:0/6to0/5:0/5toleft5:,18,True,True
676,937,1208,271,2/10to3/10,14/3to14/2,2/10to3/10:3/10to4/10:4/10to5/10:5/10to6/10:6/10to7/10:7/10to8/10:8/10to9/10:9/10to10/10:10/10to10/9:10/9to10/8:10/8to10/7:10/7to10/6:10/6to10/5:10/5to10/4:10/4to10/3:10/3to11/3:11/3to12/3:12/3to13/3:13/3to14/3:14/3to14/2:,20,False,True
785,937,1168,231,2/6to3/6,11/8to12/8,2/6to3/6:3/6to4/6:4/6to5/6:5/6to6/6:6/6to7/6:7/6to8/6:8/6to9/6:9/6to10/6:10/6to10/7:10/7to10/8:10/8to11/8:11/8to12/8:,12,False,True
2880,937,1103,166,9/7to9/6,14/2to15/2,9/7to9/6:9/6to9/5:9/5to10/5:10/5to10/4:10/4to11/4:11/4to11/3:11/3to11/2:11/2to12/2:12/2to13/2:13/2to14/2:14/2to15/2:,11,True,True
1745,937,1042,105,6/12to5/12,3/8to3/7,6/12to5/12:5/12to4/12:4/12to3/12:3/12to3/11:3/11to3/10:3/10to3/9:3/9to3/8:3/8to3/7:,8,True,True
1052,937,1235,298,2/9to2/8,14/0to15/0,2/9to2/8:2/8to3/8:3/8to4/8:4/8to5/8:5/8to6/8:6/8to7/8:7/8to8/8:8/8to9/8:9/8to10/8:10/8to10/7:10/7to10/6:10/6to10/5:10/5to10/4:10/4to10/3:10/3to10/2:10/2to10/1:10/1to10/0:10/0to11/0:11/0to12/0:12/0to13/0:13/0to14/0:14/0to15/0:,22,False,True
419,937,1067,130,3/7to4/7,5/15to6/15,3/7to4/7:4/7to4/8:4/8to4/9:4/9to4/10:4/10to4/11:4/11to4/12:4/12to4/13:4/13to4/14:4/14to4/15:4/15to5/15:5/15to6/15:,11,False,True
678,938,1053,115,2/2to2/3,2/11to2/12,2/2to2/3:2/3to2/4:2/4to2/5:2/5to2/6:2/6to2/7:2/7to2/8:2/8to2/9:2/9to2/10:2/10to2/11:2/11to2/12:,10,False,True
1014,939,1151,212,right1to15/1,11/14to12/14,right1to15/1:15/1to14/1:14/1to13/1:13/1to12/1:12/1to11/1:11/1to11/2:11/2to11/3:11/3to11/4:11/4to11/5:11/5to11/6:11/6to11/7:11/7to11/8:11/8to11/9:11/9to11/10:11/10to11/11:11/11to11/12:11/12to11/13:11/13to11/14:11/14to12/14:,19,False,True
2590,940,1103,163,7/2to6/2,1/8to2/8,7/2to6/2:6/2to5/2:5/2to4/2:4/2to3/2:3/2to2/2:2/2to1/2:1/2to1/3:1/3to1/4:1/4to1/5:1/5to1/6:1/6to1/7:1/7to1/8:1/8to2/8:,13,False,True
3353,940,1271,331,bottom1to1/0,14/7to15/7,bottom1to1/0:1/0to1/1:1/1to1/2:1/2to1/3:1/3to1/4:1/4to1/5:1/5to2/5:2/5to3/5:3/5to4/5:4/5to5/5:5/5to6/5:6/5to7/5:7/5to8/5:8/5to9/5:9/5to10/5:10/5to10/6:10/6to11/6:11/6to12/6:12/6to12/7:12/7to13/7:13/7to14/7:14/7to15/7:,22,True,True
219,940,1320,380,right15to15/15,0/0tobottom0,right15to15/15:15/15to14/15:14/15to13/15:13/15to12/15:12/15to11/15:11/15to10/15:10/15to9/15:9/15to8/15:8/15to7/15:7/15to6/15:6/15to5/15:5/15to4/15:4/15to3/15:3/15to2/15:2/15to1/15:1/15to0/15:0/15to0/14:0/14to0/13:0/13to0/12:0/12to0/11:0/11to0/10:0/10to0/9:0/9to0/8:0/8to0/7:0/7to0/6:0/6to0/5:0/5to0/4:0/4to0/3:0/3to0/2:0/2to0/1:0/1to0/0:0/0tobottom0:,32,False,True
2967,941,1002,61,5/4to5/5,4/3to4/2,5/4to5/5:5/5to4/5:4/5to4/4:4/4to4/3:4/3to4/2:,5,True,True
1106,941,1302,361,15/14to14/14,2/0tobottom2,15/14to14/14:14/14to13/14:13/14to12/14:12/14to11/14:11/14to10/14:10/14to9/14:9/14to8/14:8/14to7/14:7/14to6/14:6/14to5/14:5/14to4/14:4/14to3/14:3/14to2/14:2/14to2/13:2/13to2/12:2/12to2/11:2/11to2/10:2/10to2/9:2/9to2/8:2/8to2/7:2/7to2/6:2/6to2/5:2/5to2/4:2/4to2/3:2/3to2/2:2/2to2/1:2/1to2/0:2/0tobottom2:,28,True,True
918,941,1066,125,11/12to11/11,15/7to15/8,11/12to11/11:11/11to11/10:11/10to11/9:11/9to11/8:11/8to11/7:11/7to12/7:12/7to13/7:13/7to14/7:14/7to15/7:15/7to15/8:,10,False,True
853,942,1018,76,5/9to5/8,7/6to7/7,5/9to5/8:5/8to5/7:5/7to5/6:5/6to6/6:6/6to7/6:7/6to7/7:,6,True,True
1601,942,1035,93,8/7to8/8,8/14to8/15,8/7to8/8:8/8to8/9:8/9to8/10:8/10to8/11:8/11to8/12:8/12to8/13:8/13to8/14:8/14to8/15:,8,False,True
2915,942,1361,419,14/8to13/8,0/14to1/14,14/8to13/8:13/8to12/8:12/8to11/8:11/8to10/8:10/8to9/8:9/8to8/8:8/8to7/8:7/8to6/8:6/8to5/8:5/8to4/8:4/8to3/8:3/8to2/8:2/8to1/8:1/8to0/8:0/8to0/9:0/9to0/10:0/10to0/11:0/11to0/12:0/12to0/13:0/13to0/14:0/14to1/14:,21,True,True
2842,942,1125,183,7/15to7/14,3/5to2/5,7/15to7/14:7/14to6/14:6/14to5/14:5/14to4/14:4/14to3/14:3/14to3/13:3/13to3/12:3/12to3/11:3/11to3/10:3/10to3/9:3/9to3/8:3/8to3/7:3/7to3/6:3/6to3/5:3/5to2/5:,15,True,True
1915,943,1212,269,top11to11/15,0/5toleft5,top11to11/15:11/15to10/15:10/15to9/15:9/15to8/15:8/15to7/15:7/15to6/15:6/15to5/15:5/15to4/15:4/15to3/15:3/15to2/15:2/15to1/15:1/15to0/15:0/15to0/14:0/14to0/13:0/13to0/12:0/12to0/11:0/11to0/10:0/10to0/9:0/9to0/8:0/8to0/7:0/7to0/6:0/6to0/5:0/5toleft5:,23,False,True
2612,943,1080,137,0/5to0/6,6/8to6/9,0/5to0/6:0/6to0/7:0/7to0/8:0/8to1/8:1/8to2/8:2/8to3/8:3/8to4/8:4/8to5/8:5/8to6/8:6/8to6/9:,10,True,True
2990,943,1233,290,14/13to14/14,4/2to4/1,14/13to14/14:14/14to13/14:13/14to12/14:12/14to11/14:11/14to10/14:10/14to9/14:9/14to8/14:8/14to7/14:7/14to6/14:6/14to5/14:5/14to4/14:4/14to4/13:4/13to4/12:4/12to4/11:4/11to4/10:4/10to4/9:4/9to4/8:4/8to4/7:4/7to4/6:4/6to4/5:4/5to4/4:4/4to4/3:4/3to4/2:4/2to4/1:,24,False,True
892,943,1082,139,8/15to7/15,4/9to4/8,8/15to7/15:7/15to6/15:6/15to5/15:5/15to4/15:4/15to4/14:4/14to4/13:4/13to4/12:4/12to4/11:4/11to4/10:4/10to4/9:4/9to4/8:,11,False,True
1557,944,1124,180,right13to15/13,3/13to3/12,right13to15/13:15/13to14/13:14/13to13/13:13/13to12/13:12/13to11/13:11/13to10/13:10/13to9/13:9/13to8/13:8/13to7/13:7/13to6/13:6/13to5/13:5/13to4/13:4/13to3/13:3/13to3/12:,14,False,True
832,944,1038,94,9/1to10/1,10/6to10/7,9/1to10/1:10/1to10/2:10/2to10/3:10/3to10/4:10/4to10/5:10/5to10/6:10/6to10/7:,7,False,True
317,944,1324,380,right0to15/0,0/15totop0,right0to15/0:15/0to14/0:14/0to13/0:13/0to12/0:12/0to11/0:11/0to10/0:10/0to9/0:9/0to8/0:8/0to7/0:7/0to6/0:6/0to5/0:5/0to4/0:4/0to3/0:3/0to2/0:2/0to1/0:1/0to0/0:0/0to0/1:0/1to0/2:0/2to0/3:0/3to0/4:0/4to0/5:0/5to0/6:0/6to0/7:0/7to0/8:0/8to0/9:0/9to0/10:0/10to0/11:0/11to0/12:0/12to0/13:0/13to0/14:0/14to0/15:0/15totop0:,32,True,True
524,944,1083,139,10/5to10/6,7/1to7/0,10/5to10/6:10/6to9/6:9/6to8/6:8/6to7/6:7/6to7/5:7/5to7/4:7/4to7/3:7/3to7/2:7/2to7/1:7/1to7/0:,10,True,True
645,944,1166,222,bottom8to8/0,4/13to4/14,bottom8to8/0:8/0to7/0:7/0to6/0:6/0to5/0:5/0to4/0:4/0to4/1:4/1to4/2:4/2to4/3:4/3to4/4:4/4to4/5:4/5to4/6:4/6to4/7:4/7to4/8:4/8to4/9:4/9to4/10:4/10to4/11:4/11to4/12:4/12to4/13:4/13to4/14:,19,False,True
546,944,1150,206,6/13to7/13,13/4to14/4,6/13to7/13:7/13to7/12:7/12to7/11:7/11to7/10:7/10to7/9:7/9to7/8:7/8to7/7:7/7to7/6:7/6to7/5:7/5to8/5:8/5to9/5:9/5to10/5:10/5to10/4:10/4to11/4:11/4to12/4:12/4to13/4:13/4to14/4:,17,True,True
2712,944,1084,140,bottom7to7/0,15/1to15/0,bottom7to7/0:7/0to7/1:7/1to8/1:8/1to9/1:9/1to10/1:10/1to11/1:11/1to12/1:12/1to13/1:13/1to14/1:14/1to15/1:15/1to15/0:,11,True,True
3143,945,1047,102,9/7to9/8,9/15to10/15,9/7to9/8:9/8to9/9:9/9to9/10:9/10to9/11:9/11to9/12:9/12to9/13:9/13to9/14:9/14to9/15:9/15to10/15:,9,False,True
2384,946,970,24,7/7to7/6,7/6to7/5,7/7to7/6:7/6to7/5:,2,True,True
1595,946,1064,118,13/10to14/10,14/2to15/2,13/10to14/10:14/10to14/9:14/9to14/8:14/8to14/7:14/7to14/6:14/6to14/5:14/5to14/4:14/4to14/3:14/3to14/2:14/2to15/2:,10,False,True
3110,946,1099,153,9/4to9/3,1/0tobottom1,9/4to9/3:9/3to8/3:8/3to7/3:7/3to6/3:6/3to5/3:5/3to4/3:4/3to3/3:3/3to2/3:2/3to1/3:1/3to1/2:1/2to1/1:1/1to1/0:1/0tobottom1:,13,True,True
360,946,1332,386,right0to15/0,0/15totop0,right0to15/0:15/0to14/0:14/0to13/0:13/0to12/0:12/0to11/0:11/0to11/1:11/1to10/1:10/1to9/1:9/1to8/1:8/1to7/1:7/1to6/1:6/1to5/1:5/1to4/1:4/1to3/1:3/1to2/1:2/1to1/1:1/1to0/1:0/1to0/2:0/2to0/3:0/3to0/4:0/4to0/5:0/5to0/6:0/6to0/7:0/7to0/8:0/8to0/9:0/9to0/10:0/10to0/11:0/11to0/12:0/12to0/13:0/13to0/14:0/14to0/15:0/15totop0:,32,True,True
2324,947,1031,84,3/13to2/13,2/8to2/7,3/13to2/13:2/13to2/12:2/12to2/11:2/11to2/10:2/10to2/9:2/9to2/8:2/8to2/7:,7,True,True
1777,947,1062,115,9/4to9/5,11/9to11/10,9/4to9/5:9/5to10/5:10/5to11/5:11/5to11/6:11/6to11/7:11/7to11/8:11/8to11/9:11/9to11/10:,8,True,True
2343,947,1084,137,9/5to8/5,1/3to0/3,9/5to8/5:8/5to7/5:7/5to6/5:6/5to5/5:5/5to4/5:4/5to3/5:3/5to2/5:2/5to1/5:1/5to1/4:1/4to1/3:1/3to0/3:,11,True,True
462,947,1160,213,3/10to4/10,10/15to11/15,3/10to4/10:4/10to5/10:5/10to6/10:6/10to7/10:7/10to8/10:8/10to9/10:9/10to10/10:10/10to10/11:10/11to10/12:10/12to10/13:10/13to10/14:10/14to10/15:10/15to11/15:,13,False,True
3222,948,1127,179,9/11to9/12,0/11toleft11,9/11to9/12:9/12to8/12:8/12to7/12:7/12to6/12:6/12to5/12:5/12to4/12:4/12to3/12:3/12to2/12:2/12to1/12:1/12to0/12:0/12to0/11:0/11toleft11:,12,True,True
3057,948,1160,212,11/10to10/10,7/9to7/8,11/10to10/10:10/10to9/10:9/10to8/10:8/10to7/10:7/10to7/9:7/9to7/8:,6,False,True
2068,948,1134,186,10/3to10/4,2/1to3/1,10/3to10/4:10/4to9/4:9/4to8/4:8/4to7/4:7/4to6/4:6/4to5/4:5/4to4/4:4/4to3/4:3/4to2/4:2/4to2/3:2/3to2/2:2/2to2/1:2/1to3/1:,13,False,True
2843,948,1086,138,11/11to11/12,10/7to11/7,11/11to11/12:11/12to11/11:11/11to12/11:12/11to12/10:12/10to12/9:12/9to11/9:11/9to10/9:10/9to10/8:10/8to10/7:10/7to11/7:,10,True,True
816,948,1120,172,15/2to15/3,7/6to7/7,15/2to15/3:15/3to14/3:14/3to13/3:13/3to12/3:12/3to11/3:11/3to11/4:11/4to10/4:10/4to9/4:9/4to8/4:8/4to7/4:7/4to7/5:7/5to7/6:7/6to7/7:,13,True,True
517,948,1183,235,14/6to14/7,9/8to8/8,14/6to14/7:14/7to13/7:13/7to12/7:12/7to12/8:12/8to11/8:11/8to10/8:10/8to9/8:9/8to8/8:,8,True,True
702,949,1263,314,14/4to14/5,3/5to3/6,14/4to14/5:14/5to13/5:13/5to12/5:12/5to11/5:11/5to10/5:10/5to9/5:9/5to8/5:8/5to7/5:7/5to6/5:6/5to5/5:5/5to4/5:4/5to3/5:3/5to3/6:,13,False,True
274,949,1335,386,right15to15/15,0/0tobottom0,right15to15/15:15/15to14/15:14/15to13/15:13/15to12/15:12/15to11/15:11/15to10/15:10/15to9/15:9/15to8/15:8/15to7/15:7/15to6/15:6/15to5/15:5/15to4/15:4/15to3/15:3/15to2/15:2/15to1/15:1/15to0/15:0/15to0/14:0/14to0/13:0/13to0/12:0/12to0/11:0/11to0/10:0/10to0/9:0/9to0/8:0/8to0/7:0/7to0/6:0/6to0/5:0/5to0/4:0/4to0/3:0/3to0/2:0/2to0/1:0/1to0/0:0/0tobottom0:,32,False,True
1828,949,1218,269,13/15to12/15,2/6to2/5,13/15to12/15:12/15to11/15:11/15to10/15:10/15to9/15:9/15to8/15:8/15to7/15:7/15to6/15:6/15to5/15:5/15to4/15:4/15to3/15:3/15to2/15:2/15to2/14:2/14to2/13:2/13to2/12:2/12to2/11:2/11to2/10:2/10to2/9:2/9to2/8:2/8to2/7:2/7to2/6:2/6to2/5:,21,False,True
3137,949,1121,172,2/9to3/9,10/14to11/14,2/9to3/9:3/9to3/10:3/10to3/11:3/11to3/12:3/12to3/13:3/13to3/14:3/14to4/14:4/14to5/14:5/14to6/14:6/14to7/14:7/14to8/14:8/14to9/14:9/14to10/14:10/14to11/14:,14,True,True
3327,949,1073,124,15/3to15/4,10/7to10/8,15/3to15/4:15/4to14/4:14/4to13/4:13/4to12/4:12/4to11/4:11/4to10/4:10/4to10/5:10/5to10/6:10/6to10/7:10/7to10/8:,10,False,True
3000,949,1070,121,6/1to6/2,11/0to12/0,6/1to6/2:6/2to6/1:6/1to6/0:6/0to7/0:7/0to8/0:8/0to9/0:9/0to10/0:10/0to11/0:11/0to12/0:,9,True,True
47,949,0,-949,left15to0/15,15/0tobottom15,left15to0/15:0/15to0/14:0/14to0/13:0/13to0/12:0/12to0/11:0/11to0/10:0/10to0/9:0/9to0/8:0/8to0/7:0/7to0/6:0/6to0/5:0/5to0/4:0/4to0/3:0/3to0/2:0/2to0/1:0/1to0/0:,16,True,False
2080,950,1100,150,1/1to0/1,0/12to1/12,1/1to0/1:0/1to0/2:0/2to0/3:0/3to0/4:0/4to0/5:0/5to0/6:0/6to0/7:0/7to0/8:0/8to0/9:0/9to0/10:0/10to0/11:0/11to0/12:0/12to1/12:,13,False,True
2961,950,1144,194,7/13to7/14,14/8to14/9,7/13to7/14:7/14to7/13:7/13to7/12:7/12to7/11:7/11to7/10:7/10to7/9:7/9to7/8:7/8to8/8:8/8to9/8:9/8to10/8:10/8to11/8:11/8to12/8:12/8to13/8:13/8to14/8:14/8to14/9:,15,True,True
1127,950,1095,145,right14to15/14,11/7to10/7,right14to15/14:15/14to14/14:14/14to13/14:13/14to12/14:12/14to11/14:11/14to11/13:11/13to11/12:11/12to11/11:11/11to11/10:11/10to11/9:11/9to11/8:11/8to11/7:11/7to10/7:,13,False,True
551,951,1135,184,2/1to3/1,15/0tobottom15,2/1to3/1:3/1to4/1:4/1to5/1:5/1to6/1:6/1to7/1:7/1to8/1:8/1to9/1:9/1to10/1:10/1to10/0:10/0to11/0:11/0to12/0:12/0to13/0:13/0to14/0:14/0to15/0:15/0tobottom15:,15,False,True
3258,951,1125,174,5/1to6/1,7/13to8/13,5/1to6/1:6/1to6/2:6/2to6/3:6/3to6/4:6/4to6/5:6/5to6/6:6/6to6/7:6/7to6/8:6/8to6/9:6/9to6/10:6/10to6/11:6/11to6/12:6/12to6/13:6/13to7/13:7/13to8/13:,15,False,True
2831,952,1031,79,5/3to5/4,1/4to0/4,5/3to5/4:5/4to4/4:4/4to3/4:3/4to2/4:2/4to1/4:1/4to0/4:,6,True,True
1773,952,1205,253,15/11to15/12,1/10to1/9,15/11to15/12:15/12to14/12:14/12to13/12:13/12to12/12:12/12to11/12:11/12to10/12:10/12to9/12:9/12to8/12:8/12to7/12:7/12to6/12:6/12to5/12:5/12to4/12:4/12to3/12:3/12to2/12:2/12to1/12:1/12to1/11:1/11to1/10:1/10to1/9:,18,False,True
2100,952,1067,115,4/1to4/2,6/7to7/7,4/1to4/2:4/2to4/3:4/3to4/4:4/4to4/5:4/5to4/6:4/6to4/7:4/7to5/7:5/7to6/7:6/7to7/7:,9,False,True
603,953,1150,197,3/9to4/9,10/1to11/1,3/9to4/9:4/9to5/9:5/9to6/9:6/9to7/9:7/9to8/9:8/9to9/9:9/9to10/9:10/9to10/8:10/8to10/7:10/7to10/6:10/6to10/5:10/5to10/4:10/4to10/3:10/3to10/2:10/2to10/1:10/1to11/1:,16,False,True
1647,953,989,36,7/2to7/1,6/1to6/0,7/2to7/1:7/1to6/1:6/1to6/0:,3,True,True
1024,953,1171,218,1/13to1/12,11/8to12/8,1/13to1/12:1/12to2/12:2/12to3/12:3/12to4/12:4/12to5/12:5/12to6/12:6/12to7/12:7/12to8/12:8/12to9/12:9/12to10/12:10/12to10/11:10/11to10/10:10/10to10/9:10/9to10/8:10/8to11/8:11/8to12/8:,16,False,True
413,954,1043,89,10/10to10/9,14/8to15/8,10/10to10/9:10/9to10/8:10/8to11/8:11/8to12/8:12/8to13/8:13/8to14/8:14/8to15/8:,7,True,True
589,954,1069,115,10/6to10/7,12/13to13/13,10/6to10/7:10/7to10/8:10/8to11/8:11/8to11/9:11/9to11/10:11/10to11/11:11/11to11/12:11/12to11/13:11/13to12/13:12/13to13/13:,10,True,True
2260,954,1277,323,right1to15/1,3/13to2/13,right1to15/1:15/1to14/1:14/1to13/1:13/1to12/1:12/1to11/1:11/1to10/1:10/1to9/1:9/1to8/1:8/1to7/1:7/1to6/1:6/1to5/1:5/1to4/1:4/1to3/1:3/1to3/2:3/2to3/3:3/3to3/4:3/4to3/5:3/5to3/6:3/6to3/7:3/7to3/8:3/8to3/9:3/9to3/10:3/10to3/11:3/11to3/12:3/12to3/13:3/13to2/13:,26,False,True
2598,954,971,17,left1to0/1,0/1to0/2,left1to0/1:0/1to0/2:,2,False,True
1225,955,1172,217,2/6to3/6,13/11to13/12,2/6to3/6:3/6to3/7:3/7to3/8:3/8to3/9:3/9to3/10:3/10to3/11:3/11to4/11:4/11to5/11:5/11to6/11:6/11to7/11:7/11to8/11:8/11to9/11:9/11to10/11:10/11to11/11:11/11to12/11:12/11to13/11:13/11to13/12:,17,True,True
2635,955,1140,185,2/8to2/7,9/2to10/2,2/8to2/7:2/7to2/6:2/6to2/5:2/5to2/4:2/4to2/3:2/3to2/2:2/2to3/2:3/2to4/2:4/2to5/2:5/2to6/2:6/2to7/2:7/2to8/2:8/2to9/2:9/2to10/2:,14,False,True
610,955,1027,72,top6to6/15,6/10to5/10,top6to6/15:6/15to6/14:6/14to6/13:6/13to6/12:6/12to6/11:6/11to6/10:6/10to5/10:,7,False,True
724,956,1018,62,10/3to10/2,11/0to11/1,10/3to10/2:10/2to10/1:10/1to10/0:10/0to11/0:11/0to11/1:,5,False,True
2898,956,1300,344,13/5to12/5,0/5to0/6,13/5to12/5:12/5to11/5:11/5to10/5:10/5to9/5:9/5to8/5:8/5to7/5:7/5to6/5:6/5to5/5:5/5to4/5:4/5to3/5:3/5to2/5:2/5to1/5:1/5to0/5:0/5to0/6:,14,False,True
1908,956,1097,141,1/8to0/8,7/9to7/8,1/8to0/8:0/8to0/9:0/9to1/9:1/9to2/9:2/9to3/9:3/9to4/9:4/9to5/9:5/9to6/9:6/9to7/9:7/9to7/8:,10,False,True
3328,956,1257,301,14/14to13/14,5/0to4/0,14/14to13/14:13/14to12/14:12/14to11/14:11/14to10/14:10/14to9/14:9/14to8/14:8/14to7/14:7/14to6/14:6/14to5/14:5/14to5/13:5/13to5/12:5/12to5/11:5/11to5/10:5/10to5/9:5/9to5/8:5/8to5/7:5/7to5/6:5/6to5/5:5/5to5/4:5/4to5/3:5/3to5/2:5/2to5/1:5/1to5/0:5/0to4/0:,24,True,True
154,957,1328,371,left0to0/0,15/15totop15,left0to0/0:0/0to1/0:1/0to2/0:2/0to3/0:3/0to4/0:4/0to5/0:5/0to6/0:6/0to7/0:7/0to8/0:8/0to9/0:9/0to10/0:10/0to10/1:10/1to10/2:10/2to10/3:10/3to10/4:10/4to10/5:10/5to10/6:10/6to10/7:10/7to10/8:10/8to10/9:10/9to10/10:10/10to10/11:10/11to10/12:10/12to10/13:10/13to10/14:10/14to10/15:10/15to11/15:11/15to12/15:12/15to13/15:13/15to14/15:14/15to15/15:15/15totop15:,32,False,True
935,957,1195,238,left10to0/10,9/1to9/2,left10to0/10:0/10to0/9:0/9to0/8:0/8to0/7:0/7to0/6:0/6to0/5:0/5to0/4:0/4to0/3:0/3to0/2:0/2to0/1:0/1to1/1:1/1to2/1:2/1to3/1:3/1to4/1:4/1to5/1:5/1to6/1:6/1to7/1:7/1to8/1:8/1to9/1:9/1to9/2:,20,False,True
178,957,1358,401,left0to0/0,15/15totop15,left0to0/0:0/0to1/0:1/0to2/0:2/0to3/0:3/0to4/0:4/0to5/0:5/0to6/0:6/0to7/0:7/0to8/0:8/0to9/0:9/0to10/0:10/0to10/1:10/1to10/2:10/2to10/3:10/3to10/4:10/4to10/5:10/5to10/6:10/6to10/7:10/7to10/8:10/8to10/9:10/9to10/10:10/10to10/11:10/11to10/12:10/12to10/13:10/13to10/14:10/14to10/15:10/15to11/15:11/15to12/15:12/15to13/15:13/15to14/15:14/15to15/15:15/15totop15:,32,False,True
1197,958,1150,192,4/10to5/10,9/0to9/1,4/10to5/10:5/10to5/9:5/9to5/8:5/8to5/7:5/7to5/6:5/6to5/5:5/5to5/4:5/4to5/3:5/3to5/2:5/2to5/1:5/1to5/0:5/0to6/0:6/0to7/0:7/0to8/0:8/0to9/0:9/0to9/1:,16,False,True
182,958,1347,389,left0to0/0,15/15totop15,left0to0/0:0/0to0/1:0/1to0/2:0/2to0/3:0/3to0/4:0/4to0/5:0/5to0/6:0/6to0/7:0/7to0/8:0/8to0/9:0/9to0/10:0/10to0/11:0/11to0/12:0/12to0/13:0/13to1/13:1/13to2/13:2/13to3/13:3/13to4/13:4/13to5/13:5/13to6/13:6/13to7/13:7/13to8/13:8/13to9/13:9/13to10/13:10/13to10/14:10/14to11/14:11/14to11/15:11/15to12/15:12/15to13/15:13/15to14/15:14/15to15/15:15/15totop15:,32,True,True
1645,958,1181,223,1/10to1/9,11/4to11/3,1/10to1/9:1/9to2/9:2/9to3/9:3/9to4/9:4/9to5/9:5/9to6/9:6/9to7/9:7/9to8/9:8/9to9/9:9/9to10/9:10/9to10/8:10/8to10/7:10/7to10/6:10/6to10/5:10/5to10/4:10/4to11/4:11/4to11/3:,17,False,True
737,958,1148,190,5/4to5/3,1/13to0/13,5/4to5/3:5/3to4/3:4/3to3/3:3/3to2/3:2/3to1/3:1/3to1/4:1/4to1/5:1/5to1/6:1/6to1/7:1/7to1/8:1/8to1/9:1/9to1/10:1/10to1/11:1/11to1/12:1/12to1/13:1/13to0/13:,16,False,True
2618,958,1052,94,5/6to4/6,8/7to9/7,5/6to4/6:4/6to4/7:4/7to5/7:5/7to6/7:6/7to7/7:7/7to8/7:8/7to9/7:,7,False,True
872,959,1019,60,5/5to4/5,5/7to5/8,5/5to4/5:4/5to4/6:4/6to4/7:4/7to5/7:5/7to5/8:,5,True,True
2781,960,1078,118,4/13to5/13,5/5to6/5,4/13to5/13:5/13to5/12:5/12to5/11:5/11to5/10:5/10to5/9:5/9to5/8:5/8to5/7:5/7to5/6:5/6to5/5:5/5to6/5:,10,True,True
1341,960,1021,61,9/13to8/13,5/13to5/14,9/13to8/13:8/13to7/13:7/13to6/13:6/13to5/13:5/13to5/14:,5,False,True
3147,960,1018,58,left0to0/0,3/0tobottom3,left0to0/0:0/0to1/0:1/0to2/0:2/0to3/0:3/0tobottom3:,5,True,True
2061,960,1051,91,10/4to10/3,15/3to15/2,10/4to10/3:10/3to11/3:11/3to12/3:12/3to13/3:13/3to14/3:14/3to15/3:15/3to15/2:,7,True,True
2109,961,1207,246,0/10to1/10,14/14to14/13,0/10to1/10:1/10to2/10:2/10to3/10:3/10to4/10:4/10to5/10:5/10to6/10:6/10to7/10:7/10to8/10:8/10to9/10:9/10to10/10:10/10to10/11:10/11to10/12:10/12to10/13:10/13to10/14:10/14to11/14:11/14to12/14:12/14to13/14:13/14to14/14:14/14to14/13:,19,False,True
1038,961,1057,96,3/3to2/3,5/1to5/2,3/3to2/3:2/3to2/2:2/2to2/1:2/1to3/1:3/1to4/1:4/1to5/1:5/1to5/2:,7,False,True
3288,961,1201,240,13/9to12/9,2/3to1/3,13/9to12/9:12/9to11/9:11/9to10/9:10/9to9/9:9/9to8/9:8/9to7/9:7/9to6/9:6/9to5/9:5/9to4/9:4/9to3/9:3/9to2/9:2/9to2/8:2/8to2/7:2/7to2/6:2/6to2/5:2/5to2/4:2/4to2/3:2/3to1/3:,18,False,True
2148,962,1179,217,0/2to1/2,11/8to11/7,0/2to1/2:1/2to1/3:1/3to1/4:1/4to1/5:1/5to1/6:1/6to1/7:1/7to1/8:1/8to2/8:2/8to3/8:3/8to4/8:4/8to5/8:5/8to6/8:6/8to7/8:7/8to8/8:8/8to9/8:9/8to10/8:10/8to11/8:11/8to11/7:,18,True,True
291,962,1342,380,right15to15/15,0/0tobottom0,right15to15/15:15/15to14/15:14/15to13/15:13/15to12/15:12/15to11/15:11/15to11/14:11/14to10/14:10/14to9/14:9/14to8/14:8/14to7/14:7/14to6/14:6/14to5/14:5/14to4/14:4/14to3/14:3/14to2/14:2/14to1/14:1/14to0/14:0/14to0/13:0/13to0/12:0/12to0/11:0/11to0/10:0/10to0/9:0/9to0/8:0/8to0/7:0/7to0/6:0/6to0/5:0/5to0/4:0/4to0/3:0/3to0/2:0/2to0/1:0/1to0/0:0/0tobottom0:,32,True,True
3378,963,1044,81,1/10to1/11,2/15to3/15,1/10to1/11:1/11to1/12:1/12to1/13:1/13to1/14:1/14to1/15:1/15to2/15:2/15to3/15:,7,True,True
3204,963,1160,197,4/11to4/12,11/7to11/8,4/11to4/12:4/12to5/12:5/12to6/12:6/12to7/12:7/12to8/12:8/12to9/12:9/12to10/12:10/12to10/11:10/11to10/10:10/10to10/9:10/9to10/8:10/8to10/7:10/7to11/7:11/7to11/8:,14,False,True
1930,963,1058,95,5/13to4/13,8/12to9/12,5/13to4/13:4/13to4/12:4/12to5/12:5/12to6/12:6/12to7/12:7/12to8/12:8/12to9/12:,7,True,True
142,963,0,-963,left0to0/0,15/15totop15,left0to0/0:,1,True,False
1409,963,1138,175,4/14to3/14,0/6toleft6,4/14to3/14:3/14to2/14:2/14to1/14:1/14to0/14:0/14to0/13:0/13to0/12:0/12to0/11:0/11to0/10:0/10to0/9:0/9to0/8:0/8to0/7:0/7to0/6:0/6toleft6:,13,True,True
454,963,1073,110,1/10to0/10,4/8to4/9,1/10to0/10:0/10to0/9:0/9to0/8:0/8to1/8:1/8to2/8:2/8to3/8:3/8to4/8:4/8to4/9:,8,False,True
2255,964,1260,296,1/1to1/2,11/15to12/15,1/1to1/2:1/2to1/3:1/3to1/4:1/4to1/5:1/5to1/6:1/6to1/7:1/7to1/8:1/8to1/9:1/9to1/10:1/10to1/11:1/11to1/12:1/12to1/13:1/13to2/13:2/13to3/13:3/13to4/13:4/13to5/13:5/13to6/13:6/13to7/13:7/13to8/13:8/13to9/13:9/13to10/13:10/13to10/14:10/14to11/14:11/14to11/15:11/15to12/15:,25,True,True
3086,965,1060,95,6/15to5/15,1/13to0/13,6/15to5/15:5/15to4/15:4/15to3/15:3/15to2/15:2/15to1/15:1/15to1/14:1/14to1/13:1/13to0/13:,8,False,True
2944,965,1129,164,5/1to5/2,8/11to8/10,5/1to5/2:5/2to5/3:5/3to5/4:5/4to5/5:5/5to5/6:5/6to5/7:5/7to5/8:5/8to5/9:5/9to5/10:5/10to5/11:5/11to6/11:6/11to7/11:7/11to8/11:8/11to8/10:,14,True,True
1512,965,1125,160,9/0to10/0,10/8to10/9,9/0to10/0:10/0to10/1:10/1to10/2:10/2to11/2:11/2to11/3:11/3to11/4:11/4to11/5:11/5to11/6:11/6to11/7:11/7to10/7:10/7to10/8:10/8to10/9:,12,True,True
3127,965,1041,76,6/2to6/3,4/0tobottom4,6/2to6/3:6/3to5/3:5/3to4/3:4/3to4/2:4/2to4/1:4/1to4/0:4/0tobottom4:,7,True,True
246,965,1346,381,right15to15/15,0/0tobottom0,right15to15/15:15/15to14/15:14/15to13/15:13/15to12/15:12/15to11/15:11/15to10/15:10/15to9/15:9/15to8/15:8/15to7/15:7/15to6/15:6/15to5/15:5/15to4/15:4/15to3/15:3/15to2/15:2/15to1/15:1/15to0/15:0/15to0/14:0/14to0/13:0/13to0/12:0/12to0/11:0/11to0/10:0/10to0/9:0/9to0/8:0/8to0/7:0/7to0/6:0/6to0/5:0/5to0/4:0/4to0/3:0/3to0/2:0/2to0/1:0/1to0/0:0/0tobottom0:,32,False,True
43,965,1346,381,left15to0/15,15/0tobottom15,left15to0/15:0/15to0/14:0/14to0/13:0/13to0/12:0/12to0/11:0/11to0/10:0/10to0/9:0/9to0/8:0/8to0/7:0/7to0/6:0/6to0/5:0/5to0/4:0/4to0/3:0/3to0/2:0/2to1/2:1/2to2/2:2/2to3/2:3/2to4/2:4/2to5/2:5/2to6/2:6/2to7/2:7/2to8/2:8/2to9/2:9/2to10/2:10/2to10/1:10/1to11/1:11/1to11/0:11/0to12/0:12/0to13/0:13/0to14/0:14/0to15/0:15/0tobottom15:,32,True,True
2382,965,1133,168,15/4to15/3,9/3to8/3,15/4to15/3:15/3to14/3:14/3to13/3:13/3to12/3:12/3to11/3:11/3to11/2:11/2to10/2:10/2to9/2:9/2to9/3:9/3to8/3:,10,True,True
1755,966,1072,106,10/10to9/10,6/7to6/6,10/10to9/10:9/10to8/10:8/10to7/10:7/10to6/10:6/10to6/9:6/9to6/8:6/8to6/7:6/7to6/6:,8,False,True
1790,966,1167,201,right3to15/3,6/9to6/10,right3to15/3:15/3to14/3:14/3to13/3:13/3to12/3:12/3to11/3:11/3to11/4:11/4to10/4:10/4to9/4:9/4to8/4:8/4to7/4:7/4to6/4:6/4to6/5:6/5to6/6:6/6to6/7:6/7to6/8:6/8to6/9:6/9to6/10:,17,True,True
2760,967,1166,199,7/14to8/14,10/1to10/0,7/14to8/14:8/14to9/14:9/14to10/14:10/14to10/13:10/13to10/12:10/12to10/11:10/11to10/10:10/10to10/9:10/9to10/8:10/8to10/7:10/7to10/6:10/6to10/5:10/5to10/4:10/4to10/3:10/3to10/2:10/2to10/1:10/1to10/0:,17,False,True
1505,967,1175,208,15/15to14/15,8/6to8/5,15/15to14/15:14/15to13/15:13/15to12/15:12/15to11/15:11/15to10/15:10/15to9/15:9/15to8/15:8/15to8/14:8/14to8/13:8/13to8/12:8/12to8/11:8/11to8/10:8/10to8/9:8/9to8/8:8/8to8/7:8/7to8/6:8/6to8/5:,17,False,True
870,967,1194,227,0/15to1/15,7/4to7/3,0/15to1/15:1/15to1/14:1/14to1/13:1/13to1/12:1/12to1/11:1/11to1/10:1/10to1/9:1/9to1/8:1/8to1/7:1/7to1/6:1/6to1/5:1/5to1/4:1/4to2/4:2/4to3/4:3/4to4/4:4/4to5/4:5/4to6/4:6/4to7/4:7/4to7/3:,19,True,True
2125,967,991,24,11/12to11/13,11/13to11/14,11/12to11/13:11/13to11/14:,2,True,True
358,968,1347,379,right0to15/0,0/15totop0,right0to15/0:15/0to14/0:14/0to13/0:13/0to12/0:12/0to11/0:11/0to10/0:10/0to9/0:9/0to8/0:8/0to7/0:7/0to6/0:6/0to5/0:5/0to4/0:4/0to3/0:3/0to2/0:2/0to1/0:1/0to0/0:0/0to0/1:0/1to0/2:0/2to0/3:0/3to0/4:0/4to0/5:0/5to0/6:0/6to0/7:0/7to0/8:0/8to0/9:0/9to0/10:0/10to0/11:0/11to0/12:0/12to0/13:0/13to0/14:0/14to0/15:0/15totop0:,32,False,True
1764,968,0,-968,0/1to0/0,14/15to15/15,0/1to0/0:,1,True,False
896,968,1323,355,11/9to11/8,1/4to0/4,11/9to11/8:11/8to10/8:10/8to9/8:9/8to8/8:8/8to7/8:7/8to6/8:6/8to5/8:5/8to4/8:4/8to3/8:3/8to2/8:2/8to1/8:1/8to1/7:1/7to1/6:1/6to1/5:1/5to1/4:1/4to0/4:,16,True,True
2127,968,1022,54,right13to15/13,12/13to12/14,right13to15/13:15/13to14/13:14/13to13/13:13/13to12/13:12/13to12/14:,5,True,True
1818,969,1087,118,7/13to8/13,14/12to14/11,7/13to8/13:8/13to9/13:9/13to10/13:10/13to10/12:10/12to11/12:11/12to12/12:12/12to13/12:13/12to14/12:14/12to14/11:,9,False,True
807,969,1054,85,2/13to2/14,1/10to1/9,2/13to2/14:2/14to1/14:1/14to1/13:1/13to1/12:1/12to1/11:1/11to1/10:1/10to1/9:,7,True,True
2425,970,1166,196,14/7to13/7,2/5to2/4,14/7to13/7:13/7to12/7:12/7to11/7:11/7to10/7:10/7to9/7:9/7to8/7:8/7to7/7:7/7to6/7:6/7to5/7:5/7to4/7:4/7to3/7:3/7to2/7:2/7to2/6:2/6to2/5:2/5to2/4:,15,False,True
448,971,1111,140,5/14to6/14,13/13to13/12,5/14to6/14:6/14to7/14:7/14to8/14:8/14to9/14:9/14to10/14:10/14to11/14:11/14to12/14:12/14to12/13:12/13to13/13:13/13to13/12:,10,True,True
1931,971,1019,48,7/12to6/12,6/14to5/14,7/12to6/12:6/12to6/13:6/13to6/14:6/14to5/14:,4,True,True
1429,971,1231,260,14/10to13/10,1/4to2/4,14/10to13/10:13/10to12/10:12/10to12/9:12/9to11/9:11/9to10/9:10/9to9/9:9/9to8/9:8/9to7/9:7/9to6/9:6/9to5/9:5/9to4/9:4/9to3/9:3/9to2/9:2/9to1/9:1/9to1/8:1/8to1/7:1/7to1/6:1/6to1/5:1/5to1/4:1/4to2/4:,20,True,True
1114,971,1275,304,0/3to1/3,12/15totop12,0/3to1/3:1/3to1/4:1/4to1/5:1/5to1/6:1/6to1/7:1/7to1/8:1/8to1/9:1/9to1/10:1/10to1/11:1/11to1/12:1/12to1/13:1/13to2/13:2/13to3/13:3/13to4/13:4/13to5/13:5/13to6/13:6/13to7/13:7/13to8/13:8/13to9/13:9/13to10/13:10/13to10/14:10/14to11/14:11/14to11/15:11/15to12/15:12/15totop12:,25,True,True
809,971,1183,212,12/10to12/11,8/2to7/2,12/10to12/11:12/11to11/11:11/11to10/11:10/11to9/11:9/11to8/11:8/11to8/10:8/10to8/9:8/9to8/8:8/8to8/7:8/7to8/6:8/6to8/5:8/5to8/4:8/4to8/3:8/3to8/2:8/2to7/2:,15,False,True
31,972,1356,384,left15to0/15,15/0tobottom15,left15to0/15:0/15to0/14:0/14to0/13:0/13to0/12:0/12to0/11:0/11to0/10:0/10to0/9:0/9to0/8:0/8to0/7:0/7to0/6:0/6to0/5:0/5to0/4:0/4to0/3:0/3to0/2:0/2to1/2:1/2to2/2:2/2to3/2:3/2to4/2:4/2to5/2:5/2to6/2:6/2to7/2:7/2to8/2:8/2to9/2:9/2to10/2:10/2to10/1:10/1to11/1:11/1to11/0:11/0to12/0:12/0to13/0:13/0to14/0:14/0to15/0:15/0tobottom15:,32,True,True
326,972,1349,377,right0to15/0,0/15totop0,right0to15/0:15/0to14/0:14/0to13/0:13/0to12/0:12/0to11/0:11/0to10/0:10/0to9/0:9/0to8/0:8/0to7/0:7/0to6/0:6/0to5/0:5/0to4/0:4/0to3/0:3/0to2/0:2/0to1/0:1/0to0/0:0/0to0/1:0/1to0/2:0/2to0/3:0/3to0/4:0/4to0/5:0/5to0/6:0/6to0/7:0/7to0/8:0/8to0/9:0/9to0/10:0/10to0/11:0/11to0/12:0/12to0/13:0/13to0/14:0/14to0/15:0/15totop0:,32,True,True
3091,972,1224,252,left9to0/9,13/14to14/14,left9to0/9:0/9to0/10:0/10to0/11:0/11to0/12:0/12to0/13:0/13to0/14:0/14to1/14:1/14to2/14:2/14to3/14:3/14to4/14:4/14to5/14:5/14to6/14:6/14to7/14:7/14to8/14:8/14to9/14:9/14to10/14:10/14to11/14:11/14to12/14:12/14to13/14:13/14to14/14:,20,True,True
118,972,0,-972,left0to0/0,15/15totop15,left0to0/0:,1,False,False
3108,972,1179,207,10/3to9/3,2/11to2/12,10/3to9/3:9/3to8/3:8/3to7/3:7/3to6/3:6/3to5/3:5/3to4/3:4/3to3/3:3/3to2/3:2/3to2/4:2/4to2/5:2/5to2/6:2/6to2/7:2/7to2/8:2/8to2/9:2/9to2/10:2/10to2/11:2/11to2/12:,17,False,True
2909,972,1090,118,0/6to1/6,3/12to3/11,0/6to1/6:1/6to1/7:1/7to1/8:1/8to1/9:1/9to1/10:1/10to1/11:1/11to1/12:1/12to2/12:2/12to3/12:3/12to3/11:,10,True,True
2862,973,1177,204,4/1to4/2,10/11to10/12,4/1to4/2:4/2to4/3:4/3to4/4:4/4to4/5:4/5to4/6:4/6to4/7:4/7to4/8:4/8to4/9:4/9to4/10:4/10to4/11:4/11to5/11:5/11to6/11:6/11to7/11:7/11to8/11:8/11to9/11:9/11to10/11:10/11to10/12:,17,True,True
694,973,1126,153,11/3to10/3,5/1to6/1,11/3to10/3:10/3to9/3:9/3to8/3:8/3to7/3:7/3to6/3:6/3to5/3:5/3to5/2:5/2to5/1:5/1to6/1:,9,False,True
2174,974,1145,171,0/10to1/10,10/11to9/11,0/10to1/10:1/10to2/10:2/10to3/10:3/10to4/10:4/10to5/10:5/10to6/10:6/10to7/10:7/10to8/10:8/10to9/10:9/10to10/10:10/10to10/11:10/11to9/11:,12,False,True
1626,974,1231,257,top1to1/15,10/4to10/3,top1to1/15:1/15to1/14:1/14to1/13:1/13to1/12:1/12to1/11:1/11to1/10:1/10to1/9:1/9to1/8:1/8to1/7:1/7to1/6:1/6to1/5:1/5to2/5:2/5to3/5:3/5to4/5:4/5to5/5:5/5to6/5:6/5to7/5:7/5to8/5:8/5to9/5:9/5to10/5:10/5to10/4:10/4to10/3:,22,True,True
1492,974,1120,146,7/9to7/10,13/14to13/15,7/9to7/10:7/10to7/11:7/11to7/12:7/12to7/13:7/13to8/13:8/13to9/13:9/13to10/13:10/13to10/14:10/14to11/14:11/14to12/14:12/14to13/14:13/14to13/15:,12,True,True
2259,975,1044,69,5/12to5/13,3/15totop3,5/12to5/13:5/13to4/13:4/13to3/13:3/13to3/14:3/14to3/15:3/15totop3:,6,False,True
1148,975,1234,259,8/13to9/13,15/2to15/1,8/13to9/13:9/13to10/13:10/13to11/13:11/13to11/12:11/12to11/11:11/11to11/10:11/10to11/9:11/9to11/8:11/8to11/7:11/7to11/6:11/6to11/5:11/5to11/4:11/4to11/3:11/3to11/2:11/2to12/2:12/2to13/2:13/2to14/2:14/2to15/2:15/2to15/1:,19,True,True
960,975,1193,218,14/2to14/3,6/11to6/12,14/2to14/3:14/3to13/3:13/3to12/3:12/3to11/3:11/3to10/3:10/3to9/3:9/3to8/3:8/3to7/3:7/3to6/3:6/3to6/4:6/4to6/5:6/5to6/6:6/6to6/7:6/7to6/8:6/8to6/9:6/9to6/10:6/10to6/11:6/11to6/12:,18,True,True
1370,975,1095,120,14/3to14/2,10/6to9/6,14/3to14/2:14/2to13/2:13/2to12/2:12/2to11/2:11/2to10/2:10/2to10/3:10/3to10/4:10/4to10/5:10/5to10/6:10/6to9/6:,10,False,True
248,976,1348,372,right15to15/15,0/0tobottom0,right15to15/15:15/15to14/15:14/15to13/15:13/15to12/15:12/15to11/15:11/15to11/14:11/14to10/14:10/14to9/14:9/14to8/14:8/14to7/14:7/14to6/14:6/14to5/14:5/14to4/14:4/14to3/14:3/14to2/14:2/14to1/14:1/14to0/14:0/14to0/13:0/13to0/12:0/12to0/11:0/11to0/10:0/10to0/9:0/9to0/8:0/8to0/7:0/7to0/6:0/6to0/5:0/5to0/4:0/4to0/3:0/3to0/2:0/2to0/1:0/1to0/0:0/0tobottom0:,32,True,True
1465,976,1117,141,15/9to15/8,9/6to8/6,15/9to15/8:15/8to14/8:14/8to13/8:13/8to12/8:12/8to11/8:11/8to10/8:10/8to10/7:10/7to9/7:9/7to9/6:9/6to8/6:,10,True,True
1858,978,1050,72,0/5to1/5,3/3to3/2,0/5to1/5:1/5to1/4:1/4to1/3:1/3to2/3:2/3to3/3:3/3to3/2:,6,False,True
770,978,1199,221,15/1to15/2,7/6to7/7,15/1to15/2:15/2to14/2:14/2to13/2:13/2to12/2:12/2to11/2:11/2to10/2:10/2to9/2:9/2to8/2:8/2to7/2:7/2to7/3:7/3to7/4:7/4to7/5:7/5to7/6:7/6to7/7:,14,False,True
1265,978,1147,169,5/9to5/8,11/2to12/2,5/9to5/8:5/8to5/7:5/7to5/6:5/6to5/5:5/5to5/4:5/4to5/3:5/3to6/3:6/3to7/3:7/3to8/3:8/3to9/3:9/3to10/3:10/3to10/2:10/2to11/2:11/2to12/2:,14,True,True
1007,978,1264,286,14/12to14/11,1/4to0/4,14/12to14/11:14/11to13/11:13/11to12/11:12/11to11/11:11/11to10/11:10/11to9/11:9/11to8/11:8/11to7/11:7/11to6/11:6/11to5/11:5/11to4/11:4/11to3/11:3/11to2/11:2/11to1/11:1/11to1/10:1/10to1/9:1/9to1/8:1/8to1/7:1/7to1/6:1/6to1/5:1/5to1/4:1/4to0/4:,22,True,True
858,978,1061,83,15/8to14/8,13/4to12/4,15/8to14/8:14/8to13/8:13/8to13/7:13/7to13/6:13/6to13/5:13/5to13/4:13/4to12/4:,7,False,True
1302,979,1119,140,7/7to8/7,10/11to10/12,7/7to8/7:8/7to8/8:8/8to8/9:8/9to8/10:8/10to9/10:9/10to10/10:10/10to10/11:10/11to10/12:,8,True,True
124,979,0,-979,left0to0/0,15/15totop15,left0to0/0:,1,False,False
1233,979,1125,146,6/6to6/7,10/1to11/1,6/6to6/7:6/7to7/7:7/7to8/7:8/7to9/7:9/7to10/7:10/7to10/6:10/6to10/5:10/5to10/4:10/4to10/3:10/3to10/2:10/2to10/1:10/1to11/1:,12,False,True
1116,979,1196,217,2/12to2/11,9/2to9/3,2/12to2/11:2/11to2/10:2/10to2/9:2/9to2/8:2/8to2/7:2/7to2/6:2/6to2/5:2/5to2/4:2/4to2/3:2/3to2/2:2/2to3/2:3/2to4/2:4/2to5/2:5/2to6/2:6/2to7/2:7/2to8/2:8/2to9/2:9/2to9/3:,18,False,True
695,980,1134,154,4/4to5/4,12/1to12/2,4/4to5/4:5/4to6/4:6/4to7/4:7/4to8/4:8/4to9/4:9/4to10/4:10/4to10/3:10/3to10/2:10/2to10/1:10/1to11/1:11/1to12/1:12/1to12/2:,12,False,True
1819,980,1153,173,14/2to13/2,13/15to12/15,14/2to13/2:13/2to13/3:13/3to13/4:13/4to13/5:13/5to13/6:13/6to13/7:13/7to13/8:13/8to13/9:13/9to13/10:13/10to13/11:13/11to13/12:13/12to13/13:13/13to13/14:13/14to13/15:13/15to12/15:,15,True,True
1316,981,1113,132,9/13to9/12,5/7to5/6,9/13to9/12:9/12to8/12:8/12to7/12:7/12to6/12:6/12to5/12:5/12to5/11:5/11to5/10:5/10to5/9:5/9to5/8:5/8to5/7:5/7to5/6:,11,True,True
1741,982,1310,328,left15to0/15,10/0to9/0,left15to0/15:0/15to0/14:0/14to0/13:0/13to0/12:0/12to0/11:0/11to0/10:0/10to0/9:0/9to0/8:0/8to0/7:0/7to0/6:0/6to0/5:0/5to0/4:0/4to0/3:0/3to0/2:0/2to1/2:1/2to2/2:2/2to3/2:3/2to4/2:4/2to5/2:5/2to6/2:6/2to7/2:7/2to8/2:8/2to9/2:9/2to10/2:10/2to10/1:10/1to10/0:10/0to9/0:,27,True,True
2826,982,1106,124,11/7to10/7,8/13to8/14,11/7to10/7:10/7to9/7:9/7to8/7:8/7to8/8:8/8to8/9:8/9to8/10:8/10to8/11:8/11to8/12:8/12to8/13:8/13to8/14:,10,True,True
1843,982,1011,29,3/7to2/7,2/7to2/8,3/7to2/7:2/7to2/8:,2,True,True
1087,982,1247,265,6/8to6/7,14/9to14/8,6/8to6/7:6/7to6/8:6/8to7/8:7/8to8/8:8/8to9/8:9/8to10/8:10/8to10/9:10/9to11/9:11/9to12/9:12/9to13/9:13/9to14/9:14/9to14/8:,12,True,True
2731,983,1064,81,7/2to8/2,9/6to9/5,7/2to8/2:8/2to8/3:8/3to8/4:8/4to8/5:8/5to8/6:8/6to9/6:9/6to9/5:,7,False,True
804,983,1125,142,top0to0/15,4/10to5/10,top0to0/15:0/15to0/14:0/14to0/13:0/13to0/12:0/12to0/11:0/11to0/10:0/10to1/10:1/10to2/10:2/10to3/10:3/10to4/10:4/10to5/10:,11,False,True
1939,983,1226,243,1/13to2/13,15/10to15/11,1/13to2/13:2/13to3/13:3/13to4/13:4/13to5/13:5/13to6/13:6/13to7/13:7/13to8/13:8/13to9/13:9/13to10/13:10/13to10/12:10/12to10/11:10/11to10/10:10/10to11/10:11/10to12/10:12/10to13/10:13/10to14/10:14/10to15/10:15/10to15/11:,18,False,True
513,984,1226,242,bottom11to11/0,4/11to4/12,bottom11to11/0:11/0to10/0:10/0to9/0:9/0to8/0:8/0to7/0:7/0to6/0:6/0to5/0:5/0to4/0:4/0to4/1:4/1to4/2:4/2to4/3:4/3to4/4:4/4to4/5:4/5to4/6:4/6to4/7:4/7to4/8:4/8to4/9:4/9to4/10:4/10to4/11:4/11to4/12:,20,False,True
91,984,0,-984,left15to0/15,15/0tobottom15,left15to0/15:0/15to0/14:0/14to0/13:0/13to0/12:0/12to0/11:0/11to0/10:0/10to0/9:0/9to0/8:0/8to0/7:0/7to0/6:0/6to0/5:0/5to0/4:0/4to0/3:0/3to0/2:0/2to0/1:0/1to0/0:,16,True,False
117,984,0,-984,left0to0/0,15/15totop15,,0,True,False
638,985,1216,231,12/11to12/12,4/4to3/4,12/11to12/12:12/12to11/12:11/12to10/12:10/12to9/12:9/12to8/12:8/12to7/12:7/12to6/12:6/12to5/12:5/12to4/12:4/12to4/11:4/11to4/10:4/10to4/9:4/9to4/8:4/8to4/7:4/7to4/6:4/6to4/5:4/5to4/4:4/4to3/4:,18,False,True
2183,985,1183,198,12/3to12/2,1/0tobottom1,12/3to12/2:12/2to11/2:11/2to10/2:10/2to9/2:9/2to8/2:8/2to7/2:7/2to6/2:6/2to5/2:5/2to4/2:4/2to3/2:3/2to2/2:2/2to1/2:1/2to1/1:1/1to1/0:1/0tobottom1:,15,True,True
2855,985,1067,82,8/13to8/12,9/8to9/7,8/13to8/12:8/12to8/11:8/11to8/10:8/10to8/9:8/9to8/8:8/8to9/8:9/8to9/7:,7,False,True
2269,986,1055,69,5/9to5/10,5/14to5/15,5/9to5/10:5/10to5/11:5/11to5/12:5/12to5/13:5/13to5/14:5/14to5/15:,6,False,True
624,986,1078,92,3/3to2/3,3/8to4/8,3/3to2/3:2/3to2/4:2/4to2/5:2/5to2/6:2/6to2/7:2/7to2/8:2/8to3/8:3/8to4/8:,8,False,True
1021,986,1179,193,9/8to9/9,0/6to1/6,9/8to9/9:9/9to8/9:8/9to7/9:7/9to6/9:6/9to5/9:5/9to4/9:4/9to3/9:3/9to2/9:2/9to1/9:1/9to0/9:0/9to0/8:0/8to0/7:0/7to0/6:0/6to1/6:,14,True,True
1704,987,1046,59,12/2to12/3,11/5to11/6,12/2to12/3:12/3to12/4:12/4to12/5:12/5to11/5:11/5to11/6:,5,True,True
961,988,1036,48,14/15to14/14,12/14to11/14,14/15to14/14:14/14to13/14:13/14to12/14:12/14to11/14:,4,True,True
2349,988,1088,100,6/3to6/4,2/6to2/7,6/3to6/4:6/4to5/4:5/4to4/4:4/4to3/4:3/4to2/4:2/4to2/5:2/5to2/6:2/6to2/7:,8,False,True
424,989,1172,183,3/9to4/9,13/7to14/7,3/9to4/9:4/9to5/9:5/9to6/9:6/9to7/9:7/9to8/9:8/9to9/9:9/9to10/9:10/9to10/8:10/8to10/7:10/7to11/7:11/7to12/7:12/7to13/7:13/7to14/7:,13,False,True
3223,990,1209,219,bottom3to3/0,1/15to0/15,bottom3to3/0:3/0to2/0:2/0to1/0:1/0to1/1:1/1to1/2:1/2to1/3:1/3to1/4:1/4to1/5:1/5to1/6:1/6to1/7:1/7to1/8:1/8to1/9:1/9to1/10:1/10to1/11:1/11to1/12:1/12to1/13:1/13to1/14:1/14to1/15:1/15to0/15:,19,True,True
3396,990,1305,315,12/2to11/2,1/15to2/15,12/2to11/2:11/2to10/2:10/2to9/2:9/2to8/2:8/2to7/2:7/2to6/2:6/2to5/2:5/2to4/2:4/2to3/2:3/2to2/2:2/2to1/2:1/2to1/3:1/3to1/4:1/4to1/5:1/5to1/6:1/6to1/7:1/7to1/8:1/8to1/9:1/9to1/10:1/10to1/11:1/11to1/12:1/12to1/13:1/13to1/14:1/14to1/15:1/15to2/15:,25,False,True
3132,990,1015,25,bottom5to5/0,5/1to6/1,bottom5to5/0:5/0to5/1:5/1to6/1:,3,True,True
2938,990,1093,103,1/12to1/11,1/4to1/3,1/12to1/11:1/11to1/10:1/10to1/9:1/9to1/8:1/8to1/7:1/7to1/6:1/6to1/5:1/5to1/4:1/4to1/3:,9,False,True
1231,990,1223,233,11/14to11/13,6/2to7/2,11/14to11/13:11/13to11/12:11/12to10/12:10/12to9/12:9/12to8/12:8/12to7/12:7/12to6/12:6/12to6/11:6/11to6/10:6/10to6/9:6/9to6/8:6/8to6/7:6/7to6/6:6/6to6/5:6/5to6/4:6/4to6/3:6/3to6/2:6/2to7/2:,18,True,True
1664,990,1051,61,6/5to6/4,4/3to3/3,6/5to6/4:6/4to5/4:5/4to4/4:4/4to4/3:4/3to3/3:,5,True,True
14,991,1361,370,left15to0/15,15/0tobottom15,left15to0/15:0/15to1/15:1/15to2/15:2/15to3/15:3/15to4/15:4/15to5/15:5/15to6/15:6/15to7/15:7/15to8/15:8/15to9/15:9/15to10/15:10/15to10/14:10/14to10/13:10/13to10/12:10/12to10/11:10/11to10/10:10/10to10/9:10/9to10/8:10/8to10/7:10/7to10/6:10/6to10/5:10/5to10/4:10/4to10/3:10/3to10/2:10/2to10/1:10/1to10/0:10/0to11/0:11/0to12/0:12/0to13/0:13/0to14/0:14/0to15/0:15/0tobottom15:,32,False,True
1469,991,1252,261,12/13to12/12,2/4to1/4,12/13to12/12:12/12to11/12:11/12to10/12:10/12to9/12:9/12to8/12:8/12to7/12:7/12to6/12:6/12to5/12:5/12to4/12:4/12to3/12:3/12to2/12:2/12to2/11:2/11to2/10:2/10to2/9:2/9to2/8:2/8to2/7:2/7to2/6:2/6to2/5:2/5to2/4:2/4to1/4:,20,True,True
3352,991,1042,51,right12to15/12,14/14to13/14,right12to15/12:15/12to14/12:14/12to14/13:14/13to14/14:14/14to13/14:,5,True,True
3040,991,1140,149,bottom13to13/0,8/6to7/6,bottom13to13/0:13/0to12/0:12/0to11/0:11/0to10/0:10/0to9/0:9/0to8/0:8/0to8/1:8/1to8/2:8/2to8/3:8/3to8/4:8/4to8/5:8/5to8/6:8/6to7/6:,13,False,True
985,992,1329,337,6/8to6/7,15/15to15/14,6/8to6/7:6/7to7/7:7/7to8/7:8/7to9/7:9/7to10/7:10/7to10/8:10/8to10/9:10/9to10/10:10/10to10/11:10/11to10/12:10/12to10/13:10/13to10/14:10/14to10/15:10/15to11/15:11/15to12/15:12/15to13/15:13/15to14/15:14/15to15/15:15/15to15/14:,19,False,True
1578,992,1273,281,15/13to15/12,5/1to4/1,15/13to15/12:15/12to14/12:14/12to13/12:13/12to12/12:12/12to11/12:11/12to10/12:10/12to9/12:9/12to8/12:8/12to7/12:7/12to6/12:6/12to5/12:5/12to5/11:5/11to5/10:5/10to5/9:5/9to5/8:5/8to5/7:5/7to5/6:5/6to5/5:5/5to5/4:5/4to5/3:5/3to5/2:5/2to5/1:5/1to4/1:,23,True,True
3377,992,1038,46,2/5to1/5,1/7to2/7,2/5to1/5:1/5to1/6:1/6to1/7:1/7to2/7:,4,True,True
2945,992,1065,73,15/11to15/12,11/12to11/11,15/11to15/12:15/12to14/12:14/12to13/12:13/12to12/12:12/12to11/12:11/12to11/11:,6,False,True
1692,992,1160,168,1/2to0/2,8/5to8/4,1/2to0/2:0/2to0/3:0/3to0/4:0/4to0/5:0/5to1/5:1/5to2/5:2/5to3/5:3/5to4/5:4/5to5/5:5/5to6/5:6/5to7/5:7/5to8/5:8/5to8/4:,13,False,True
1554,992,1120,128,4/14to4/13,2/6to2/5,4/14to4/13:4/13to3/13:3/13to2/13:2/13to2/12:2/12to2/11:2/11to2/10:2/10to2/9:2/9to2/8:2/8to2/7:2/7to2/6:2/6to2/5:,11,False,True
2565,992,1090,98,9/14to8/14,6/10to7/10,9/14to8/14:8/14to7/14:7/14to6/14:6/14to6/13:6/13to6/12:6/12to6/11:6/11to6/10:6/10to7/10:,8,False,True
1415,992,1278,286,15/14to15/15,2/7to3/7,15/14to15/15:15/15to14/15:14/15to13/15:13/15to12/15:12/15to11/15:11/15to10/15:10/15to9/15:9/15to8/15:8/15to7/15:7/15to6/15:6/15to5/15:5/15to4/15:4/15to3/15:3/15to2/15:2/15to2/14:2/14to2/13:2/13to2/12:2/12to2/11:2/11to2/10:2/10to2/9:2/9to2/8:2/8to2/7:2/7to3/7:,23,False,True
1182,992,1196,204,14/6to14/7,6/3to6/2,14/6to14/7:14/7to13/7:13/7to12/7:12/7to11/7:11/7to10/7:10/7to9/7:9/7to8/7:8/7to7/7:7/7to6/7:6/7to6/6:6/6to6/5:6/5to6/4:6/4to6/3:6/3to6/2:,14,True,True
3323,992,1081,89,11/8to11/9,12/13to12/14,11/8to11/9:11/9to12/9:12/9to12/10:12/10to12/11:12/11to12/12:12/12to12/13:12/13to12/14:,7,True,True
827,993,1136,143,5/14to5/13,1/7to1/6,5/14to5/13:5/13to4/13:4/13to3/13:3/13to2/13:2/13to1/13:1/13to1/12:1/12to1/11:1/11to1/10:1/10to1/9:1/9to1/8:1/8to1/7:1/7to1/6:,12,False,True
1624,994,1081,87,right13to15/13,13/9to13/8,right13to15/13:15/13to14/13:14/13to13/13:13/13to13/12:13/12to13/11:13/11to13/10:13/10to13/9:13/9to13/8:,8,True,True
825,994,1169,175,2/1to2/2,6/10to7/10,2/1to2/2:2/2to2/3:2/3to2/4:2/4to2/5:2/5to2/6:2/6to2/7:2/7to2/8:2/8to2/9:2/9to2/10:2/10to3/10:3/10to4/10:4/10to5/10:5/10to6/10:6/10to7/10:,14,False,True
1673,995,1117,122,11/10to12/10,15/4toright4,11/10to12/10:12/10to12/9:12/9to12/8:12/8to12/7:12/7to12/6:12/6to12/5:12/5to12/4:12/4to13/4:13/4to14/4:14/4to15/4:15/4toright4:,11,False,True
1399,995,1164,169,6/13to6/12,11/5to11/6,6/13to6/12:6/12to7/12:7/12to8/12:8/12to9/12:9/12to10/12:10/12to10/11:10/11to10/10:10/10to10/9:10/9to10/8:10/8to10/7:10/7to10/6:10/6to10/5:10/5to11/5:11/5to11/6:,14,False,True
2399,995,1171,176,13/8to13/9,9/1to9/0,13/8to13/9:13/9to12/9:12/9to11/9:11/9to11/8:11/8to11/7:11/7to11/6:11/6to11/5:11/5to11/4:11/4to11/3:11/3to11/2:11/2to10/2:10/2to10/1:10/1to9/1:9/1to9/0:,14,True,True
3356,996,1172,176,15/11to14/11,5/8to5/7,15/11to14/11:14/11to13/11:13/11to12/11:12/11to11/11:11/11to10/11:10/11to9/11:9/11to8/11:8/11to7/11:7/11to6/11:6/11to5/11:5/11to5/10:5/10to5/9:5/9to5/8:5/8to5/7:,14,False,True
1244,997,1250,253,14/2to13/2,4/8to5/8,14/2to13/2:13/2to12/2:12/2to11/2:11/2to10/2:10/2to9/2:9/2to8/2:8/2to7/2:7/2to6/2:6/2to5/2:5/2to4/2:4/2to4/3:4/3to4/4:4/4to4/5:4/5to4/6:4/6to4/7:4/7to4/8:4/8to5/8:,17,True,True
3018,998,1155,157,12/6to12/7,7/3to7/2,12/6to12/7:12/7to11/7:11/7to10/7:10/7to9/7:9/7to8/7:8/7to7/7:7/7to7/6:7/6to7/5:7/5to7/4:7/4to7/3:7/3to7/2:,11,True,True
2227,998,1136,138,13/5to13/6,15/14to15/13,13/5to13/6:13/6to13/7:13/7to13/8:13/8to13/9:13/9to13/10:13/10to13/11:13/11to13/12:13/12to13/13:13/13to13/14:13/14to14/14:14/14to15/14:15/14to15/13:,12,False,True
672,999,1231,232,2/15to1/15,8/5to9/5,2/15to1/15:1/15to1/14:1/14to1/13:1/13to1/12:1/12to1/11:1/11to1/10:1/10to1/9:1/9to1/8:1/8to1/7:1/7to1/6:1/6to1/5:1/5to2/5:2/5to3/5:3/5to4/5:4/5to5/5:5/5to6/5:6/5to7/5:7/5to8/5:8/5to9/5:,19,True,True
901,999,1111,112,bottom2to2/0,5/5to6/5,bottom2to2/0:2/0to2/1:2/1to2/2:2/2to2/3:2/3to2/4:2/4to2/5:2/5to3/5:3/5to4/5:4/5to5/5:5/5to6/5:,10,False,True
347,999,1372,373,right0to15/0,0/15totop0,right0to15/0:15/0to14/0:14/0to13/0:13/0to12/0:12/0to11/0:11/0to10/0:10/0to9/0:9/0to8/0:8/0to7/0:7/0to6/0:6/0to5/0:5/0to4/0:4/0to3/0:3/0to2/0:2/0to1/0:1/0to0/0:0/0to0/1:0/1to0/2:0/2to0/3:0/3to0/4:0/4to0/5:0/5to0/6:0/6to0/7:0/7to0/8:0/8to0/9:0/9to0/10:0/10to0/11:0/11to0/12:0/12to0/13:0/13to0/14:0/14to0/15:0/15totop0:,32,False,True
1508,999,1059,60,8/2to8/1,10/0to9/0,8/2to8/1:8/1to9/1:9/1to10/1:10/1to10/0:10/0to9/0:,5,False,True
